AA: AA
AB: BA
AD: DA
AF: FA
AG: AG
    GA
AH: HA
AJ: JA
AK: AK
    KA
AL: AL
    LA
AM: MA
AN: AN
    NA
AP: AP
    PA
AR: RA
AS: SA
AT: TA
AV: VA
AW: WA
AY: AY
    YA
AZ: ZA
AÇ: AÇ
    ÇA
AÑ: AÑ
BE: BE
BI: BI
BO: BO
BÂ: ÂB
    BÂ
BÊ: BÊ
BÔ: BÔ
DE: DE
    ED
DI: DI
DO: DO
DÂ: DÂ
DÔ: DÔ
DÛ: DÛ
EF: FE
EG: GE
EJ: JE
EK: KE
EL: LE
EM: ME
EN: EN
    NE
EP: PE
ER: RE
ES: SE
ET: TE
EV: EV
    VE
EW: WE
EY: EY
    YE
EZ: ZE
EÇ: ÇE
FI: FI
FO: FO
    OF
FÊ: FÊ
FÔ: FÔ
FÛ: FÛ
GI: GI
GO: GO
    OG
GÂ: ÂG
    GÂ
GÊ: GÊ
GÔ: GÔ
GÛ: GÛ
HÂ: HÂ
HÊ: HÊ
IJ: JI
IK: KI
IL: IL
    LI
IM: IM
    MI
IN: NI
IP: PI
IR: RI
IS: SI
IT: TI
IW: WI
IY: YI
IÇ: ÇI
JÂ: ÂJ
    JÂ
JÊ: JÊ
JÔ: JÔ
JÛ: JÛ
KO: KO
KÂ: KÂ
KÎ: KÎ
KÛ: KÛ
LO: LO
LÂ: LÂ
LÛ: LÛ
MO: MO
MÊ: ÊM
    MÊ
MÛ: MÛ
NO: NO
NÂ: NÂ
NÊ: NÊ
NÎ: NÎ
NÔ: NÔ
NÛ: NÛ
    ÛN
OP: PO
OS: SO
OT: OT
    TO
OV: VO
OW: WO
OY: YO
OZ: ZO
OÇ: ÇO
PÂ: PÂ
PÊ: PÊ
PÔ: PÔ
PÛ: PÛ
    ÛP
RÂ: RÂ
RÊ: RÊ
SÂ: SÂ
SÊ: SÊ
SÔ: ÔS
    SÔ
SÛ: SÛ
TÂ: ÂT
    TÂ
TÊ: TÊ
TÎ: ÎT
TÔ: TÔ
TÛ: TÛ
    ÛT
VÂ: VÂ
VÊ: VÊ
WÔ: WÔ
WÛ: WÛ
YÂ: YÂ
YÔ: YÔ
YÛ: ÛY
ZÂ: ZÂ
ZÊ: ZÊ
ZÔ: ÔZ
ZÛ: ZÛ
ÂÇ: ÇÂ
ÇÊ: ÇÊ
ÇÛ: ÇÛ
