AAB: ABA
AAG: AGA
AAL: ALA
AAP: APA
AAV: AVA
AAZ: AZA
AAÇ: AÇA
ABB: BAB
ABE: ABE
ABF: BAF
     FAB
ABG: BAG
ABI: ABI
ABK: BAK
     KAB
ABL: BAL
ABM: MAB
ABN: ANB
     BAN
ABO: ABO
ABP: BAP
ABR: BRA
ABS: BAS
     SAB
ABT: BAT
     TAB
ABW: BWA
ABY: BAY
ABZ: BAZ
ABÂ: ÂBA
ADE: ADE
ADF: FAD
ADG: GAD
ADH: HAD
ADK: KAD
ADL: DAL
ADM: DAM
ADN: DAN
ADP: DAP
ADR: DRA
     RAD
ADS: SAD
ADT: DAT
ADW: DWA
ADY: YAD
ADÂ: ADÂ
ADÇ: DAÇ
AEF: AFE
AEJ: AJE
AEK: AKE
     EKA
AEL: ALE
AEM: AME
AEN: ANE
AER: ERA
AES: ASE
AET: ATE
     ETA
AEV: AVE
AEY: AYE
AFG: GAF
AFL: FAL
AFP: PAF
AFR: RAF
AFS: FAS
     SAF
AFW: FWA
     WAF
AFY: FAY
AFZ: FAZ
AFÔ: AFÔ
AGL: ALG
     GAL
AGM: GAM
AGN: ANG
     GAN
AGO: AGO
AGR: GRA
AGV: VAG
AGZ: GAZ
AGÂ: ÂGA
AGÔ: AGÔ
AHN: HAN
AHP: HAP
AIJ: AJI
AIK: AKI
AIP: API
AIV: AVI
AIY: AYI
AJK: JAK
AJL: JAL
     LAJ
AJN: ANJ
     JAN
     NAJ
AJP: PAJ
AJR: RAJ
AJW: JWA
AJÂ: AJÂ
AJÇ: ÇAJ
AJÊ: AJÊ
AJÛ: AJÛ
AKL: KAL
     LAK
AKM: MAK
AKN: KAN
     NAK
AKO: AKO
AKP: KAP
     PAK
AKR: RAK
AKS: AKS
     KAS
     SAK
AKT: KAT
     TAK
AKV: KAV
AKW: KAW
     KWA
AKY: KAY
AKZ: ZAK
AKÂ: ÂKA
AKÇ: ÇAK
     KAÇ
ALM: MAL
ALN: LAN
ALO: ALO
     OLA
ALP: PAL
     PLA
ALR: RAL
ALS: LAS
     SAL
ALV: LAV
ALW: LWA
ALY: LAY
ALÇ: ÇAL
     LAÇ
ALÊ: ALÊ
AMO: AMO
     OMA
AMS: MAS
     SAM
AMW: MWA
AMY: MAY
     YAM
AMZ: ZAM
AMÇ: ÇAM
     MAÇ
AMÛ: AMÛ
ANN: NAN
ANP: NAP
     PAN
ANR: RAN
ANS: NAS
     SAN
ANT: ANT
     NAT
     TAN
ANV: VAN
ANW: NWA
ANY: ANY
     YAN
ANZ: ZAN
ANÇ: ÇAN
AOP: APO
     OPA
AOS: ASO
AOT: ATO
AOW: AWO
APP: PAP
APR: RAP
APS: PAS
APT: PAT
     TAP
APV: VAP
APW: PWA
     WAP
APY: PAY
     YAP
APÇ: ÇAP
ARS: RAS
ART: RAT
ARY: RAY
ARZ: RAZ
ARÂ: ARÂ
ARÇ: RAÇ
AST: TAS
ASV: VAS
ASW: SWA
ASY: YAS
ASÂ: ASÂ
ASÇ: ÇAS
ASÔ: ASÔ
ATW: TAW
     TWA
     WAT
ATY: TAY
ATÇ: ÇAT
     TAÇ
ATÛ: ATÛ
AVW: VWA
AVZ: VAZ
AVÂ: AVÂ
AVÇ: VAÇ
AVÊ: AVÊ
AWY: WAY
AWZ: ZWA
AWÔ: AWÔ
AYÇ: ÇAY
BBI: BIB
BDI: BID
BDO: DOB
BDÛ: DÛB
BEF: BEF
     FEB
BEI: IBE
BEJ: BEJ
BEK: BEK
BEL: BEL
     BLE
BEM: MEB
BEN: BEN
BES: BES
BET: BET
BEV: VEB
BEW: BWE
BEY: BYE
BEZ: ZEB
BEÊ: EBÊ
BFI: FIB
BFO: FOB
BFÛ: FÛB
BIK: BIK
     KIB
BIL: BIL
     LIB
BIM: BIM
BIO: IBO
BIP: BIP
BIR: BRI
BIS: BIS
BIT: BIT
     TIB
BJO: JOB
BJÂ: BÂJ
BKO: BOK
     KOB
BKÂ: BÂK
BKÛ: BÛK
     KÛB
BLO: BOL
BLÂ: BLÂ
BLÊ: BLÊ
BLÔ: BLÔ
BLÛ: BÛL
BMÔ: BÔM
BNO: BON
     NOB
BNÂ: BÂN
BNÊ: BÊN
BOS: BOS
BOT: BOT
BOW: BOW
     WOB
BOY: BOY
BOÊ: OBÊ
BRÊ: BRÊ
BSÛ: BÛS
BTÊ: TÊB
BTÛ: BÛT
BYÊ: BÊY
     BYÊ
BÇÛ: BÛÇ
BÊÊ: ÊBÊ
DEE: EDE
DEI: IDE
DEL: LED
DEM: MED
DEO: ODE
DER: RED
DES: SED
DET: DET
DEW: DWE
DEY: DEY
     DYE
DEZ: ZED
DEÂ: ÂDE
DEÊ: EDÊ
DEÜ: ÜDE
DGI: DIG
     GID
DGÊ: DÊG
DGÛ: GÛD
DIK: DIK
DIL: DIL
DIM: DIM
DIR: DRI
DIS: DIS
     SID
DIV: VID
DIZ: DIZ
DKO: DOK
     KOD
DKÔ: DÔK
DKÛ: DÛK
     KÛD
DLO: DLO
     LOD
DMO: MOD
DMÂ: DÂM
DMÔ: MÔD
DMÛ: DÛM
DNO: DON
DOT: DOT
DOY: YOD
DOZ: DOZ
     ZOD
DPÛ: PÛD
DRÊ: DRÊ
DSÂ: DÂS
DSÛ: DÛS
     SÛD
DTÛ: DÛT
DYÔ: DÔY
DYÛ: DÛY
DZÛ: DÛZ
DÂÎ: ÂDÎ
DÇÛ: DÛÇ
DÊÎ: ÊDÎ
EEF: EFE
EEK: EKE
EEP: EPE
EER: ERE
EET: ETE
EEW: EWE
EEZ: EZE
EFK: FEK
EFL: FLE
EFM: FEM
EFN: FEN
     NEF
EFO: EFO
EFR: FRE
EFS: FES
EFT: FET
EFY: FEY
     FYE
EFÂ: ÂFE
EFÇ: ÇEF
EGL: GLE
     LEG
EGM: MEG
EGN: GEN
     NEG
EGO: EGO
EGP: GEP
EGR: REG
EGÎ: EGÎ
EGÛ: EGÛ
EHN: HEN
EHY: HEY
EIL: ELI
EIN: ENI
     INE
EIP: EPI
     IPE
EIV: IVE
EIZ: IZE
EIÇ: EÇI
EJM: JEM
EJN: JEN
     NEJ
EJO: OJE
EJS: JES
EJW: JWE
EJÊ: EJÊ
EKK: KEK
EKL: KLE
EKO: EKO
     OKE
EKP: PEK
EKR: KRE
     REK
EKS: KES
     SEK
EKT: KET
     TEK
EKW: KWE
EKÂ: ÂKE
EKÇ: ÇEK
EKÛ: EKÛ
ELM: MEL
ELN: LEN
ELO: OLE
ELP: LEP
     PEL
     PLE
ELR: REL
ELS: LES
     SEL
ELT: ELT
     LET
     TEL
ELV: LEV
     VEL
     VLE
ELW: LWE
ELY: LYE
ELZ: LEZ
     ZEL
ELÂ: ÂLE
     ELÂ
EMN: ENM
     MEN
EMS: MES
EMT: MET
EMY: MYE
EMÂ: ÂME
EMÇ: MEÇ
ENN: NEN
ENO: ONE
ENP: PEN
ENR: REN
ENS: SEN
ENT: NET
     TEN
ENV: VEN
ENY: NYE
ENZ: ZEN
ENÇ: ÇEN
ENÔ: ÔNE
EOR: ORE
EOT: ETO
     OTE
EOV: OVE
EOW: EWO
EOZ: OZE
EPP: PEP
EPR: PRE
EPS: PES
EPT: PET
     TEP
EPV: VEP
EPY: PEY
     PYE
EPZ: PEZ
EPÂ: ÂPE
EPÇ: PEÇ
EPÊ: ÊPE
ERS: RES
ERT: TRE
ERV: REV
     VRE
ERY: REY
EST: SET
     TES
ESV: VES
ESW: SWE
     WES
ESY: YES
ESZ: SEZ
     ZES
ESÇ: SEÇ
ETT: TET
ETV: VET
ETY: TYE
ETÂ: ÂTE
     ETÂ
ETÎ: ETÎ
     ÎTE
EVV: VEV
EVW: VWE
EVY: VEY
     VYE
EVZ: ZEV
EVÂ: ÂVE
EVÛ: ÛVE
EWY: WEY
EWÇ: ÇWE
     WEÇ
EYZ: ZYE
EZZ: ZEZ
EZÇ: ÇEZ
EZÔ: ÔZE
EÇÇ: ÇEÇ
FGI: FIG
FGO: GOF
FGÛ: GÛF
FIL: FIL
FIM: FIM
FIR: FRI
FIT: TIF
FIV: VIF
FIW: FWI
FIÇ: ÇIF
FJO: FOJ
     JOF
FKO: FOK
     KOF
FKÂ: KÂF
FKÛ: FÛK
FLO: FOL
FLÛ: FÛL
FMO: FOM
FMÂ: FÂM
FNO: FON
FNÂ: FÂN
FNÊ: NÊF
FNÔ: FÔN
FOS: FOS
     SOF
FOT: FOT
FOÇ: ÇOF
FOÜ: ÜFO
FRÂ: FRÂ
FRÊ: FRÊ
FSÎ: SÎF
FSÛ: SÛF
FTÂ: FÂT
FTÊ: FÊT
FTÛ: FÛT
     TÛF
FWÔ: FWÔ
     WÔF
FYÛ: FÛY
FÂÊ: ÂFÊ
FÇÛ: FÛÇ
GGÂ: GÂG
GIL: LIG
GIR: GRI
GIT: TIG
GIÂ: ÂGI
GJO: GOJ
GJÊ: JÊG
GKÔ: KÔG
GLO: GOL
GLÂ: LÂG
GLÔ: LÔG
GMO: GOM
     MOG
GMÔ: GÔM
GNO: GON
GNÊ: GÊN
GOV: VOG
GOW: GWO
GOÇ: GOÇ
GOÛ: OGÛ
GPÊ: PÊG
GRÂ: GRÂ
GSÂ: SÂG
GSÛ: GÛS
GTÊ: TÊG
GTÛ: GÛT
GZÔ: ZÔG
GÂÛ: ÛGÂ
GÂÜ: ÜGÂ
HMÂ: HÂM
HYÛ: HÛY
HÂÂ: ÂHÂ
HÂÇ: HÂÇ
IIN: INI
IIS: ISI
IJJ: JIJ
IJP: JIP
IJS: JIS
IJT: TIJ
IJW: JWI
IJÂ: IJÂ
IKL: KIL
IKM: KIM
IKN: KIN
     NIK
IKO: OKI
IKP: PIK
IKR: KRI
IKS: KIS
     SIK
IKT: KIT
     TIK
IKW: KWI
IKÇ: ÇIK
ILM: LIM
     MIL
ILN: NIL
ILO: OLI
ILP: PIL
     PLI
ILS: LIS
ILT: LIT
     TIL
ILV: LIV
     VIL
ILY: LIY
ILÑ: LIÑ
IMN: MIN
IMP: PIM
IMR: RIM
IMS: MIS
IMT: MIT
IMZ: MIZ
IMÂ: ÂMI
IMÊ: IMÊ
INV: VIN
INÇ: NIÇ
IOT: OTI
IPP: PIP
IPR: PRI
     RIP
IPS: PIS
IPT: PIT
IPZ: ZIP
IPÂ: ÂPI
IPÊ: ÊPI
IRT: RIT
IRZ: RIZ
IRÂ: ÂRI
IRÇ: RIÇ
ISS: SIS
ISV: SIV
     VIS
ISY: SIY
ISÛ: ÛSI
ISÜ: ÜSI
ITT: TIT
ITV: VIT
ITÇ: ÇIT
IVV: VIV
IVÂ: ÂVI
IZÑ: ZIÑ
IÇÇ: ÇIÇ
JJO: JOJ
JKÛ: JÛK
JLO: LOJ
JLÂ: LÂJ
JLÊ: LÊJ
JLÛ: JÛL
JMÂ: JÂM
JNO: JON
JNÊ: JÊN
JNÔ: JÔN
JOT: TOJ
JSÊ: SÊJ
JSÔ: SÔJ
JSÛ: JÛS
JTÂ: JÂT
JTÊ: JÊT
JWÊ: JWÊ
JWÛ: WÛJ
JYÂ: JÂY
JZÂ: ZÂJ
KKO: KOK
KLO: KLO
     KOL
     LOK
KLÂ: KLÂ
     LÂK
KLÛ: KLÛ
     LÛK
KMO: KOM
KMÂ: MÂK
KNO: KON
KNÂ: KÂN
KNÊ: KÊN
KNÔ: KÔN
     NÔK
KOP: POK
KOS: KOS
KOT: KOT
KOW: KOW
     WOK
KOZ: KOZ
     ZOK
KOÂ: ÂKO
KOÇ: ÇOK
KPÊ: KÊP
KPÛ: KÛP
KRÂ: KRÂ
KSÂ: ÂKS
KSÊ: SÊK
KSÎ: KÎS
KSÛ: KÛS
KTÂ: TÂK
KTÎ: KÎT
KTÔ: KÔT
KTÛ: KÛT
KVÊ: VÊK
KVÎ: KÎV
KWÊ: KWÊ
KYÊ: YÊK
KZÊ: KÊZ
     ZÊK
KÂÂ: ÂKÂ
KÂÇ: ÇÂK
KÇÛ: ÇÛK
     KÛÇ
LLÎ: LÎL
LMO: LOM
     MOL
LMÂ: LÂM
LMÛ: MÛL
LNO: LON
LNÊ: LÊN
LOP: POL
LOT: LOT
     TOL
LOV: VOL
LOW: WOL
LOY: YOL
LPÂ: LÂP
     PLÂ
LPÊ: PLÊ
LPÔ: PLÔ
LPÛ: LÛP
     PÛL
LSÂ: LÂS
LSÛ: LÛS
LVÊ: VLÊ
LVÛ: VLÛ
LWÊ: LWÊ
LWÛ: WÛL
LYÔ: LYÔ
MMÂ: MÂM
MMÊ: MÊM
MNO: MON
MNÂ: MÂN
     NÂM
MNÔ: MÔN
     NÔM
MNÛ: MÛN
MOO: OMO
MOP: MOP
     POM
MOS: SOM
MOV: MOV
MOW: WOM
MOY: MYO
MOZ: ZOM
MPÂ: PÂM
MPÔ: PÔM
MSÊ: MÊS
MSÔ: MÔS
MSÛ: MÛS
MTÂ: MÂT
MTÊ: TÊM
MTÔ: MÔT
     TÔM
MVÛ: VÛM
MWÊ: MWÊ
MWÔ: WÔM
MYÂ: YÂM
MZÛ: ZÛM
MÂÇ: ÇÂM
     MÂÇ
MÇÛ: MÛÇ
NNO: NON
NOP: PON
NOS: NOS
     ONS
     SON
NOT: NOT
     TON
NOW: NOW
     WON
NOY: YON
NOZ: ONZ
     ZON
NPÂ: PÂN
NPÊ: PÊN
NPÔ: PÔN
NRÂ: RÂN
NRÊ: RÊN
NSÂ: SÂN
NSÊ: SÊN
NTÂ: TÂN
NTÎ: NÎT
NTÔ: TÔN
NVÂ: VÂN
NVÊ: VÊN
NWÔ: WÔN
NYÛ: YÛN
NÂÎ: ÂNÎ
NÇÊ: ÇÊN
NÇÛ: ÇÛN
OOT: OTO
OOW: OWO
OPP: POP
OPS: POS
OPT: POT
OPV: POV
OPW: POW
OPY: POY
OPZ: POZ
OPÇ: ÇOP
     POÇ
OPÊ: ÊPO
ORÂ: ORÂ
OSS: SOS
OST: SOT
OTT: TOT
OTV: VOT
OTW: TWO
OTY: TYO
OTZ: ZOT
OTÂ: ÂTO
     OTÂ
OTÇ: ÇOT
     TOÇ
OTÛ: OTÛ
OVÇ: ÇOV
OWY: WOY
OWZ: WOZ
OWÇ: WOÇ
OÂÇ: OÇÂ
PPÔ: PÔP
PRÂ: PRÂ
     RÂP
PSÂ: PÂS
PSÊ: PÊS
     SÊP
PSÛ: PÛS
     SÛP
PTÂ: PÂT
     TÂP
PTÊ: PÊT
PTÎ: TÎP
PTÛ: PÛT
PVÛ: VÛP
PWÊ: PWÊ
PYÂ: PYÂ
PYÊ: PÊY
PYÔ: PYÔ
PÂÂ: ÂPÂ
PÇÊ: PÊÇ
PÇÔ: PÔÇ
RSÂ: RÂS
RTÂ: RÂT
RTÊ: TRÊ
RÂÇ: RÂÇ
SSÂ: SÂS
SSÛ: SÛS
STÂ: SÂT
STÊ: SÊT
STÛ: TÛS
SVÎ: SÎV
SWÊ: SWÊ
SZÔ: ZÔS
SÂÇ: ÇÂS
SÂÎ: ÎSÂ
TTÂ: TÂT
TTÎ: TÎT
TTÛ: TÛT
TVÂ: VÂT
TVÛ: VÛT
TWÔ: WÔT
TWÛ: TWÛ
     WÛT
TZÎ: ZÎT
TÂÎ: ÎTÂ
TÂÛ: ÂTÛ
TÇÛ: ÇÛT
     TÛÇ
VÂÂ: ÂVÂ
VÂÊ: ÂVÊ
WYÛ: WÛY
WÇÊ: WÊÇ
WÇÛ: WÛÇ
YÂÇ: ÇÂY
YÇÊ: ÇYÊ
