AABF: AFAB
AABK: BAKA
      KABA
AABL: LABA
AABN: ANBA
AABR: ARAB
AABT: ABAT
      ATAB
      BATA
AABZ: BAZA
AABÇ: BAÇA
AADD: DADA
AADN: ADAN
AADR: RADA
AADZ: DAZA
AAFM: AFAM
AAGG: GAGA
AAGL: GALA
AAGN: ANGA
AAGT: AGAT
AAGY: GAYA
AAJN: AJAN
AAJV: JAVA
AAKK: KAKA
AAKM: AMAK
AAKN: ANKA
      KANA
AAKR: AKRA
      KARA
AAKT: ATAK
      KATA
AAKY: KAYA
AAKZ: ZAKA
AALM: ALAM
AALP: APLA
      PALA
AALV: AVAL
AALZ: LAZA
AAMW: AMWA
AAMY: MAYA
AANR: ARAN
AANS: ASAN
AANV: AVAN
AANW: WANA
AAPP: PAPA
AAPÇ: PAÇA
AARR: RARA
AATT: TATA
AATY: YATA
AATZ: TAZA
AATÇ: ÇATA
AAVW: AVWA
AAYY: YAYA
ABBO: BABO
ABDE: BADE
      DEBA
ABDJ: DJAB
ABDL: BLAD
ABDO: DABO
      DOBA
ABDY: DYAB
ABDÂ: BÂDA
ABDÔ: BÔDA
ABDÛ: BÛDA
ABDÜ: BÜDA
ABEG: BEGA
ABEJ: BAJE
ABEL: ALBE
      BALE
ABEM: EMAB
ABEN: BENA
ABER: BARE
      RABE
ABES: ABSE
ABEV: BAVE
ABEY: BAYE
ABEZ: BAZE
ABFÔ: BAFÔ
ABGI: BAGI
ABGL: BLAG
ABGÜ: GÜBA
ABIK: BIKA
ABIL: ABIL
ABIM: ABIM
      AMIB
      MABI
ABIN: BANI
ABIR: ABRI
      RABI
ABIT: ABIT
      BATI
ABIV: BIVA
ABIY: BIYA
ABIZ: BIZA
ABIÇ: BIÇA
ABJN: BANJ
ABJÛ: BAJÛ
ABKN: BANK
ABKO: KABO
ABKR: BRAK
      KRAB
ABKÔ: KÔBA
ABKÛ: BÛKA
ABLN: BLAN
ABLO: BALO
ABLÊ: ABLÊ
ABLÔ: BALÔ
ABLÛ: ALBÛ
      BÛLA
      LABÛ
ABMÂ: MÂBA
ABNN: BANN
ABOR: RABO
ABOS: BOSA
      SABO
ABOT: BATO
ABOW: BAWO
ABOY: BAYO
ABPÊ: PÊBA
ABPÔ: PABÔ
ABRS: BRAS
ABRV: BRAV
ABRY: BRAY
ABSÂ: ABSÂ
      SÂBA
ABSÊ: BASÊ
ABTW: BWAT
ABTÂ: BATÂ
ABTÔ: BATÔ
ABTÛ: ABÛT
      TABÛ
ABWY: BWAY
ABWÂ: ÂBWA
ABWÔ: BAWÔ
ABYÛ: BÛYA
ABZÂ: BÂZA
ABZÊ: BAZÊ
ABÇÊ: ÇABÊ
ABÇÔ: ÇABÔ
ADDY: DYAD
ADEG: DEGA
      GADE
ADEJ: DEJA
ADEK: KADE
ADEL: DELA
ADEM: MADE
ADEN: ANDE
      DANE
ADEP: DEPA
ADEY: ADYE
      DAYE
ADFO: ADOF
      FADO
ADFÊ: FADÊ
ADFÜ: FÜDA
ADGO: GADO
ADGR: GRAD
ADIJ: JIDA
ADIK: DAKI
ADIM: MADI
ADIR: ARID
      RADI
ADIS: ASID
      SIDA
ADIV: AVID
ADJK: DJAK
ADJL: DJAL
ADJO: ADJO
ADJY: DJAY
ADJZ: DJAZ
ADJÊ: JADÊ
ADJÛ: JÛDA
ADKO: DAKO
      KADO
ADKY: DYAK
ADLO: DOLA
ADLY: DYAL
ADLÂ: LADÂ
ADMN: DANM
ADMR: DRAM
ADMÂ: MÂDA
      MADÂ
ADMÛ: DAMÛ
      MADÛ
ADNS: DANS
ADNÎ: ANDÎ
ADOR: RADO
ADOS: DASO
      DOSA
      ODAS
ADPÊ: PÊDA
ADPÔ: PADÔ
ADRY: DRAY
ADTW: DWAT
ADWÂ: ÂDWA
ADWÊ: ADWÊ
ADWÛ: DAWÛ
ADYZ: DYAZ
AEFK: KAFE
AEFL: AFLE
AEFN: ANFE
      FANE
AEFR: AFRE
AEFS: EFAS
AEFZ: ZAFE
AEFÇ: FAÇE
AEGG: GAGE
AEGK: KAGE
AEGL: EGAL
      GALE
      LAGE
AEGR: AGRE
AEGT: GATE
AEGV: AVEG
AEGW: AGWE
AEGY: GAYE
AEJL: LAJE
AEJM: JAME
AEJN: AJEN
      NAJE
AEJP: JAPE
AEJR: JARE
      RAJE
AEJS: SAJE
AEJZ: JAZE
AEJÇ: ÇAJE
      JAÇE
AEKL: AKLE
      KALE
AEKM: MAKE
AEKN: ANKE
      KANE
AEKP: PAKE
AEKR: KARE
AEKS: KASE
AEKT: AKTE
      EKTA
      TAKE
AEKV: AVEK
      KAVE
AEKY: AKEY
      EKAY
      KAYE
AEKZ: KAZE
AEKÇ: KAÇE
AELM: LAME
      MALE
AELN: ALEN
      ANLE
      ELAN
      LANE
AELP: APEL
      LAPE
      PALE
      PELA
AELR: RALE
AELS: ELAS
      LASE
      SALE
AELT: ALTE
      LATE
      LETA
      TALE
AELV: LAVE
      VALE
AELW: LEWA
AELY: ALYE
      LAYE
AELZ: ALEZ
      LEZA
AELÇ: ÇALE
AEMM: MAME
AEMN: AMEN
      ANME
AEMR: MARE
      MERA
      RAME
AEMS: MASE
AEMT: MATE
AEMY: EMAY
AEMÇ: ÇAME
      ÇEMA
      MAÇE
AENP: ANPE
AENT: ANTE
      ETAN
AENV: ANVE
      AVEN
      NAVE
AENW: ANWE
AEPR: APRE
      PARE
      RAPE
      REPA
AEPS: PASE
AEPT: ETAP
      PATE
      PETA
      TAPE
AEPV: EPAV
      VAPE
AEPY: APYE
      EPAY
      PAYE
AEPÇ: ÇAPE
AERT: RATE
      RETA
AERV: VARE
AERY: ARYE
      AYER
AERZ: RAZE
AERÇ: ÇARE
      RAÇE
AESV: AVES
      SAVE
AESW: ASWE
AESY: ASYE
AESZ: SEZA
AESÇ: ÇASE
      SAÇE
AETT: TATE
      TETA
AETW: WATE
AETY: TAYE
      TEYA
AETÇ: AÇTE
      TAÇE
AEVW: AVWE
AEYÇ: ÇAYE
AEÇÇ: ÇAÇE
AFFÂ: FÂFA
AFGR: GRAF
AFIÇ: AFIÇ
AFKL: FLAK
AFKN: KANF
AFKS: FAKS
AFKÛ: KAFÛ
AFLO: ALFO
AFLY: FLAY
AFLÇ: FLAÇ
AFLÊ: LAFÊ
AFLÔ: LAFÔ
AFLÛ: FÛLA
AFMN: FANM
AFMO: FOMA
AFNN: FANN
AFNO: AFON
AFNR: FRAN
AFNT: FANT
AFNÊ: ANFÊ
AFOP: FOPA
AFOS: AFOS
AFOW: AFWO
AFOÇ: ÇAFO
AFPR: FRAP
AFPÊ: PAFÊ
AFRZ: FRAZ
AFSW: SWAF
AFSÂ: ÂFAS
AFSÔ: FASÔ
AFWÔ: AFWÔ
AFÇÛ: FÛÇA
AGGN: GANG
AGIN: ANGI
      GANI
AGIP: PIGA
AGIS: SIGA
AGIT: GITA
AGIY: GIYA
AGJR: GRAJ
AGJÔ: JAGÔ
AGKÛ: KAGÛ
AGLN: LANG
AGLO: LAGO
AGLS: GLAS
AGLW: GLWA
AGLÂ: GALÂ
AGLÔ: GALÔ
AGMR: GRAM
AGNO: AGON
      OGAN
AGNR: GRAN
AGNS: SANG
AGNW: GWAN
AGNÛ: ÛGAN
AGNÜ: ÜGAN
AGOT: GATO
AGOW: AGWO
AGOY: YOGA
AGOZ: ZAGO
AGOÇ: AGOÇ
AGPR: GRAP
AGRS: GRAS
AGRV: GRAV
AGRÊ: ÊGRA
AGRÛ: RAGÛ
AGSÔ: GASÔ
AGTW: GWAT
AGTÂ: TÂGA
AGWÂ: WÂGA
AGYÂ: GAYÂ
AGZÊ: ZÊGA
AGZÔ: GAZÔ
AHMN: HANM
AHNÂ: ÂHAN
      ANHÂ
AHNÇ: HANÇ
AIJL: AJIL
      LAJI
AIJM: IMAJ
      MAJI
AIJN: IJAN
AIJY: JAYI
AIKK: KAKI
AIKM: AKIM
AIKN: KINA
AIKP: APIK
AIKS: KISA
AIKT: ATIK
AIKY: AYIK
AILP: APIL
AILR: LARI
AILS: LASI
      SILA
AILV: LAVI
      VILA
AILZ: AZIL
AIMN: ANMI
      MANI
AIMP: PAMI
AIMR: MARI
AIMT: MATI
AIMW: MIWA
AIMY: MAYI
AIMZ: MAZI
AINP: ANPI
AINR: ANRI
AINT: NATI
AINV: ANVI
      AVNI
AIPR: PARI
AIPT: PATI
      PITA
      TAPI
AIPW: WAPI
AIRS: RASI
AIRW: WARI
AIRY: RAYI
AIRÇ: RIÇA
AIST: ATIS
AISÇ: ÇASI
AITW: TIWA
AITÇ: ÇITA
AIVW: IVWA
AIVZ: VIZA
AIVÇ: AÇIV
AIÇÇ: ÇIÇA
AJKO: JAKO
AJKÛ: KAJÛ
AJLN: LANJ
AJLP: PLAJ
AJLÂ: LAJÂ
AJLÛ: JALÛ
AJMN: JANM
AJMO: MAJO
      OMAJ
AJNT: JANT
AJNY: JANY
      NYAJ
AJNZ: ZANJ
AJOT: OTAJ
AJPÛ: JÛPA
AJSÂ: AJÂS
AJVÊ: VAJÊ
AJWÂ: ÂJWA
AJÂÇ: ÂÇAJ
AKKO: KAKO
AKKR: KRAK
AKKW: KWAK
AKLN: KLAN
      LANK
AKLO: KOLA
AKLP: PLAK
AKLS: KLAS
AKLÂ: KALÂ
AKLÊ: KALÊ
AKLÛ: LAKÛ
AKMN: MANK
AKMO: KOMA
AKMÛ: MAKÛ
      MÛKA
AKNN: KANN
AKNO: AKON
      ANKO
AKNR: KRAN
AKNS: ANKS
AKNT: TANK
AKNÂ: ÂKAN
      ANKÂ
      KÂNA
AKNÇ: ÇANK
AKOP: KAPO
      OPAK
      PAKO
AKOR: RAKO
AKOT: KATO
      TAKO
AKOV: KAVO
AKOW: AKWO
      KAWO
AKOZ: AKOZ
      KAZO
AKOÇ: KAÇO
AKPS: PAKS
AKPÊ: ÊPAK
AKPÔ: KAPÔ
      KÔPA
AKPÛ: PAKÛ
AKRS: KRAS
AKRT: TRAK
AKRÊ: RÊKA
AKST: TAKS
AKSÂ: AKSÂ
AKSÔ: AKSÔ
      KÔSA
AKSÛ: SÛKA
AKTY: TYAK
AKTÇ: TÇAK
AKTÊ: TAKÊ
AKTÔ: KATÔ
AKWÛ: KÛWA
AKYÊ: KAYÊ
ALLO: LALO
ALLÊ: LALÊ
ALMN: LANM
ALMO: LAMO
ALMW: MWAL
ALMÊ: MALÊ
ALMÛ: LAMÛ
ALNP: LANP
      PLAN
ALNS: LANS
ALOR: ORAL
ALOS: ALOS
ALOT: LOTA
ALOV: LAVO
      OVAL
ALOY: LAYO
ALOÇ: LAÇO
ALPP: PLAP
ALPR: PRAL
ALPS: PLAS
ALPT: PLAT
ALPW: PLAW
      PWAL
ALPÂ: PALÂ
ALPÊ: LAPÊ
ALSV: VALS
ALSÊ: ASLÊ
ALSÔ: SALÔ
ALTW: TWAL
ALTÂ: TALÂ
ALTÔ: TALÔ
ALVW: VLAW
      VWAL
ALVÂ: LAVÂ
ALVÊ: ALVÊ
ALWÇ: ÇWAL
ALWÔ: LAWÔ
ALÂÇ: ÇALÂ
AMMN: MANM
AMNN: MANN
      NANM
AMNP: PANM
AMNT: MANT
AMNW: MWAN
AMNY: YANM
AMNÂ: AMÂN
AMNÇ: ÇANM
      MANÇ
AMOS: AMOS
AMOT: ATOM
      MATO
AMOW: MAWO
      WOMA
AMOY: MAYO
AMOZ: ZAMO
AMOÇ: ÇAMO
AMPÛ: MAPÛ
AMRÂ: RAMÂ
AMRÊ: MARÊ
AMSÔ: MASÔ
AMTÇ: MATÇ
AMTÊ: MATÊ
AMTÔ: MATÔ
AMWY: MYAW
AMWÔ: MAWÔ
      WÔMA
AMÂÇ: ÇAMÂ
ANNP: PANN
ANNR: RANN
ANNS: SANN
ANNT: TANN
ANNV: VANN
ANNÎ: ANNÎ
ANOR: ORAN
ANOS: ASON
ANOT: ANTO
      OTAN
ANOW: ANWO
      AWON
ANOÇ: OÇAN
ANPR: PRAN
      RANP
ANPS: PANS
ANPT: PANT
      TANP
ANPY: PYAN
ANPÂ: ANPÂ
      ÂPAN
ANPÊ: APÊN
ANRS: RANS
ANRT: RANT
ANRÇ: RANÇ
ANRÊ: RÊNA
ANSS: SANS
ANST: SANT
ANSÇ: ÇANS
ANSÎ: ÎSAN
ANSÔ: ANÔS
      SANÔ
ANTT: TANT
ANTV: VANT
ANTÎ: ÎTAN
ANTÛ: ANTÛ
ANVÂ: ANVÂ
      ÂVAN
ANVÊ: ANVÊ
ANWY: NWAY
ANYÇ: ÇANY
ANYÊ: ANYÊ
AOPR: RAPO
AOPT: APOT
AOPY: APOY
AOPÇ: ÇAPO
AORT: RATO
AOST: TASO
AOSW: OSWA
AOTW: AWOT
AOTY: TAYO
      YOTA
AOTZ: AZOT
AOTÇ: ÇATO
APRÂ: PARÂ
APSY: PYAS
APSÂ: PASÂ
APSÊ: ÊPAS
APTÇ: PATÇ
APTÛ: PATÛ
APVW: PWAV
APVÊ: ÊPAV
APYÊ: PAYÊ
ARST: TRAS
ARTY: TRAY
ARYÊ: ARYÊ
ASTY: TYAS
ASTÂ: SATÂ
ASTÊ: SATÊ
ASVÂ: AVÂS
ASVÊ: SAVÊ
ASVÔ: SAVÔ
ATTÔ: TATÔ
ATVÂ: VÂTA
ATYÂ: ÂTAY
AVWZ: ZWAV
AVYÔ: AVYÔ
AVÂÇ: ÇAVÂ
AWYÂ: WAYÂ
AWÂÇ: ÂÇWA
BBEE: BEBE
BBEÔ: BÔBE
BBII: BIBI
BBIÛ: BÛBI
BBOO: BOBO
BBOÊ: BÊBO
BBÂÊ: BÂBÊ
BBÂÛ: BÂBÛ
BBÔÔ: BÔBÔ
BBÛÜ: BÛBÜ
BDEO: BODE
BDEÂ: BÂDE
BDEÔ: BÔDE
      DEBÔ
BDEÛ: BÛDE
BDIR: BRID
      DRIB
BDIÂ: BÂDI
BDIÔ: BIDÔ
      BÔDI
BDJO: DJOB
BDOY: DYOB
BDOÂ: BÂDO
BDÊÛ: BÛDÊ
BEEG: BEGE
BEEK: BEKE
BEEL: BELE
BEEN: EBEN
BEER: BERE
      EBRE
BEES: BESE
BEET: TEBE
BEFI: BIFE
BEFR: BREF
BEGO: GOBE
BEGÜ: BEGÜ
BEIJ: BIJE
BEIK: BEKI
      KEBI
BEIN: BENI
BEIP: BIPE
BEIS: BISE
BEIT: BITE
BEIY: BIYE
BEJL: BELJ
BEJÂ: JÂBE
BEJÛ: BÛJE
BEKO: BOKE
BEKÊ: KÊBE
BEKÔ: BÔKE
BEKÛ: BÛKE
      KÛBE
BELM: BLEM
BELN: BLEN
BELY: BYEL
BELÂ: LÂBE
BELÛ: BÛLE
BENN: BENN
BENO: BONE
      OBEN
BENR: BREN
BENT: TENB
BENY: BENY
      BYEN
BENÊ: ÊBEN
      ENBÊ
BENÔ: BÔNE
BEOP: BOPE
BEOR: REBO
BEOS: BESO
BEOT: BOTE
BEOZ: BOZE
BERÛ: BÛRE
BESÂ: ÂBES
BESÛ: BÛSE
BETW: BWET
BETÔ: BETÔ
      BÔTE
      TÔBE
BEYÂ: ÂBYE
BEYÊ: EBYÊ
BEYÛ: BÛYE
BEÇÛ: BÛÇE
BFIO: BOFI
BFIÛ: FÛBI
BFLO: BLOF
BFOO: FOBO
BGIO: BIGO
      BOGI
BGLO: GLOB
BGOÔ: GÔBO
BGÔÛ: BÛGÔ
BIIS: SIBI
BIIÇ: BIÇI
BIJÛ: BIJÛ
      BÛJI
BIKO: KIBO
BIKR: BRIK
BIKÊ: KIBÊ
BIKÛ: BÛKI
BILÂ: BILÂ
      LÂBI
BILÛ: ÛBLI
BIMÊ: BIMÊ
BINO: BONI
BIOS: BOSI
BIOT: OBIT
      OBTI
BIOW: BIWO
BIPÔ: PIBÔ
BIRZ: BRIZ
BIRÂ: RIBÂ
BIRÊ: BIRÊ
BITÊ: BITÊ
BIYÛ: BÛYI
BIZÔ: ZÔBI
BIÇÛ: BÛÇI
BJÂÔ: BÔJÂ
      JÂBÔ
BJÔÛ: BÔJÛ
      BÛJÔ
BKLO: BLOK
BKOO: BOKO
BKOS: BOKS
BKÂÛ: BÛKÂ
BKÊÔ: KÔBÊ
BKÔÛ: BÔKÛ
BLNO: BLON
BLNÔ: BLÔN
BLOO: LOBO
BLZÛ: BLÛZ
BLÂÇ: BLÂÇ
BLÔÛ: BÛLÔ
BLÛÜ: LÜBÛ
BMNO: BONM
BMOÂ: MÂBO
BMÊÔ: MÔBÊ
BNOO: BONO
BNRÊ: BRÊN
BNWÊ: BWÊN
BOOW: WOBO
BOOY: BOYO
BOOZ: BOZO
BOPÂ: POBÂ
BOSW: BWOS
BOTÛ: BÛTO
BOWÛ: BOWÛ
      BÛWO
BRÂÇ: BRÂÇ
BTWÛ: TWÛB
BTÂÛ: TÂBÛ
BTÊÔ: BÔTÊ
BTÔÛ: BÛTÔ
BWZÔ: BWÔZ
BWÇÔ: BWÔÇ
BYÂÊ: ÂBYÊ
BYÊÛ: ÛBYÊ
BYÔÛ: BÛYÔ
BZÊÛ: BÛZÊ
BÇÔÛ: BÛÇÔ
DDEE: DEDE
DDEI: DEDI
DDOO: DODO
DEEG: DEGE
      GEDE
DEEL: DELE
      LEDE
DEEM: EDEM
DEEN: EDEN
DEEP: DEPE
DEES: DESE
      SEDE
DEEY: DEYE
DEEZ: DEZE
DEEÇ: DEÇE
DEFI: DEFI
      DIFE
DEFO: DEFO
DEFÊ: DEFÊ
DEFÜ: FÜDE
DEGI: DEGI
      DIGE
      GIDE
DEGN: DENG
DEGO: GODE
DEGY: DYEG
DEGÛ: DEGÛ
DEIJ: JEDI
DEIL: LIDE
DEIM: DEMI
      EDMI
DEIN: DENI
      DINE
DEIP: DEPI
      PEDI
      PIDE
DEIR: DIRE
      REDI
      RIDE
DEIT: DITE
      ETID
DEIV: DEVI
      DIVE
      VIDE
DEIZ: DEZI
      DIZE
DEJP: DJEP
DEJT: DJET
DEJÂ: DÂJE
      DEJÂ
DEKO: DEKO
      KODE
DEKÛ: DEKÛ
DELO: DOLE
DELÛ: DÛLE
DEMO: MODE
DEMÂ: MÂDE
DEMÊ: DEMÊ
DEMÔ: DEMÔ
DENO: DONE
DENR: DREN
DENÎ: ENDÎ
DENÛ: ÛNDE
DEOP: DEPO
DEOR: DORE
DEOS: SEDO
DEOT: TODE
DEOW: WODE
DEOY: DEYO
      YODE
DEOÇ: ÇODE
DEPÂ: DEPÂ
      PEDÂ
DERT: DRET
DERÂ: DÂRE
DERÎ: REDÎ
DESÂ: DÂSE
      DESÂ
DESÊ: DESÊ
DESÎ: SEDÎ
DESÔ: SÔDE
DESÛ: DÛSE
      SÛDE
DETW: DWET
DETY: DYET
      TYED
DETÂ: DETÂ
      TÂDE
DETÎ: DETÎ
DETÔ: DÔTE
DETÛ: DETÛ
      DÛTE
DEVÂ: DEVÂ
DEWÔ: WÔDE
DEYZ: DYEZ
DEYÂ: ÂDEY
DEZÂ: DEZÂ
DFIO: DIFO
DFOW: FWOD
DFOÊ: DOFÊ
DGIO: DIGO
DGIÔ: GIDÔ
DGOO: GODO
DGOW: DWOG
DGÊÛ: GÛDÊ
DIIM: IMID
      MIDI
DIIR: DIRI
DIJO: JIDO
      JODI
DIJP: DJIP
DIKÔ: KÔDI
DILO: IDOL
DILR: DRIL
DILÊ: LÊDI
DIMO: DOMI
      MODI
DINÊ: DINÊ
DIOR: RIDO
DIOY: IYOD
DIPÎ: DIPÎ
DIRV: DRIV
DIRÂ: DIRÂ
DISÛ: DÛSI
DITÂ: DÂTI
      DITÂ
DITÛ: DITÛ
      TÛDI
DIVÂ: DIVÂ
DIVÊ: DIVÊ
DIWÔ: WÔDI
DIYÊ: ÊDIY
DIZÂ: DIZÂ
DIZÔ: DIZÔ
DJKO: DJOK
DJLO: DJOL
DJMÂ: DJÂM
DJNÊ: DJÊN
DKNO: DONK
DKOY: DYOK
DKOÔ: KÔDO
      KODÔ
DKOÛ: DÛKO
DKÎÔ: KÔDÎ
DKÔÔ: KÔDÔ
DLOW: DWOL
DLOY: DYOL
DMNO: MOND
DMWÛ: DWÛM
DMYÂ: DYÂM
DMÂÊ: DÂMÊ
DMÊÊ: DÊMÊ
DMÊÔ: MÔDÊ
DNOY: DONY
DNOÂ: DÂNO
      DONÂ
DNÂÂ: ÂNDÂ
DNÂÔ: DÔNÂ
DNÊÔ: DÔNÊ
DOOY: ODYO
DOSÛ: DOSÛ
DOTÂ: DOTÂ
DOVÛ: VODÛ
DOVÜ: VODÜ
DPÂÂ: PÂDÂ
DPÂÛ: ÂPÛD
DPÊÛ: PÊDÛ
DRÂÎ: RÂDÎ
DTÂÔ: TÂDÔ
DTÊÔ: ÊDÔT
DVÂÛ: DÛVÂ
DYÊÊ: ÊDYÊ
DYÔÛ: DÛYÔ
DZÂÛ: DÛZÂ
DÂÇÊ: ÇÊDÂ
EEFF: FEFE
EEFL: FELE
EEFR: FERE
      REFE
EEFS: FESE
EEFT: FETE
EEFZ: FEZE
EEGR: REGE
EEGT: GETE
EEGZ: ZEGE
EEHL: HELE
EEJL: JELE
      LEJE
EEJM: JEME
EEJN: EJEN
      JENE
EEJR: JERE
EEJT: JETE
EEJZ: JEZE
EEKR: REKE
EEKS: EKSE
      SEKE
EEKT: KETE
      TEKE
EEKV: EVEK
EEKÇ: EÇEK
EELM: MELE
EELP: EPLE
      LEPE
EELR: LERE
      RELE
EELS: LESE
      SELE
EELT: LETE
EELV: ELEV
      ELVE
      LEVE
EELZ: ZELE
EELÇ: EÇEL
EEMT: METE
EEMY: MEYE
EENP: ENPE
EENR: NERE
EENS: SENE
EENV: NEVE
      VENE
EENW: WENE
EENY: NEYE
EENÇ: ÇENE
EEPP: PEPE
EEPS: PESE
EEPT: PETE
EEPY: PEYE
EEPZ: PEZE
EEPÇ: PEÇE
EERS: SERE
EERT: RETE
      TERE
EERV: REVE
EEST: SETE
EESV: SEVE
      VESE
EESY: SEYE
EESÇ: ÇESE
      SEÇE
EETT: TETE
EETV: VETE
EETW: WETE
EETÇ: ÇETE
EEVV: VEVE
EEVY: VEYE
EEVÇ: ÇEVE
EEWÇ: EÇWE
EEYZ: ZEYE
EEÇÇ: ÇEÇE
EFGR: GREF
EFGÛ: FÛGE
EFIL: FILE
EFIR: FERI
      FIRE
EFIS: FESI
EFIZ: FIZE
      ZEFI
EFJO: FOJE
      JEFO
EFJÛ: FÛJE
EFKÛ: FÛKE
EFLM: FLEM
EFLR: FREL
EFLY: FYEL
EFLÂ: ÂFLE
      LÂFE
EFLÇ: FLEÇ
EFLÛ: FÛLE
EFMO: FOME
EFMÂ: FEMÂ
EFMÊ: FEMÊ
EFNN: NENF
EFNR: FREN
EFNT: FENT
EFNÂ: ÂFEN
EFOR: FORE
EFOV: OFEV
EFOÇ: ÇOFE
EFRT: FRET
      TREF
EFRZ: FREZ
EFRÛ: FÛRE
EFSÔ: FÔSE
EFTW: FWET
EFTÊ: FÊTE
EFTÛ: TÛFE
EFVY: FYEV
EFYÛ: FÛYE
EFZÂ: FEZÂ
EFÂÇ: ÂÇEF
EFÇÛ: FÛÇE
EGIM: GIME
EGIR: GERI
EGIV: VIGE
EGIW: EGWI
      IGWE
EGIÇ: GIÇE
EGJN: JENG
EGKR: GREK
EGLR: GREL
EGLÂ: ÂGLE
EGLÊ: GÊLE
      LEGÊ
EGLÔ: LÔGE
EGNN: GENN
EGNP: PENG
EGNT: TENG
EGNÔ: GENÔ
EGNÛ: GENÛ
EGOR: REGO
EGOT: GETO
EGOV: VOGE
EGOY: OGEY
EGOÇ: GOÇE
EGPR: GREP
EGRS: GRES
EGRV: GREV
EGRY: GREY
EGRÂ: ÂGRE
      ÂREG
EGTÂ: GÂTE
      TÂGE
EGTÊ: ÊTEG
EGTÛ: GÛTE
EGYÛ: GÛYE
EGZÎ: ZEGÎ
EIJJ: JIJE
EIJM: JEMI
EIJN: JENI
EIJP: PIJE
EIJR: JIRE
EIJS: SIJE
EIJY: JIYE
EIJZ: JEZI
EIKL: KILE
      LIKE
EIKM: MEKI
EIKP: EKIP
      KEPI
      PIKE
EIKR: EKRI
EIKT: ETIK
      KITE
      TIKE
EIKV: VIKE
EIKY: KEYI
      KIYE
EIKÇ: ÇIKE
EILP: PILE
EILS: ELIS
      ILSE
      LISE
EILT: ELIT
      ITLE
      LETI
      LITE
EILV: LIVE
EILZ: ZILE
EIMN: IMEN
      MINE
EIMP: PEMI
EIMR: MERI
EIMS: MESI
      SEMI
EIMT: TIME
EIMZ: MEZI
      MIZE
EIMÇ: ÇIME
EINP: ENPI
EINV: VENI
EINÇ: ÇENI
      NIÇE
EIPR: PERI
      PIRE
EIPS: EPIS
      PESI
      PISE
      SIPE
EIPV: VIPE
EIPY: PEYI
      PIYE
EIPZ: ZEPI
      ZIPE
EIRS: RESI
      SERI
      SIRE
EIRT: IRET
      TIRE
EIRV: REVI
      RIVE
      VIRE
EIRZ: RIZE
EIRÇ: ÇERI
      ÇIRE
      RIÇE
EIST: SITE
EISV: SEVI
      VESI
      VISE
EISY: ISYE
      SIYE
EISZ: SEZI
      SIZE
EITY: TIYE
EIVV: VIVE
EIVZ: VIZE
EIVÇ: ÇIVE
EJKÂ: KÂJE
EJKÔ: KÔJE
EJKÛ: JÛKE
EJLN: LENJ
EJLO: LOJE
EJLY: LYEJ
EJLÔ: LÔJE
EJMÂ: MÂJE
EJMÊ: JEMÊ
EJNN: JENN
EJNS: SENJ
EJNT: JENT
EJNW: JWEN
EJNÂ: JENÂ
EJNÛ: JENÛ
EJOP: POJE
EJPY: PYEJ
EJPÔ: EPÔJ
EJRÂ: JERÂ
      RÂJE
EJRÛ: JÛRE
EJSY: SYEJ
EJSÂ: SEJÂ
EJSÔ: SÔJE
EJTW: JWET
EJTÂ: JÂTE
EJVY: VYEJ
EJVÂ: VÂJE
EJWZ: JWEZ
EJWÔ: WÔJE
EJYÂ: JEYÂ
EJÂÇ: ÇÂJE
      EÇÂJ
EJÇÔ: ÇÔJE
EKKO: KOKE
EKKR: KREK
EKLO: EKOL
      KOLE
      LOKE
      OKLE
EKLÛ: KÛLE
EKMO: KOME
      MOKE
EKMR: KREM
EKMÂ: MÂKE
EKMÔ: KÔME
EKNN: KENN
EKNO: KONE
      NEKO
EKNP: KENP
EKNS: SENK
EKNV: VENK
EKNW: KWEN
EKNY: YENK
EKNZ: KENZ
      ZENK
EKOP: EPOK
      POKE
EKOR: KORE
EKOS: EKOS
      OKES
EKOT: KOTE
      OKET
      TOKE
EKOV: KOVE
EKOZ: KOZE
EKOÇ: ÇOKE
      KOÇE
EKPÂ: KÂPE
EKPÊ: PEKÊ
EKPÎ: KÎPE
EKPÔ: KÔPE
EKPÛ: KÛPE
EKRT: KRET
EKRÂ: EKRÂ
EKRÇ: KREÇ
EKRÊ: REKÊ
EKRÛ: KÛRE
EKSS: SEKS
EKSY: SYEK
EKSÂ: KÂSE
EKSÊ: ÊSEK
      SÊKE
EKSÛ: SEKÛ
      SÛKE
EKTÂ: ÂKET
EKTÊ: KÊTE
EKTÔ: KÔTE
EKTÛ: KÛTE
EKVÛ: KÛVE
EKWÛ: EKWÛ
      KÛWE
EKYÊ: ÊKYE
EKZÔ: KÔZE
EKÇÛ: KÛÇE
ELMO: LEMO
      MOLE
ELMW: MWEL
ELMY: MYEL
ELMÂ: LÂME
      LEMÂ
ELMÔ: MELÔ
ELMÛ: MÛLE
ELNN: LENN
ELNO: LENO
ELNP: PLEN
ELNV: VLEN
ELNW: LWEN
      NWEL
ELOP: POLE
ELOS: OSLE
      SOLE
ELOT: LOTE
      OTEL
ELOV: VOLE
ELOY: OLYE
ELOZ: LEZO
ELPW: PWEL
ELPÊ: PELÊ
ELSY: SYEL
ELSÂ: LÂSE
ELSÔ: LESÔ
      SELÔ
ELSÛ: SÛLE
ELTW: TWEL
ELTÂ: LETÂ
ELTÇ: TÇEL
ELTÊ: ÊTEL
ELTÛ: ÛLET
ELVW: VWEL
ELVÂ: LÂVE
ELVÊ: LEVÊ
ELWÛ: WÛLE
EMMN: MENM
EMMÂ: MÂME
EMNO: MONE
EMNS: MENS
EMNT: TENM
EMNW: MWEN
EMNÛ: NEMÛ
EMOR: REMO
EMOS: SOME
EMOT: MOTE
EMOV: MOVE
EMOÇ: ÇOME
EMPÂ: PEMÂ
EMPÔ: MÔPE
EMRÔ: REMÔ
EMSY: MSYE
EMSÂ: SEMÂ
EMTW: MWET
EMTY: MYET
EMTÂ: MÂTE
EMTÔ: MÔTE
EMWÂ: ÂMWE
EMWÛ: WÛME
EMYÛ: MÛYE
EMZÂ: MÂZE
EMÂÇ: MÂÇE
      MEÇÂ
EMÇÊ: ÇEMÊ
EMÇÔ: MÔÇE
EMÇÛ: MÛÇE
ENNO: ONNE
ENNP: PENN
ENNR: RENN
ENNS: SENN
ENNV: VENN
ENNÇ: ÇENN
ENOP: ENPO
ENOR: RENO
ENOT: NOTE
      ONET
ENOZ: ONZE
ENPS: PENS
      SENP
ENPT: PENT
ENPW: PWEN
ENPY: PENY
ENPÇ: PENÇ
ENRT: TREN
ENST: SENT
ENSW: SWEN
ENSY: NYES
ENTÂ: ÂTEN
      TÂNE
ENTÊ: ÊTEN
      ETÊN
ENTÔ: ÔNET
      TÔNE
ENVÂ: ÂVEN
      NEVÂ
ENVÊ: NEVÊ
ENWÇ: WENÇ
ENYZ: NYEZ
ENYÇ: ÇYEN
EOPP: POPE
EOPR: PORE
      REPO
EOPS: ESPO
EOPT: EPOT
      POTE
EOPW: EWOP
EOPZ: POZE
EORS: ORES
      RESO
EORT: RETO
EORZ: REZO
EORÇ: REÇO
EOSS: SESO
EOST: SOTE
EOSV: SEVO
      SOVE
      VESO
EOSW: SOWE
      WOSE
EOSÇ: ÇOSE
EOTV: VOTE
EOTW: WOTE
EOTY: ETYO
EOVY: VOYE
EOWZ: WOZE
      ZEWO
EOÇÇ: ÇOÇE
EPPÔ: PÔPE
EPPÛ: PÛPE
EPRS: PRES
EPRT: PRET
EPRV: PREV
EPRÂ: ÂPRE
EPRÇ: PREÇ
EPSW: PWES
EPSY: PYES
EPSÂ: PÂSE
      SEPÂ
EPSÊ: PÊSE
EPSÛ: PÛSE
      SÛPE
EPTW: PWET
EPTÂ: ETÂP
      TÂPE
EPTÎ: TÎPE
EPVY: PYEV
EPWÔ: PEWÔ
      WÔPE
EPWÛ: PEWÛ
EPZÔ: ZEPÔ
EPÂÇ: PÂÇE
ERST: TRES
ERSÂ: RÂSE
ERSÊ: RÊSE
      SERÊ
ERTT: TRET
ERTZ: TREZ
ERTÂ: ÂTRE
ERTÊ: TERÊ
ERYÔ: REYÔ
ERZÊ: REZÊ
ERZÔ: REZÔ
ERÂÇ: ÇERÂ
ESSÂ: ESÂS
      SÂSE
ESSÊ: SÊSE
ESSÛ: SÛSE
ESTÂ: ÂSET
      SÂTE
ESTÊ: SETÊ
ESTÛ: TÛSE
ESVÂ: EVÂS
      VÂSE
ESVÊ: ÊVES
ESZÔ: SEZÔ
ETTW: TWET
ETTÂ: ÂTET
      TÂTE
ETVÂ: VÂTE
ETVÛ: VÛTE
ETWÂ: WETÂ
ETWÇ: ÇWET
ETWÔ: WÔTE
ETYÛ: TÛYE
ETZÊ: TEZÊ
ETÂÇ: ÇÂTE
ETÇÊ: ÇÊTE
ETÇÛ: ÇÛTE
      TÛÇE
EVWÔ: VEWÔ
EVYY: VYEY
EVÇÔ: ÇEVÔ
EWYÛ: WÛYE
EWZÛ: WÛZE
FFÊÊ: FÊFÊ
FFÛÛ: FÛFÛ
FFÛÜ: FÛFÜ
FGII: FIGI
FGIR: GRIF
FIIN: FINI
FIIT: FITI
      TIFI
FIIZ: FIZI
FIJO: JOFI
FIJW: JWIF
FIKS: FIKS
FILO: FILO
      FOLI
FILT: FILT
      FLIT
FILÛ: FÛLI
FIMÂ: FÂMI
FIMÊ: ÊFIM
      FIMÊ
FIMÛ: FÛMI
FINÂ: NÂFI
FINÛ: FÛNI
FIOP: PIFO
FIOR: OFRI
FIOS: OFIS
FIOÇ: ÇOFI
FIRZ: FRIZ
FIRÛ: FÛRI
FISW: SWIF
FIWÑ: FWIÑ
FIÇÔ: ÇIFÔ
FJOÔ: FOJÔ
FKLÂ: FLÂK
FKOÔ: KÔFO
FKRÊ: FRÊK
FKWÊ: FWÊK
FLMÂ: FLÂM
FLNÂ: FLÂN
FLOÇ: FLOÇ
FLPÛ: FLÛP
FMOÂ: ÂFOM
FNNO: FONN
FNOW: FWON
      WONF
FNOÛ: FÛNO
      ÛNFO
FNRÊ: FRÊN
FNWÊ: FWÊN
FNÊÊ: FÊNÊ
FNÊÛ: FÛNÊ
FOOT: FOTO
FORÂ: RÂFO
FOWÛ: FÛWO
FYZÛ: FYÛZ
FÇÔÛ: FÛÇÔ
GGOO: GOGO
GGOW: GWOG
GGÂÂ: GÂGÂ
GGÂÊ: GÊGÂ
GHÂÜ: HÜGÂ
GIJO: JIGO
GIJR: GRIJ
GIMÊ: MÊGI
GINZ: ZING
GINÊ: GINÊ
GIOR: RIGO
GIOS: OGIS
GIOV: GOVI
GIPR: GRIP
GIRY: GRIY
GIZÂ: ÂGIZ
      ZÂGI
GKNO: KONG
GKOÔ: KÔGO
GLNO: LONG
GLNÂ: GLÂN
GLOP: PLOG
GLOS: GLOS
GLOT: GLOT
GLÂÔ: LÔGÂ
GMNO: GONM
GMOÂ: MÂGO
GMÂÊ: ÊGÂM
GMÊÔ: GÔMÊ
GMÊÛ: GÛMÊ
GNOZ: ZONG
GNRÂ: GRÂN
GNRÊ: GRÊN
GNÂÛ: ÛNGÂ
GOOS: SOGO
GOSW: GWOS
GOTW: GWOT
GOVÂ: ÂVOG
GOWÂ: ÂGWO
GOÂÇ: ÇÂGO
GPWÛ: GWÛP
GRTÊ: TRÊG
GRÂÂ: ÂGRÂ
GRÂÊ: ÂGRÊ
GTÂÊ: GÊTÂ
HISÜ: HÜSI
IIJR: JIRI
IIKN: INIK
IIKP: PIKI
IILT: ITIL
IIMM: MIMI
IIMS: IMIS
IIMÇ: ÇIMI
IINP: PINI
IINR: IRIN
IINV: VINI
IINZ: IZIN
IINÇ: ÇINI
IIPP: PIPI
IIPT: PITI
IIRS: IRIS
IISS: SISI
IIST: ISIT
      TISI
IITW: WITI
IIVV: VIVI
IIZZ: ZIZI
IIÇÇ: ÇIÇI
IJKÂ: KIJÂ
IJMO: JIMO
IJMÂ: JIMÂ
IJNO: JONI
IJNÂ: ÂJIN
IJNÊ: JÊNI
IJOS: OJIS
IJPÔ: JIPÔ
      PIJÔ
IJSÂ: IJÂS
IJSÊ: ÊJIS
IJTÂ: JÂTI
IJWÛ: WÛJI
IKKO: KOKI
IKKR: KRIK
IKKÂ: KIKÂ
IKLO: KILO
IKLS: KLIS
IKLT: KILT
IKMO: KOMI
IKMR: KRIM
IKMW: MWIK
IKMÊ: KIMÊ
IKNN: KINN
IKNÂ: ÂNIK
      KÂNI
      KINÂ
IKOP: KOPI
IKOS: SIKO
IKOT: OKIT
IKPÂ: PIKÂ
IKPÛ: KÛPI
      PÛKI
IKRT: TRIK
IKRZ: KRIZ
IKRÇ: KRIÇ
IKRÛ: KÛRI
IKSV: VIKS
IKSW: KWIS
IKSÎ: SIKÎ
IKSÔ: KÔSI
IKTW: KWIT
IKTÂ: ÂTIK
IKTÛ: KÛTI
IKVW: KWIV
IKYÂ: YÂKI
ILLW: LWIL
ILMP: PLIM
ILMÊ: LIMÊ
ILMÔ: LIMÔ
ILOP: POLI
ILOS: SILO
ILOT: LOTI
ILOV: OLIV
      OVIL
ILPS: PLIS
ILPT: PLIT
ILPÂ: ÂPIL
ILPÔ: PILÔ
ILPÛ: PÛLI
ILTÊ: LITÊ
ILYÂ: ÂLIY
ILYÊ: LIYÊ
IMNÊ: MINÊ
IMOR: MORI
IMOV: VOMI
IMOY: MIYO
IMOZ: MIZO
IMPÂ: PIMÂ
IMRÛ: MÛRI
IMSÂ: SIMÂ
IMSÊ: SIMÊ
IMSÔ: SIMÔ
IMTÂ: MÂTI
      MITÂ
IMTÊ: ÊTIM
IMTÜ: TIMÜ
IMVÔ: VÔMI
IMZÂ: ÂZIM
      ZÂMI
IMÇÊ: ÇIMÊ
INNO: INON
INOV: NIVO
INRÂ: RÂNI
INRÊ: RINÊ
INRÛ: NÛRI
INSÛ: ÛNSI
INTÛ: NITÛ
      TÛNI
INYÔ: INYÔ
IOPS: SIPO
IOPT: PITO
      TOPI
IOST: SITO
      SOTI
IOSW: SIWO
IOSZ: SIZO
IOTT: OTIT
      TITO
      TOTI
IOTY: TIYO
IPRS: PRIS
IPRT: TRIP
IPRZ: PRIZ
IPRÛ: PÛRI
IPSÛ: SÛPI
IPTÂ: PÂTI
      TÂPI
IPTÊ: PÊTI
      PITÊ
IPTÔ: PITÔ
IPTÛ: TÛPI
IPWÔ: WÔPI
IPÇÔ: PIÇÔ
IRST: TRIS
IRSÛ: SÛRI
IRVÛ: ÛVRI
ISSÂ: SÂSI
ISSÛ: SÛSI
ISTW: TWIS
ISTÂ: SÂTI
      SITÂ
ISTÊ: SÊTI
ISTÛ: SITÛ
ISVW: SWIV
ISYÊ: SIYÊ
ISYÔ: SIYÔ
ISÂÇ: ÇÂSI
ITTÇ: TÇIT
ITWZ: ZWIT
ITYÂ: ÂTIY
ITYÔ: TIYÔ
ITZÛ: ZÛTI
IVVÂ: VIVÂ
IWZÑ: ZWIÑ
IWZÛ: WÛZI
IYÇÔ: ÇIYÔ
JJÛÛ: JÛJÛ
JKOO: JOKO
JLOO: OLOJ
JLWÂ: LWÂJ
JMÂÛ: JÛMÂ
JMÛÛ: JÛMÛ
JNNO: JONN
JNOS: SONJ
JNWÊ: JWÊN
JNÊÊ: JÊNÊ
JNÊÛ: JÛNÊ
JTÛÛ: TÛJÛ
KKOO: KOKO
KKOW: KWOK
KKOÊ: KOKÊ
KKOÔ: KOKÔ
KKÊÊ: KÊKÊ
KKÔÛ: KÔKÛ
KKÛÛ: KÛKÛ
KKÛÜ: KÛKÜ
KLOO: KOLO
      LOKO
KLOP: PLOK
KLOÂ: KOLÂ
KLOÇ: KLOÇ
KLOÔ: KOLÔ
KMOO: MOKO
KMOW: KWOM
KMOÂ: KOMÂ
KMÂÛ: KÛMÂ
KNNO: KONN
      NONK
KNOT: KONT
KNOÂ: KÂNO
KNOÊ: KONÊ
      OKÊN
KNWÂ: KWÂN
KNWÊ: KWÊN
KNÂÛ: KÛNÂ
KNÊÔ: KÔNÊ
KNÛÛ: KÛNÛ
KOOP: POKO
KOOY: KOYO
KOPÂ: KÂPO
      PÂKO
KOPÊ: KOPÊ
KORÂ: KORÂ
KOSY: KYOS
KOTW: KWOT
      TWOK
KOTÔ: KOTÔ
KOTÛ: KÛTO
KOZÂ: KÂZO
KOÂÇ: ÇOKÂ
KOÇÔ: KOÇÔ
KPRÂ: KRÂP
KPSÊ: PÊKS
KPWÛ: KWÛP
KPÔÛ: KÛPÔ
KRÂÛ: KÛRÂ
KSÂÔ: KÂSÔ
KSÊÛ: KÛSÊ
KTWÛ: KWÛT
KTÂÔ: KÂTÔ
      KÔTÂ
KTÂÛ: TÂKÛ
KTÔÛ: KÔTÛ
KWÛÛ: WÛKÛ
KYÂÛ: KÛYÂ
KYÛÛ: ÛYKÛ
KZÊÛ: KÛZÊ
KÇÛÜ: ÇÛKÜ
LLOO: LOLO
LMOÂ: LÂMO
LMÂÂ: LÂMÂ
LMÂÊ: LÂMÊ
LMÂÛ: LÂMÛ
LMÊÔ: LÔMÊ
LMÊÛ: MÛLÊ
LNOP: PLON
LNOY: LYON
LNOÊ: LONÊ
LNPÊ: PLÊN
LNYÂ: LYÂN
LNÊÔ: LÔNÊ
LOOS: SOLO
LOOV: OVOL
LOPP: PLOP
LOPT: PLOT
      POLT
LOTV: VOLT
LOTÊ: LÊTO
LOVY: VYOL
LOVÂ: VOLÂ
LOWÛ: WÛLO
LPTÂ: PLÂT
LPTÊ: PLÊT
LPÂÇ: PLÂÇ
LPÂÛ: ÂPÛL
LPÊÛ: PÛLÊ
LSÂÂ: LÂSÂ
LTYÛ: TYÛL
LTÂÔ: LÔTÂ
LTÊÛ: LÛTÊ
LZÛÛ: ZÛLÛ
MMOÂ: MOMÂ
MMÂÂ: MÂMÂ
MMÛÛ: MÛMÛ
MNNO: MONN
      NONM
MNOO: OMON
MNOP: PONM
MNOS: MONS
MNOT: MONT
      TONM
MNOW: WONM
MNYÂ: MYÂN
MNÂÂ: MÂNÂ
MNÊÊ: MÊNÊ
MNÊÔ: MÔNÊ
      NÔMÊ
MOOS: MOSO
MOPY: MYOP
MOSÂ: OSMÂ
MOSÔ: SOMÔ
MOTÂ: MÂTO
MOWÂ: WOMÂ
MOWÊ: OMWÊ
MPÂÊ: PÂMÊ
MPÔÛ: PÛMÔ
MRÂÛ: MÛRÂ
MRÊÊ: RÊMÊ
MSWÊ: MWÊS
MSYÂ: SYÂM
MSÂÂ: ÂSÂM
MTÂÊ: TÂMÊ
MTÂÛ: TÛMÂ
MTÔÛ: MÛTÔ
MWÊÛ: WÛMÊ
NNOP: PONN
NNOT: TONN
NNOW: WONN
NNOÂ: NÂNO
NNÂÂ: NÂNÂ
NOOY: NOYO
NOPP: PONP
NOPY: PYON
NOPÂ: PÂNO
NOPÇ: PONÇ
NOSZ: ZONS
NOSÔ: OSNÔ
NOTW: TWON
      WONT
NOVÛ: NÛVO
NOZÂ: ZÂNO
NPWÊ: PWÊN
NRTÂ: TRÂN
NRTÊ: TRÊN
NSÊÊ: SÊNÊ
NSÊÔ: SÔNÊ
NTÂÂ: ÂTÂN
NTÂÊ: TÂNÊ
NTÊÛ: TÛNÊ
NVYÂ: VYÂN
NVÂÊ: VÂNÊ
NWÔÔ: WÔNÔ
NYZÛ: NYÛZ
OOPT: POTO
OOPW: POWO
OOTW: TOWO
OOWW: WOWO
OOWZ: WOZO
OOYY: YOYO
OOZZ: ZOZO
OPPW: PWOP
OPSÊ: PÊSO
OPSÛ: PÛSO
OPTW: TWOP
OPTÂ: OTÂP
OPWZ: PWOZ
ORYÂ: ORYÂ
OSÇÔ: ÇOSÔ
OTTY: TYOT
OTTÂ: TÂTO
OTVÂ: VOTÂ
OTVÛ: VOTÛ
OTÂÇ: ÂTOÇ
OTÇÔ: TOÇÔ
OYYÜ: YOYÜ
PPÂÂ: PÂPÂ
PPÂÊ: PÊPÂ
PPÔÔ: PÔPÔ
PPÛÛ: PÛPÛ
PRSÊ: PRÊS
PSÂÛ: PÛSÂ
PTWÊ: PWÊT
PTYÛ: PYÛT
      TYÛP
PTÂÂ: ÂPÂT
      PÂTÂ
PTÂÊ: PÂTÊ
      TÊPÂ
PTÂÔ: TÂPÔ
PTÂÛ: PÛTÂ
PTÇÎ: TÇÎP
PZÂÛ: PÂZÛ
PÂÇÛ: ÇÂPÛ
PÇÊÊ: PÊÇÊ
RTTÂ: TRÂT
RTÂÇ: TRÂÇ
SSYÂ: SYÂS
SSÛÛ: SÛSÛ
STÂÊ: ÂSÊT
STÂÎ: ÂSÎT
STÊÊ: ÊSTÊ
STÊÛ: TÛSÊ
SVÂÊ: VÊSÂ
SVÂÛ: SÛVÂ
SYÂÊ: ÂSYÊ
SÂÇÔ: ÇÂSÔ
TTÂÂ: ÂTÂT
TTÂÛ: TÛTÂ
TTÊÊ: TÊTÊ
TTÔÔ: TÔTÔ
TTÛÛ: TÛTÛ
VVÔÔ: VÔVÔ
VVÛÛ: VÛVÛ
VVÜÜ: VÜVÜ
VZÂÛ: VÛZÂ
WÂÂÇ: ÂÇWÂ
ZZÔÔ: ZÔZÔ
ZZÛÜ: ZÛZÜ
ÇÇÛÛ: ÇÛÇÛ
