AAADL: ALADA
AAADR: ARADA
AAAKZ: AZAKA
AAANN: ANANA
AABBL: LABAB
AABBY: BABAY
AABDN: BANDA
AABDR: BARAD
AABFI: AFIBA
AABGR: GRABA
AABGS: BAGAS
AABGY: BAGAY
AABIL: ALABI
AABJR: BARAJ
AABJÛ: ABAJÛ
AABKO: ABAKO
AABKP: KAPAB
       PABAK
AABKR: BARAK
AABKS: KASAB
AABKT: KATAB
       TABAK
AABLN: BANAL
AABLP: PALAB
AABLR: RALBA
AABMN: MANBA
AABNS: ABSAN
       SANBA
AABNT: BATAN
AABNW: ANBWA
AABNZ: BANZA
AABPS: PASAB
AABRS: BRASA
AABRT: RABAT
AABTY: BATAY
AADEZ: AZADE
AADFS: FASAD
AADGI: AGIDA
AADGL: LAGAD
AADIY: AYIDA
AADJÊ: AJÊDA
AADKN: KADNA
AADKO: AKADO
AADKS: KADAS
       SAKAD
AADKV: KADAV
AADLM: MALAD
AADLN: LADAN
AADLS: SALAD
AADLY: DALYA
AADLÊ: ALADÊ
AADMN: MADAN
       MANDA
AADNW: ANDWA
AADPR: PARAD
AADRÇ: ÇARAD
AADTW: ADWAT
AADVW: DAVWA
AADVY: DAYVA
AADWZ: ADWAZ
AADYY: YAYAD
AAEGS: AGASE
AAEJM: AJAME
AAEKL: ALEKA
AAEKT: ATAKE
AAEKY: AKAYE
AAEMT: AMATE
AAETÇ: ATAÇE
AAFFN: FANFA
AAFGR: AGRAF
AAFKR: FRAKA
       KARAF
AAFLN: FANAL
AAFLR: RAFAL
AAFLW: LAFWA
AAFLÊ: ALAFÊ
AAFLÛ: ALÛFA
AAFMY: MAFYA
AAFNS: ANFAS
AAFPR: PARAF
AAFPW: PAFWA
AAFRT: FATRA
AAFTY: TAFYA
AAGJR: GARAJ
AAGKY: GAYAK
AAGLN: GALAN
AAGLT: GALTA
AAGMM: MAGMA
AAGNT: TANGA
AAGNW: WANGA
AAGNY: GAYAN
AAGPR: AGRAP
AAGSÂ: AGASÂ
AAGWÛ: AGAWÛ
AAHNN: ANHAN
AAIMT: AMATI
AAINS: ANASI
AAINÇ: ANAÇI
AAIPT: APATI
AAIRY: ARIYA
AAJKÛ: AKAJÛ
AAJLN: LAJAN
AAJLR: LARAJ
AAJLV: LAVAJ
AAJLW: LAJWA
AAJLY: ALYAJ
AAJMS: MASAJ
AAJNS: AJANS
AAJNW: ANJWA
       NAJWA
AAJNÇ: ANÇAJ
AAJPT: PATAJ
       TAPAJ
AAJPÛ: AJÛPA
AAKKM: MAKAK
AAKKO: KAKAO
AAKKS: KAKAS
AAKKZ: KAZAK
AAKLL: LAKAL
AAKLM: KALMA
AAKLN: KALAN
       KANAL
AAKLR: LARAK
AAKLW: LAKWA
AAKLY: LAKAY
AAKNN: ANKAN
       KANNA
AAKNS: AKSAN
AAKNV: KANVA
AAKNÛ: ANÛKA
AAKOV: AVOKA
AAKOW: AKAWO
AAKPW: KAPWA
AAKPY: KAPAY
AAKRT: TRAKA
AAKRW: KARAW
AAKRÑ: KARAÑ
AAKSV: KASAV
AAKSÂ: AKASÂ
AAKTY: TYAKA
AAKVY: KAVYA
AAKÇÔ: AKAÇÔ
AALLS: LASAL
AALLW: LALWA
AALMT: MATLA
AALMÊ: ALAMÊ
AALNP: PALAN
AALNT: TALAN
AALNV: LAVAN
       NAVAL
AALNÇ: ÇALAN
AALOS: ALASO
AALPW: PALWA
AALRT: LARAT
AALST: ATLAS
AALSV: SAVAL
AALSÇ: LAÇAS
AALTY: LATYA
       TYALA
AALTÇ: TÇALA
AALVW: LAVWA
       VWALA
AALVY: LAVAY
AALWY: WAYAL
AALWÛ: ALAWÛ
AAMNN: AMANN
AAMNR: RAMAN
AAMNÇ: ÇAMAN
AAMSY: MASAY
       MAYAS
AAMWZ: AMWAZ
AAMWÇ: MAÇWA
AANNP: ANPAN
AANNV: ANVAN
AANOW: AWONA
AANPR: PARAN
AANPS: PASAN
AANST: SATAN
AANSV: AVANS
AANTV: VANTA
AANTY: ANTAY
AANVW: AVWAN
AANVÇ: ÇAVAN
AANWY: WAYAN
AANWÇ: ANÇWA
AAOPW: APAWO
AAPPP: PAPAP
AAPPY: PAPAY
AAPRT: ATRAP
AAPRÂ: APARÂ
AAPST: SAPAT
AAPSW: PASWA
       PAWAS
AAPSY: PASAY
       PAYAS
AAPTT: PATAT
AAPTÇ: PAÇAT
AARRY: RARYA
AARWZ: RAZWA
AASSÊ: ASASÊ
AASTÛ: ATÛSA
AATTÂ: ATÂTA
AATTÔ: ATATÔ
AATÂÇ: ATAÇÂ
AAWYÛ: AWÛYA
ABBEL: BABEL
ABBEY: BABYE
ABBIL: LABIB
ABBIN: BABIN
ABBIÇ: BABIÇ
ABBMÛ: BÛMBA
ABBNÊ: BANBÊ
ABBNÛ: BANBÛ
ABBOO: ABOBO
ABBOP: POBAB
ABDDO: ADBOD
ABDEN: BANDE
ABDEO: ABODE
ABDET: DEBAT
ABDEV: ADVEB
ABDIN: BADIN
       BANDI
ABDIR: DIRAB
ABDJÂ: BÂDAJ
ABDJÛ: DJÛBA
ABDNO: BANDO
       BONDA
       DONAB
ABDNÊ: BADNÊ
ABDNÔ: DÔNAB
ABDNÛ: BÛNDA
ABDOY: BADYO
ABDRÛ: BÛRAD
ABDÂÔ: ABÔDÂ
ABEES: ABESE
ABEFL: BAFLE
ABEFR: BAFRE
ABEFW: BAFWE
ABEFZ: FEZAB
ABEGL: BLAGE
       GABEL
       LEGBA
ABEGT: BAGET
ABEIM: ABIME
ABEIT: ABITE
ABEIY: ABIYE
ABEIZ: ABIZE
       AZIBE
ABEJL: ALJEB
ABEJN: JANBE
ABEKN: BEKAN
ABEKR: BRAKE
       KABRE
       KRABE
ABEKS: KABES
ABEKÂ: ÂBAKE
ABELM: BLAME
ABELN: ABLEN
       BALEN
       LANBE
ABELO: EBOLA
ABELR: LEBRA
ABELS: SABLE
ABELV: VEBAL
ABELZ: BLAZE
ABELÂ: ÂBALE
ABEMT: BATEM
ABENO: ABONE
ABENP: PENBA
ABENS: ANBES
       BASEN
ABENW: BENWA
ABENY: ANBYE
       BANYE
ABENZ: BAZEN
ABENÇ: ÇABEN
ABEOR: AREBO
ABERS: BRASE
ABERT: BARET
       REBAT
ABERY: BARYE
ABEST: ESTAB
ABETV: BAVET
ABETW: BWATE
ABETY: BETAY
ABETÂ: ÂBATE
ABEWY: BWAYE
ABEWZ: BWAZE
ABFNO: BAFON
ABFWÔ: BÔFWA
ABGIJ: GABJI
ABGIY: BIGAY
ABGLO: GALBO
ABGLÛ: BÛLGA
ABGMÛ: GÛMBA
ABGNÛ: GÛNBA
ABGOÂ: ÂBAGO
ABGYÔ: GABYÔ
ABIIS: ISIBA
ABIKR: BARIK
ABIKÇ: KABIÇ
ABILM: LABIM
ABILN: BILAN
       LANBI
ABILO: ABOLI
ABILS: BALIS
ABILT: TABLI
ABILY: BLAYI
ABILZ: BALIZ
       BAZIL
ABIMN: MINAB
ABIMÂ: ABIMÂ
ABIMÊ: ABIMÊ
ABINR: RIBAN
ABINT: BITAN
ABINÇ: ÇABIN
ABIRT: BATRI
ABIST: BATIS
ABISW: SIBWA
ABISY: BASIY
ABITY: TIBYA
ABITÂ: ABITÂ
ABITÛ: ABÛTI
ABIVV: VIVAB
ABIZÂ: ABIZÂ
ABJLO: BOJLA
ABJNÔ: BÔJAN
       JANBÔ
ABJWÛ: BÛJWA
ABKLO: BOKAL
ABKLÂ: BÂKAL
       LABÂK
ABKLÔ: BALKÔ
ABKNO: KABON
       KONBA
ABKNÂ: KABÂN
ABKNÛ: BÛKAN
ABKOT: TABOK
ABKOW: BAWOK
ABKOY: KOBAY
ABKOÇ: KABOÇ
ABKPÛ: KÛPAB
ABKRÂ: BRÂKA
ABKTÔ: KÔBAT
       KÔTAB
ABLMO: ALBOM
ABLMÛ: MABÛL
ABLNO: BALON
ABLNÂ: BÂNAL
ABLNÇ: BLANÇ
ABLNÊ: BALÊN
ABLOS: BOSAL
ABLOT: TABLO
ABLSÂ: BALÂS
ABLSÊ: SÊBAL
ABLTÊ: TÊBAL
ABLVÛ: BÛLVA
ABLÂÂ: ÂBALÂ
ABLÂÇ: BLÂÇA
ABMNO: MANBO
ABMNÂ: BAMÂN
ABNOP: PABON
       POBAN
ABNOT: BATON
       NOTAB
ABNOW: BAWON
ABNOÇ: ÇABON
ABNOÊ: ABONÊ
ABNRÇ: BRANÇ
ABNTÛ: TANBÛ
ABNYÊ: ANBYÊ
ABORV: BRAVO
ABOVW: BOVWA
ABPWÊ: BWAPÊ
ABPWÛ: PÛBWA
ABRVÛ: BRAVÛ
       ÛVRAB
ABSSÂ: ABSÂS
ABSTÊ: ABSÊT
ABSWÔ: BÔSWA
       BWASÔ
ABSYÛ: BYASÛ
ABTVÂ: BAVÂT
ABVZÛ: BÛVAZ
ABWWÔ: BWAWÔ
ABWYÛ: BÛYWA
ABWZÂ: ÂBWAZ
ABYYÛ: BÛYAY
ADDEG: DEGAD
ADEFN: FADEN
ADEFO: ADEFO
ADEGJ: DJAGE
       GADJE
ADEGR: GRADE
ADEGY: DYAGE
ADEJK: DJAKE
ADEJN: DANJE
       DEJAN
       JADEN
ADEJW: DEJWA
ADEKO: AKODE
ADEKR: KADRE
ADEKW: DEKWA
ADEKY: DYAKE
ADEKÇ: ÇADEK
ADELP: PEDAL
ADEMM: MEDAM
ADEMN: MANDE
ADEMR: MADER
       MADRE
ADEMS: DESAM
ADEMT: ADMET
ADEMY: DAMYE
       MEDAY
ADEMÇ: DEMAÇ
ADEMÊ: ADEMÊ
ADENP: DEPAN
       PEDAN
       PENDA
ADENR: DANRE
ADENS: DANSE
       DESAN
ADENT: DETAN
       TANDE
ADENV: DEVAN
ADENW: ADWEN
ADENY: ANDEY
ADENZ: DEZAN
ADEOR: ADORE
ADEPR: DAPRE
       PADRE
ADERS: ADRES
ADERY: DYARE
ADEST: ESTAD
ADESV: DEVAS
ADESZ: DEZAS
ADETW: DETWA
       DWATE
       TWADE
ADETY: DETAY
ADEVW: DEVWA
ADEYÇ: DEÇAY
ADFIN: DAFNI
ADFNÛ: FÛNDA
ADGIR: GADRI
ADGIT: DATIG
ADGKO: GADKO
ADGLÂ: ÂGLAD
ADGNO: GONAD
ADGRÊ: GRADÊ
ADGRÔ: DRAGÔ
ADGYÊ: GADYÊ
ADGYÛ: GÛYAD
ADIJY: DJAYI
ADIKT: DIKTA
ADIKÂ: ÂDAKI
ADIMS: SAMDI
ADINR: DIRAN
ADINS: SADIN
ADINT: DANTI
       DITAN
ADINV: DIVAN
ADINW: DAWIN
ADINZ: DIZAN
ADIPR: RAPID
ADIPS: PADSI
ADIRT: IDRAT
ADISW: DISWA
ADISÛ: ADÛSI
ADITW: DWATI
ADIWÔ: AWÔDI
ADIYY: DYAYI
ADJMN: DJANM
ADJMO: DOMAJ
ADJMÂ: JÂDAM
ADJWÊ: ADJWÊ
ADKKO: KODAK
       KOKAD
ADKLÛ: DÛKLA
ADKOS: KODAS
ADKOÊ: ADOKÊ
ADKRÂ: KADRÂ
ADKSÂ: KADÂS
ADLMO: LAMOD
ADLNÂ: LADÂN
ADLOS: SOLDA
ADLPÔ: DAPLÔ
ADLPÛ: PALÛD
ADLSÂ: SÂDAL
ADLSÛ: LASÛD
ADMMÂ: MADÂM
ADMNO: NOMAD
ADMNY: DYANM
ADMNÊ: DANMÊ
ADMOP: POMAD
ADMOS: MOSAD
ADMPÔ: PÔMAD
ADMTÛ: MÛTAD
ADMYÂ: DYAMÂ
ADNNO: DANNO
       DONAN
ADNNÂ: ÂNDAN
       ANNDÂ
ADNNÔ: DÔNAN
ADNOP: PADON
ADNOT: DOTAN
       TONAD
ADNPÂ: PÂDAN
       PANDÂ
ADNPÛ: ANPÛD
ADNRÎ: RANDÎ
ADNTÔ: TANDÔ
ADNVÛ: DÛVAN
ADNWY: DWANY
ADNZÛ: DÛZAN
ADNÇÊ: ÇÊDAN
ADNÊÔ: ADÔNÊ
ADOPR: DRAPO
ADORT: RADOT
ADORY: RADYO
ADPSÛ: PÛSAD
ADPTÊ: PÊTAD
ADWÇÔ: ÇADWÔ
ADYÂÇ: ÇÂDAY
AEEFS: AFESE
       EFASE
AEEGL: EGALE
AEEGR: EGARE
AEEJT: ETAJE
AEEKL: ALEKE
AEEKT: EKATE
AEELL: ALELE
AEELT: ETALE
AEELW: ALEWE
AEEMY: EMAYE
AEEPZ: APEZE
AEERT: ARETE
AEFIM: AFIME
AEFIÇ: AFIÇE
AEFJM: FEMAJ
AEFJR: JEFRA
AEFJY: FEYAJ
AEFKL: FEKAL
AEFKT: FAKTE
AEFKW: KWAFE
AEFLN: ANFLE
       LAFEN
       LANFE
AEFLR: RAFLE
AEFLT: FLATE
AEFLZ: FALEZ
AEFLÂ: ÂFALE
AEFLÇ: FLAÇE
AEFMN: FEMAN
AEFMT: FEMAT
AEFMÊ: AFEMÊ
AEFNN: ANFEN
AEFNP: PAFEN
AEFNW: FENWA
AEFNZ: FEZAN
AEFNÂ: ÂNAFE
AEFNÇ: ANÇEF
AEFOÇ: EÇAFO
AEFPR: FRAPE
AEFPY: PYAFE
AEFRW: FWARE
AEFRY: FERAY
AEFRZ: FRAZE
AEFST: ESTAF
       SAFTE
AEFSW: FWASE
AEFTY: FETAY
AEFTÛ: ATÛFE
AEFVÂ: ÂFAVE
AEFWY: FWAYE
AEGJR: GRAJE
AEGJÂ: ÂGAJE
AEGLL: LEGAL
AEGLM: GAMEL
AEGLN: ANGLE
AEGLP: PELAG
AEGLS: GLASE
       LASEG
AEGLT: GALET
AEGMR: GRAME
AEGMT: GAMET
AEGNR: ANGRE
       ANREG
       ENGRA
       GRENA
AEGNT: GANTE
       TANGE
AEGNY: GANYE
AEGNZ: ZENGA
AEGNÂ: ÂNEGA
AEGRT: GRATE
AEGRV: GRAVE
AEGTZ: EGZAT
       GAZET
AEGTÂ: AGÂTE
AEGTÇ: GAÇET
AEIJL: ALEJI
       ELAJI
AEIJT: AJITE
AEIKL: AKILE
AEIKY: AKEYI
AEIKZ: AKIZE
AEILN: ANILE
AEILT: ALITE
AEILZ: ALIZE
AEIMN: AMINE
       ANEMI
       ANIME
AEIMZ: AMEZI
       AMIZE
AEINP: EPINA
AEIPS: APESI
AEIPT: APETI
AEIPY: APIYE
AEIRS: ASIRE
AEIRT: ATERI
       ATIRE
AEITV: AVETI
AEIVZ: AVIZE
AEIYZ: EZAYI
AEJKN: KANJE
AEJKW: JEKWA
AEJLN: LANEJ
AEJLS: LAJES
AEJLV: ELVAJ
AEJLÑ: LAJEÑ
AEJLÔ: ALÔJE
AEJMN: MANJE
       MENAJ
AEJMS: MESAJ
AEJNN: JENAN
AEJNO: AJENO
AEJNR: JERAN
       RANJE
AEJNS: SEJAN
AEJNT: JANTE
AEJNV: VAJEN
       VANJE
AEJNY: JEYAN
AEJNÇ: ÇANJE
       EÇANJ
AEJNÛ: AJENÛ
       AJÛNE
AEJRT: JARET
       TRAJE
AEJRÂ: ÂRAJE
AEJTÂ: AJÂTE
AEJTÛ: AJÛTE
AEJWY: JWAYE
AEJÂÇ: ÂÇAJE
AEKKR: AKREK
       KRAKE
AEKKW: KWAKE
AEKKÂ: ÂKAKE
AEKLM: KALME
AEKLN: KALEN
       KANEL
AEKLP: PEKAL
       PLAKE
AEKLR: LAKRE
       RAKLE
AEKLS: KLASE
       SAKLE
AEKLT: KALTE
       KATEL
       KLATE
       LAKET
AEKLV: KALVE
AEKLY: KALYE
AEKLÊ: ALEKÊ
AEKMN: MANKE
AEKMR: KAREM
       REMAK
AEKMS: MASKE
AEKMT: MAKET
AEKNP: ENPAK
       KANPE
AEKNR: EKRAN
       RENKA
AEKNS: KANSE
AEKNT: ANKET
       NEKTA
       TAKEN
AEKNY: KAYEN
AEKNZ: KAZEN
AEKNÊ: ÊKANE
AEKOT: AKOTE
AEKPS: PASKE
AEKPT: KAPTE
       PAKET
AEKPW: KWAPE
AEKRS: KARES
       SAKRE
AEKRT: KARET
       KATRE
       RAKET
AEKRZ: KRAZE
AEKRÇ: KRAÇE
AEKST: KASET
AEKSW: SEKWA
AEKTT: TAKET
       TAKTE
AEKTY: KATYE
       TYAKE
AEKTZ: AZTEK
       EKZAT
AEKTÇ: KAÇTE
       KEÇAT
       TÇAKE
AEKWZ: KWAZE
AEKYÂ: AKEYÂ
AEKÇÛ: AKÛÇE
AELLN: LALEN
AELLS: LASEL
AELMN: LANME
       LEMAN
       MALEN
AELMR: MAREL
AELMS: LAMES
       MASEL
       MELAS
AELMT: MALET
       METAL
AELMÑ: MALEÑ
AELNO: ALONE
AELNP: LAPEN
       PLANE
AELNR: LAREN
       RENAL
AELNS: ASLEN
       LANSE
AELNT: LETAN
AELNV: ALVEN
       LANVE
AELOP: OPALE
AELPR: PRALE
       PRELA
AELPS: PLASE
AELPT: PALET
       PETAL
AELPY: LAPYE
AELPÇ: ÇAPEL
       ÇAPLE
       LAPEÇ
AELST: LASET
       SALTE
AELSV: VALSE
AELSW: LESWA
AELSY: LASYE
       SALYE
AELTT: ATLET
AELTV: TAVLE
       VALET
AELTW: ETWAL
AELTÇ: LATÇE
AELTÑ: LATEÑ
AELVW: VWALE
AELVY: LAVEY
AELVÂ: ALÂVE
AELVÇ: ÇEVAL
AELVÊ: ALEVÊ
AELWY: LWAYE
AELYÇ: ÇALYE
AEMMN: MANME
AEMMW: MEMWA
AEMNP: PEMAN
AEMNR: MAREN
AEMNS: SEMAN
AEMNT: MANTE
       MATEN
       METAN
AEMNV: MANEV
AEMNW: ANMWE
AEMNY: MANYE
AEMNZ: MANZE
AEMNÇ: MANÇE
       MEÇAN
AEMOS: AMOSE
AEMRT: TREMA
AEMRY: MARYE
       RAMYE
AEMRÛ: AMÛRE
AEMST: MASTE
AEMTY: MATYE
       MAYET
AEMTZ: MAZET
AEMWY: MWAYE
AEMWÇ: MAÇWE
AENNP: APENN
AENNR: RENNA
AENNT: ANTEN
       TANNE
AENNV: ANVEN
       NEVAN
AENNY: ANYEN
AENPR: ANPRE
AENPS: ENPAS
       PANSE
       SEPAN
AENPT: ETANP
       TANPE
AENPV: ENPAV
AENPY: PANYE
       PAYEN
AENPÇ: PANÇE
AENRS: RANSE
AENRT: ANTRE
AENRY: ARYEN
AENRÇ: ÇERAN
AENSS: ESANS
       SANSE
AENST: ANSET
       SANTE
       SATEN
AENSV: EVANS
       SAVEN
       VANSE
AENSÔ: ANÔSE
AENTT: ANTET
       TANTE
AENTV: NAVET
       VANTE
AENTW: WETAN
AENTY: TENAY
AENTÇ: ÇANTE
AENVY: VANYE
AENWY: NWAYE
AEORT: ORATE
AEOTV: AVOTE
AEOWZ: AWOZE
AEPPP: PEPAP
AEPPY: PAPYE
AEPRS: PARES
AEPRT: PARET
       TRAPE
AEPRY: PAREY
       PARYE
AEPRZ: RAPEZ
AEPRÂ: ÂPARE
AEPST: PASTE
AEPSW: ESPWA
AEPTY: PAYET
AEPTÂ: APÂTE
AEPTÇ: PATÇE
AEPYÂ: ÂPAYE
AERST: TERAS
       TRASE
AERSW: SWARE
AERTV: RAVET
       TRAVE
AERTY: RETAY
AERTÂ: ÂRETA
AERTÇ: ÇARET
       ÇATRE
AERVY: VARYE
AERVZ: VAREZ
AERYÇ: ÇARYE
AESSÂ: ASÂSE
AESTT: ESTAT
AESTY: ASYET
AESVÂ: AVÂSE
AESWÂ: AWESÂ
AESWÇ: SEÇWA
AESZÔ: ASEZÔ
AETTW: ETWAT
AETTY: TEYAT
AETWZ: TWAZE
AETWÛ: AWÛTE
AETYZ: TAYEZ
AETYÇ: ÇATYE
AFGIT: FATIG
AFIJR: JIRAF
AFIKN: KANIF
AFIKT: AKTIF
       FAKTI
AFIKW: KWAFI
AFILS: FASIL
       SILFA
AFIMN: FAMIN
       FANMI
AFIMS: MASIF
AFINN: NANFI
AFINR: FARIN
AFINT: NATIF
AFINY: NAYIF
AFINÇ: FAÇIN
AFISS: SIFAS
AFISÇ: FAÇIS
AFITY: FAYIT
AFIWZ: WAZIF
AFKLN: FLANK
AFKLO: FOKAL
AFKLÔ: FLAKÔ
AFKLÛ: KALFÛ
AFLMN: FLANM
AFLMÂ: FLAMÂ
AFLNN: FLANN
AFLNO: LAFON
AFLNÂ: FÂNAL
AFLOR: RALFO
AFLPÔ: PLAFÔ
AFLYÛ: FÛLAY
AFMNO: ANFOM
AFNOR: RANFO
AFNOS: FASON
AFNOW: AFWON
AFOYÇ: ÇOFAY
AFPRÂ: FRAPÂ
AFSWÂ: SÂFWA
AFSYÂ: FAYÂS
AGGIT: GAGIT
AGGNÂ: GÂGAN
       GAGÂN
       GANGÂ
AGGNÊ: GÊGAN
AGGOO: AGOGO
AGGOT: GAGOT
AGILR: GALRI
AGILS: GLASI
AGILÛ: AGÛLI
AGIMÂ: AGIMÂ
AGINO: AGONI
AGINP: PINGA
AGINW: IGWAN
AGINZ: ANGIZ
       ZANGI
AGITÛ: AGÛTI
AGJLÂ: LÂGAJ
AGJLÊ: LAJÊG
AGJNO: JAGON
AGKLÛ: KAGÛL
AGKRÂ: KARÂG
AGLLÛ: LÛGAL
AGLMÊ: MALÊG
AGLMÛ: MAGÛL
AGLNN: GLANN
AGLNO: GALON
AGLNÔ: LÔGAN
AGLOP: GALOP
AGLTÊ: LATÊG
AGMNO: MANGO
AGMNÊ: ÊGANM
AGMÂÂ: AGÂMÂ
AGNNR: GRANN
AGNNÛ: ÛNGAN
AGNOS: GASON
AGNOV: ANVOG
AGNOW: ANGWO
       GWANO
AGNOY: YOGAN
AGNOZ: GAZON
AGNOÇ: ÇANGO
AGNRÂ: ÂGRAN
       ANGRÂ
AGNRÊ: ANGRÊ
       GRÊNA
AGNTÊ: GÊTAN
AGOWÂ: AWOGÂ
AGOYZ: GAZOY
AGRTÊ: GRATÊ
AGRTÔ: GRATÔ
AGRYÔ: GARYÔ
AGRÇÊ: ÇAGRÊ
AGVYÛ: GÛYAV
AGVÂÛ: AVÂGÛ
AIILV: AVILI
AIJKM: MAJIK
AIJKN: KIJAN
AIJKS: JISKA
AIJLV: VILAJ
AIJLZ: LIZAJ
AIJMN: JIMAN
AIJMR: MIRAJ
AIJNN: ANJIN
AIJNS: IJANS
AIJNT: JANTI
AIJRT: TIRAJ
AIJRV: RIVAJ
       VIRAJ
AIKKN: KANIK
       KIKAN
AIKKS: KASIK
AIKKZ: ZIKAK
AIKLM: KALMI
       KLIMA
AIKLT: TIKAL
AIKMN: KINAM
AIKMR: MIRAK
AIKMY: KAMIY
AIKNN: ANNIK
       KANNI
       KINAN
AIKNP: PAKIN
       PIKAN
AIKNT: ANTIK
AIKNY: YANKI
AIKPW: PIKWA
AIKPY: KIPAY
AIKPZ: ZIKAP
AIKPÛ: AKÛPI
AIKST: SAKIT
       TAKSI
AILLN: LALIN
AILLP: LAPLI
AILLV: LAVIL
AILLY: LALIY
AILLÑ: LALIÑ
AILMP: APLIM
AILMR: LARIM
AILMS: ISLAM
       MALIS
AILMT: MILAT
AILMY: MALIY
       MILYA
AILMÂ: ALIMÂ
AILNP: ANPIL
AILNS: SALIN
AILNV: LAVNI
AILNY: ANLIY
AILPT: PILAT
       PLATI
AILRT: ILTRA
AILRV: AVRIL
AILSS: SISAL
AILSV: SALIV
AILSY: SIYAL
AILSZ: SIZAL
AILTV: VITAL
AILVZ: VALIZ
AILVÇ: ÇIVAL
AILYÊ: ALIYÊ
AIMMT: MAMIT
AIMNO: AMONI
AIMNP: PIMAN
AIMNR: MARIN
AIMNS: SIMAN
AIMNT: MANTI
       MITAN
AIMNZ: ANZIM
       ZANMI
AIMNÇ: MAÇIN
AIMOT: AMOTI
AIMRY: MIRAY
AIMWZ: MWAZI
AIMYÛ: MIYAÛ
AIMZÂ: AMIZÂ
AINNR: RANNI
AINOV: ANIVO
AINPT: PANTI
       TANPI
AINPV: PAVNI
AINRS: RASIN
AINRT: TANRI
AINRV: RAVIN
AINSS: SANSI
AINST: SANTI
       SITAN
AINSW: NWASI
AINSÇ: ÇANSI
AINTY: ANTIY
AINVV: VIVAN
AINVY: VANIY
AINWÇ: ÇINWA
AIOSS: ASOSI
AIOST: ASOTI
AIOTÇ: ATIÇO
AIPPY: PAPIY
AIPRT: PIRAT
AIPSW: PISWA
AIPSÛ: ASÛPI
AIPTÇ: ÇAPIT
AIPYY: PIYAY
AIRSV: VARIS
AIRSY: SIRAY
AIRTT: ATRIT
AIRTY: TIRAY
       TRAYI
AIRTÂ: ATIRÂ
AIRTÇ: ÇARIT
AISTW: ISTWA
AISYÊ: ASIYÊ
AITTW: TWATI
AITVW: VWATI
AITVÂ: AVÂTI
AITZÂ: ATIZÂ
AIVYÂ: ÂVAYI
AIWZÇ: ÇWAZI
AIYZÂ: AYIZÂ
AJKLO: KALOJ
AJKMO: JOKMA
AJKOS: KOSAJ
AJKRÛ: KÛRAJ
AJLNW: LWANJ
AJLNÛ: JÛNAL
AJLOR: LORAJ
AJLOV: JAVLO
AJLRÔ: RALÔJ
AJMNÛ: JÛMAN
AJMSÊ: JASMÊ
AJMÂÇ: ÇAJMÂ
AJNOS: JONAS
AJOSV: SOVAJ
AJRTÛ: ÛTRAJ
AJTÂÊ: AJÂTÊ
AJVÂÛ: AVÂJÛ
AKKNO: KAKON
AKKTÔ: KÔTAK
AKKVÔ: KÔKAV
AKKWÛ: KWAKÛ
AKKYÂ: KAYÂK
AKKYÊ: KÊKAY
AKLLO: ALKOL
       LAKOL
       LOKAL
AKLMÂ: KALMÂ
AKLMÛ: MALÛK
AKLNO: KOLAN
AKLNÂ: KÂNAL
AKLOR: KORAL
AKLOT: KALOT
       KOLTA
       LAKOT
AKLOV: VOKAL
AKLOZ: LAKOZ
AKLOÇ: KALOÇ
AKLPÂ: ÂPLAK
AKLSÔ: KALSÔ
AKLVÊ: KALVÊ
AKMNO: KOMAN
       MAKON
AKMNÛ: KÛMAN
AKMOÇ: KOÇMA
AKMTÛ: MAKÛT
AKMYÔ: KAMYÔ
AKNNO: KANNO
AKNNW: KWANN
AKNNÛ: KÛNAN
AKNOP: KANPO
       KAPON
       KONPA
       PANKO
AKNOR: KORAN
AKNOS: AKSON
       KONSA
AKNOT: KATON
AKNOZ: KANZO
AKNOÇ: ÇOKAN
AKNPR: KRANP
AKNRÂ: KARÂN
AKNRÛ: KÛRAN
AKNSÔ: KANSÔ
AKNTÔ: KANTÔ
       KÔTAN
AKNTÛ: TANKÛ
AKNYÂ: KÂNAY
AKNYÛ: KÛYAN
AKOPR: KRAPO
AKOPT: KAPOT
AKORY: KORAY
AKOST: KASTO
AKOTW: KAWOT
AKOTZ: KATOZ
AKPTÂ: PÂKAT
AKPYÔ: KÔPAY
AKRTÂ: KARÂT
       KATRÂ
AKRTÔ: KÔTRA
AKRWÊ: RAKWÊ
AKRYÛ: KÛRAY
AKSTÔ: KÔSTA
AKSVÂ: VAKÂS
AKSVÊ: VAKSÊ
AKSYÔ: AKSYÔ
AKTVÂ: KÂTAV
AKTWÔ: KÔTWA
AKTYÛ: KÛTAY
AKTÂÛ: ÂTÛKA
AKTÇÛ: KATÛÇ
AKWYÂ: KWAYÂ
ALMMÂ: MALMÂ
ALMNO: LANMO
       NOMAL
ALMNÂ: LÂMAN
       LANMÂ
ALMNÊ: LANMÊ
ALMNÛ: LANMÛ
ALMOR: MORAL
ALMOT: LAMOT
       MATLO
ALMOY: MAYOL
ALMPÂ: PALMÂ
ALMSÊ: MASLÊ
ALMTÂ: MÂTAL
ALMTÔ: LATÔM
ALMVÂ: LAVMÂ
ALMÂÇ: LAÇÂM
ALNNY: LYANN
ALNOS: SALON
ALNOT: TALON
ALNOV: VOLAN
ALNOW: LAWON
ALNPT: PLANT
ALNPÇ: PLANÇ
ALNPÛ: ANPÛL
ALNSÂ: LANSÂ
       LÂSAN
ALNTÔ: LÔTAN
ALNWÔ: LAWÔN
ALOPS: LAPOS
       SALOP
ALOPT: PALTO
       PLATO
ALOPV: VALOP
ALOPW: PAWOL
ALORY: LORAY
ALOSY: SOLAY
ALOTT: TOTAL
ALOTÇ: ÇALOT
ALOVY: VOLAY
ALOWY: WOYAL
ALOWÇ: LAWOÇ
ALOYÇ: LAÇOY
ALPSÂ: ÂPLAS
ALPSÛ: LASÛP
ALPTÂ: ÂPLAT
ALPTÔ: PLATÔ
ALPÇÊ: ÇAPLÊ
ALPÇÛ: ÇALÛP
ALSSÂ: SÂSAL
ALSSÛ: LASÛS
ALSTÊ: LASÊT
ALSTÛ: LATÛS
ALSVÊ: VALSÊ
ALSYÂ: ALYÂS
ALSYÊ: LAYÊS
ALTVÂ: LAVÂT
ALTÂÛ: ALÂTÛ
AMMNO: MOMAN
AMMNÂ: MÂMAN
       MANMÂ
AMMWÊ: MÊMWA
AMNNÂ: MÂNAN
       MANNÂ
AMNOS: MASON
       OSMAN
AMNOT: MANTO
       MATON
AMNOW: MAWON
       WOMAN
       WONMA
AMNPÊ: PANMÊ
AMNRÊ: MARÊN
AMNRÛ: MÛRAN
AMNSY: SYANM
AMNSÂ: ANSÂM
       ÂSANM
AMNSÔ: MASÔN
AMNTÊ: TANMÊ
AMNTÛ: TÛMAN
AMNYÊ: MANYÊ
AMNÂÇ: MAÇÂN
AMOTT: TOMAT
AMOTY: MATYO
AMOTÇ: MATÇO
AMOWY: WAYOM
AMOYÇ: ÇOMAY
AMPÇÊ: PAÇMÊ
AMRTÂ: RATMÂ
AMRYÊ: MARYÊ
AMSWÊ: MASWÊ
AMSWÔ: MWASÔ
AMTTÂ: MATÂT
AMTYÔ: MÔTAY
AMWYÊ: MWAYÊ
AMWÇÛ: MÛÇWA
AMYÇÔ: ÇÔMAY
ANNNO: NANNO
ANNNÂ: NÂNAN
       NANNÂ
ANNOP: PANNO
ANNOS: ANONS
       SANON
ANNOZ: ZANNO
ANNRT: TRANN
ANNTÂ: ANTÂN
       ÂTANN
ANNTÊ: TANNÊ
ANNVY: VYANN
ANNVÊ: VANNÊ
ANOPT: OTANP
ANOPY: PONYA
       PYANO
ANORY: ORYAN
ANOSV: SAVON
ANOTT: TANTO
       TATON
ANOTV: VOTAN
ANOTY: TAYNO
ANOTÇ: ANTOÇ
ANOVY: AVYON
ANOWY: NWAYO
ANOYZ: OZANY
       ZONAY
ANPPÂ: PANPÂ
       PÂPAN
ANPPÊ: PÊPAN
ANPRÂ: APRÂN
ANPRÊ: PARÊN
ANPSÛ: PÛSAN
ANPTÂ: ANPÂT
       ÂPANT
       PANTÂ
       PÂTAN
ANPTÊ: PANTÊ
       TÊPAN
ANPTÔ: TANPÔ
ANPTÛ: PÛTAN
ANPWÔ: NAPWÔ
ANPYÊ: PANYÊ
ANPZÛ: PANZÛ
ANPÂÂ: ÂPÂNA
ANPÇÛ: ÇANPÛ
ANRTT: TRANT
ANRTÇ: TRANÇ
ANRYÔ: RANYÔ
ANSSY: SYANS
ANSTÊ: ANSÊT
ANSTÎ: ANSÎT
ANSVÂ: SAVÂN
ANSVÊ: VÊSAN
ANSVÛ: SÛVAN
ANSWÛ: SÛNWA
ANSYÊ: ANSYÊ
ANSYÔ: NASYÔ
ANSÇÔ: ÇANSÔ
ANTTÂ: ANTÂT
       ÂTANT
ANTTÛ: TÛTAN
ANTWÂ: ÂTWAN
ANTÊÔ: TAÔNÊ
ANVZÛ: VÛZAN
ANVÂÂ: ÂNAVÂ
ANWÂÇ: ÂÇWAN
       ANÇWÂ
AOOST: ASOTO
AOOWY: AWOYO
AOPPS: PASPO
AOPPT: PAPOT
AOPTY: POTAY
AORSV: VORAS
AORSY: RASYO
AORSÂ: ARÂSO
AORTÇ: RAÇOT
AORYÇ: ÇARYO
AOTTW: TWOTA
AOWZZ: ZWAZO
APSTÂ: PATÂS
APSWÔ: PWASÔ
APSYÔ: PASYÔ
APSÂÂ: ÂPASÂ
APTTÂ: PATÂT
APTWÔ: PATWÔ
APTÂÂ: ÂPATÂ
APTÂÇ: ÇAPÂT
APVWÛ: PÛVWA
APWZÔ: PWAZÔ
APYÂÇ: ÇÂPAY
ARTVÂ: ÂTRAV
ARVWÂ: RÂVWA
ASSÂÊ: ÂSASÊ
ATVYÂ: VÂTAY
ATYÂÇ: ÇÂTAY
AVWYÂ: VWAYÂ
AVWZÊ: VWAZÊ
BBEEL: BEBEL
BBENO: BENBO
       BONBE
BBENÂ: BÂBEN
BBEOÇ: BOBEÇ
BBIIT: BIBIT
BBILO: BIBLO
BBINO: BOBIN
BBIWÔ: BIBWÔ
BBKÂÛ: BÛKBÂ
BBMOÊ: BÊMBO
BBNOÔ: BÔBON
       BONBÔ
BBNÛÛ: BÛBÛN
BBOOT: BOBOT
BBOOY: BOBOY
BBORÊ: BOBRÊ
BBOÂÇ: BÂBOÇ
BBSÂÔ: BÔBÂS
BBTÛÛ: BÛBÛT
BBYÛÛ: BÛBÛY
BBÇÔÛ: BÔBÛÇ
BDEIJ: BIDJE
BDEIR: BRIDE
       DEBRI
BDEIT: BIDET
BDEJO: DJOBE
BDELO: BLODE
       BODEL
       DOBLE
BDELÊ: BLÊDE
BDELÛ: DÛBLE
BDEMO: BODME
BDENO: BONDE
       DEBON
BDENÛ: BÛDEN
BDEOW: BWODE
BDEOY: DYOBE
BDEYÊ: DEBYÊ
BDEYÔ: BÔDYE
BDIIR: IBRID
BDIKO: KIBOD
BDILO: BIDOL
BDILÛ: DÛBLI
BDINO: BIDON
       BONDI
BDISÛ: BÛDIS
BDJOÂ: BÂDJO
BDLÔÛ: DÛBLÔ
BDOOW: BODWO
BDOYÔ: DÔBOY
BDSÂÔ: BÔDÂS
BDTÛÛ: DÛBÛT
BEEET: EBETE
BEEGL: BEGLE
BEEGW: BEGWE
BEEGÂ: ÂBEGE
BEEKN: KENBE
BEELM: BELME
       MEBLE
BEELR: REBEL
BEELS: BELSE
       BLESE
BEELT: BELTE
BEELV: VEBLE
BEELÇ: ÇELBE
BEENN: ENBEN
BEENT: BENET
       TENEB
BEENY: BENYE
       EBYEN
BEERT: BRETE
BEERV: BREVE
BEERZ: BEZER
BEETV: VETEB
BEETW: BWETE
BEETÂ: ÂBETE
BEETÊ: ÊBETE
BEFGÔ: FÔGBE
BEFIL: FEBLI
BEFIN: FINEB
BEFIT: BIFET
BEFLO: BLOFE
BEFLÂ: FEBLÂ
       FLÂBE
BEFOR: BOFRE
BEFRÂ: FÂBRE
BEGIZ: BEZIG
BEGLO: GOBLE
BEGNÛ: BEGÛN
BEIJL: BLIJE
BEIJY: JIBYE
BEIKN: BEKIN
       KIBEN
BEIKR: BRIKE
BEIKS: BISKE
BEIKZ: BEZIK
BEILR: BRILE
BEILS: BLESI
BEILY: BLIYE
BEILÂ: ÂBELI
BEILÑ: BILEÑ
BEIMN: BIMEN
BEINR: BIREN
       BRINE
BEINT: BITEN
BEIOV: EBIVO
BEIOY: OBEYI
BEIPS: BISEP
BEIPZ: PEZIB
BEIRT: BIRET
BEIRV: VIBRE
BEIRY: BRIYE
BEITV: BIVET
BEITZ: BETIZ
BEITÇ: BIÇET
BEJYÂ: JÂBYE
BEKLO: BLOKE
BEKLÔ: KÔBLE
BEKLÛ: BÛKLE
BEKNO: BONKE
BEKNÔ: KÔBEN
BEKOS: BOKSE
       BOSKE
BEKOW: KEBWO
BEKOY: BOKYE
BEKRÂ: KÂBRE
BEKSÛ: BÛSKE
BEKTÂ: BÂKET
BELMÂ: ÂBLEM
BELNO: NOBLE
BELOT: BOLET
       BOTLE
BELOW: BLEWO
BELOY: LOBEY
BELPÔ: PLÔBE
BELRÂ: RÂBLE
BELSÂ: BELÂS
       SÂBLE
BELTÛ: BÛLET
       TÛBLE
BELÂÇ: BLÂÇE
BEMNÔ: MÔBEN
BEMOW: BEWOM
BEMRÂ: MÂBRE
BEMWÔ: BEWÔM
BENNO: BONNE
BENNR: BRENN
BENNW: BWENN
BENOT: BETON
       BONET
       BONTE
       TONBE
BENTÔ: BÔNET
       BÔTEN
BENYÂ: ÂBYEN
BENYÛ: ÛBYEN
BENZÛ: BÛZEN
BEORZ: BREZO
BEOSW: BWOSE
BEOTW: BEWOT
       BWOTE
BEOWZ: BWEZO
BEOÂÇ: ÂBOÇE
BEPÇÊ: PÊBEÇ
BERTÊ: TÊBRE
BERTÔ: BRETÔ
BERTÛ: BÛRET
BERÂÇ: ÇÂBRE
BESTÛ: BÛSTE
BESYÛ: BÛSYE
BETYÛ: BÛTEY
BETÂÂ: ÂBETÂ
BEWZÊ: BEZWÊ
BEYÂÛ: ÂBÛYE
BFIIZ: FIZIB
BFIIÂ: ÂFIBI
BFIOS: BOFIS
BFLOÂ: FLÂBO
BFOOP: FOBOP
BFTÂÛ: BÛFÂT
BGILÊ: BILÊG
BGIOR: BRIGO
BGIOT: BIGOT
BGIRÂ: BRIGÂ
BGMOO: GOMBO
BGNOO: GONBO
BGNOÛ: BÛGON
BIIJS: JIBIS
BIIKK: KIBIK
BIILR: BRILI
BIILZ: LIZIB
BIIMS: SIMBI
BIINR: BRINI
BIINT: TIBIN
BIIPS: PIBIS
BIIRZ: RIZIB
BIIST: SIBIT
BIIVZ: VIZIB
BIKLO: OBLIK
BIKOT: BOKIT
BIKRÛ: BÛRIK
BIKTÔ: KÔBIT
BIKTÛ: BÛTIK
BIKZÂ: KÂBIZ
BILNO: BOLIN
BILNÛ: BÛLIN
BILOT: BOLIT
BILTÂ: TIBLÂ
BILTÊ: BILTÊ
BILWÛ: WÛLIB
BILÂÇ: BLÂÇI
BIMOY: BIYOM
BIMTÔ: TIBÔM
BINOP: PIBON
BINOS: BONIS
BINOZ: ZONBI
BINZÎ: NÎZIB
BIOPS: POSIB
BIPSÛ: PÛSIB
BIRSÔ: BRISÔ
BIRYÂ: BRIYÂ
BIRÇÛ: BÛÇRI
BISSÂ: SÂSIB
BISTÊ: BISÊT
BISTÎ: BISÎT
BIÂÇÛ: ÂBÛÇI
BJLÂÂ: JÂBLÂ
BJNOÂ: BONÂJ
       BONJÂ
       JÂBON
BJNOÛ: BONJÛ
       BÛJON
BJNÂÔ: BÔNÂJ
BKKOO: KOKOB
BKLOÛ: BÛLOK
BKNOÊ: KONBÊ
BKNOÛ: BONKÛ
BKOOS: BOSKO
BKOOT: OKTOB
BKOOY: KOBOY
BKOSÊ: SÊKOB
BKYÊÔ: KÔBYÊ
BLMÂÊ: BLÂMÊ
BLMÊÊ: BLÊMÊ
BLNNO: BLONN
BLNOÛ: BÛLON
BLNÛÛ: LÛNBÛ
BLOOT: LOTBO
BLOSÊ: SÊBOL
BLOSÛ: BÛSOL
BLSÂÂ: SÂBLÂ
BLWÔÛ: WÛBLÔ
BLZÔÛ: BLÛZÔ
BMNOO: BONOM
BMNOÊ: MONBÊ
BMNÔÔ: BÔNÔM
BMOOW: BOWOM
BNNÂÂ: BÂNÂN
BNOTÊ: BONTÊ
BNOTÛ: BÛTON
BNOWZ: BWONZ
BNOWÇ: BWONÇ
BNOYÛ: BÛYON
BNOÇÛ: BÛÇON
BNRÂÊ: BRÂNÊ
BOOPZ: ZOBOP
BOOYZ: ZOBOY
BOTYÛ: BÛTYO
BSSÂÔ: BÔSÂS
BSYÂÂ: ÂBYÂS
DDEEJ: DEDJE
DDEEY: DEDYE
DDEKÛ: DEKÛD
DDELÂ: DLÂDE
DDEOZ: DEZOD
DDEÂÂ: ÂDEDÂ
DDINO: DODIN
DDKÛÛ: DÛDÛK
DDSÛÛ: DÛDÛS
DEEFN: DEFEN
DEEFT: DEFET
DEEGR: DEGRE
DEEIK: EDIKE
DEEIT: EDITE
DEEJL: DEJLE
DEEJN: DEJNE
DEEJW: DEJWE
DEEKS: DESKE
DEELP: PLEDE
DEELY: DELYE
DEEMN: DEMEN
DEEMR: REMED
DEEMÂ: ÂMEDE
DEENR: DRENE
DEENS: DESEN
DEENY: DENYE
DEEPS: DEPES
DEEPÇ: DEPEÇ
DEERS: DRESE
DEERY: DERYE
DEEVW: DEVWE
DEEVY: DEVYE
DEFIL: FIDEL
DEFIP: PEFID
DEFIR: FREDI
DEFKÂ: FEDKÂ
DEFNO: DOFEN
DEFNÂ: DEFÂN
DEFNÛ: FÛNDE
DEFOÂ: ÂDEFO
DEFSÂ: DEFÂS
DEGIJ: DJIGE
DEGIT: DIGET
DEGNÊ: DEGÊN
DEGNÔ: DEGÔN
DEGNÛ: GÛDEN
DEGOT: GODET
DEGOW: DOGWE
       DWOGE
DEGOZ: EGZOD
DEGRÂ: GRÂDE
DEGSÔ: SEGÔD
DEGTÛ: DEGÛT
DEGWÔ: GWÔDE
DEIKR: DEKRI
       DERIK
       DIREK
       KREDI
DEIKS: DISEK
DEIKT: DIKTE
DEIKÊ: ÊDIKE
DEILM: DILEM
DEILN: LENDI
DEILS: DELIS
       DISEL
DEILZ: DIZEL
DEILÂ: ILÂDE
DEINN: DINEN
DEINO: ODINE
DEINV: DEVNI
       DIVEN
DEINY: ENDIY
DEINZ: DIZEN
DEINÔ: INÔDE
DEIOT: ODITE
DEIPR: PEDRI
       PREDI
DEIRV: DERIV
       DRIVE
DEIRÂ: ÂDIRE
DEIST: DISET
DEITW: DETWI
DEITY: TYEDI
DEITZ: DIZET
DEITÂ: ETÂDI
DEITÛ: ETÛDI
DEIVZ: DEVIZ
DEIYÊ: ÊDIYE
DEJKO: DJOKE
DEJLO: DJOLE
DEJNN: DJENN
DEJNÊ: DEJNÊ
DEJÂÂ: ÂDÂJE
DEKLO: DELKO
DEKLÊ: DEKLÊ
DEKOR: KORED
DEKOT: DOKTE
DEKOY: DYOKE
DEKYÛ: KÛDEY
DELMO: MODEL
DELMÂ: LÂMED
DELMÊ: MÊDEL
DELMÔ: LEMÔD
DELOR: RELDO
DELOY: DYOLE
DELOÂ: OLÂDE
DELSÊ: DELÊS
DELTÂ: DÂTEL
DELWÊ: DELWÊ
DELWÔ: WÔDEL
DELÂÇ: ÇÂDEL
DEMMO: MODEM
DEMNO: DEMON
       DOMEN
       MODEN
DEMNÂ: DÂMEN
       DEMÂN
DEMNÊ: DÊMEN
       DENMÊ
DEMNÔ: MÔDEN
DEMOS: MODES
DEMOT: METOD
DEMOZ: DOMEZ
DEMOÑ: DOMEÑ
DEMSÂ: DESÂM
DEMSÊ: MEDSÊ
DEMVÊ: MÊDEV
DEMYÂ: DÂMYE
DEMÂÂ: ÂMEDÂ
DENNÔ: DÔNEN
DENOO: ODONE
DENOR: DRENO
DENOS: NODES
       SONDE
DENOT: DONTE
DENOW: WONDE
DENPÂ: DEPÂN
DENPÊ: DEPÊN
DENPÛ: PENDÛ
DENSÂ: DESÂN
DENTÂ: DETÂN
DENTÊ: DETÊN
DENTÔ: ENDÔT
DENVÊ: DEVÊN
DENYÊ: ÊDYEN
       ENDYÊ
DENZÛ: DÛZEN
DENÂÇ: ÇENDÂ
DENÂÑ: NÂDEÑ
DEORT: DORET
DEOSY: DOSYE
DEOSÂ: ÂDOSE
DEOTY: TODYE
DEOWZ: DEWOZ
DEOWÇ: DEWOÇ
DEOYÂ: ÂDEYO
DEOYÇ: ÇODYE
DEPRÛ: PÛDRE
DEPSÂ: DEPÂS
DEPYÂ: PÂDYE
DERYÊ: DERYÊ
DERZÛ: REZÛD
DESSÂ: DESÂS
       SÂDES
DESTÂ: DESÂT
DESTÊ: DESTÊ
DESÂÊ: ÊDESÂ
DETTÂ: DETÂT
DETZÔ: TÔDEZ
DFIMO: DIFOM
DFIRÔ: FÔDRI
DFSÂÂ: DÂFÂS
DGINO: GIDON
DGIRÂ: GRÂDI
DGIÂÛ: ÂGÛDI
DGKÛÛ: KÛDÛG
DGMOÊ: DOMÊG
DGNÂÊ: NÂDÊG
DGNÊÔ: DÊGÔN
DGOOT: OTDOG
DGRÂÔ: GRÂDÔ
DGRÂÛ: GRÂDÛ
DGWÔÛ: GÛDWÔ
DIIKL: LIKID
DIIMT: TIMID
DIIPS: DISIP
DIJNÂ: DJÂNI
DIJÂÊ: ÊDIJÂ
DIKKÔ: KIDÔK
DIKNO: KONDI
DIKSÛ: DISKÛ
DILMO: MODIL
DILOS: DOSIL
       SOLID
DILOV: DOLIV
DILOW: LWIDO
DILOZ: ZIDOL
DILPÂ: PÂDIL
DIMOY: IDYOM
DIMOÂ: ÂDOMI
DIMÂÇ: DIMÂÇ
DINOW: WONDI
DINOZ: DIZON
DINSÂ: DISÂN
       NÂSID
DINSÛ: SÛDIN
DINYÂ: DYÂNI
DIOSV: DIVOS
DIPRÂ: PÂDRI
       PRIDÂ
DIRYÂ: DIRYÂ
DISTÂ: DÂTIS
DITZÎ: DIZÎT
DIÂÇÊ: ÇIÊDÂ
DJLÂÛ: JÛDLÂ
DKMOO: KOMOD
DKNOO: KODON
       KONDO
DKNOÊ: KODÊN
DKNOÎ: KONDÎ
DKNOÔ: KÔDON
       KONDÔ
DKOWÔ: KODWÔ
DKTÎÔ: KÔDÎT
DLMÂÊ: LÂDMÊ
DLOWÂ: WOLDÂ
DMNOÊ: MONDÊ
DMRÂÂ: RÂDMÂ
DMSÂÛ: DÛSMÂ
DMYÂÂ: MÂDYÂ
DMÂÊÔ: ÂDÊMÔ
DNNOÂ: DONNÂ
DNNOÊ: DONNÊ
DNOPÎ: PODNÎ
DNOTÂ: TÂDON
DNOTÊ: ÊDONT
DNOVÛ: VODÛN
DNOYÛ: DÛYON
DOPWÎ: PWODÎ
DOSTÊ: SÊTOD
DOSYÂ: ODYÂS
DPZÂÛ: ZÂPÛD
DRÂÂÛ: ÂDÛRÂ
DSTÂÂ: TÂDÂS
DSTÂÛ: DÛTÂS
EEEMT: EMETE
EEENV: ENEVE
EEEPS: EPESE
EEESY: ESEYE
EEEVÇ: EVEÇE
EEFGR: GREFE
EEFKY: FEKYE
EEFLM: FEMEL
EEFLÂ: ELEFÂ
EEFMN: FEMEN
EEFMT: FEMTE
EEFMY: FEMYE
       MEFYE
EEFMÂ: ÂFEME
EEFNT: FENET
       FENTE
EEFNW: FENWE
EEFPR: PREFE
EEFRÇ: FREÇE
EEFSW: SEFWE
EEFTW: FWETE
EEFTY: FYETE
EEGLN: GENLE
       LEGEN
EEGLR: REGLE
EEGLV: VEGLE
EEGLÂ: ELEGÂ
EEGNS: NEGES
EEGNT: ENTEG
EEGRS: GRESE
EEGRY: GERYE
EEGRZ: ZEGRE
EEIJN: ENEJI
EEIKP: EKIPE
EEIMS: EMISE
EEITV: EVITE
EEITZ: EZITE
EEJMN: JEMEN
EEJNS: JENES
EEJNZ: JENEZ
EEJPY: JEPYE
EEJRT: REJTE
EEKKL: KELKE
EEKLL: LEKLE
EEKLR: KLERE
EEKLS: SEKLE
EEKLT: KLETE
EEKLZ: ZEKLE
EEKMS: KEMES
EEKNP: KENEP
       PEKEN
EEKNR: REKEN
EEKNS: ENSEK
       SENKE
EEKNT: KENTE
EEKNY: ENKYE
EEKOS: EKOSE
EEKPS: EKSPE
EEKRS: SEKRE
EEKRT: REKTE
EEKRV: KREVE
EEKRY: KREYE
EEKST: SEKTE
EEKSV: VEKSE
EEKSW: SEKWE
EEKSY: KESYE
       SEKEY
EEKSÂ: ÂKESE
EEKTV: VEKTE
EEKTÂ: ÂKETE
EEKTÛ: EKÛTE
EELMS: SEMEL
EELMÂ: ELEMÂ
EELNP: PELEN
EELNT: ENTEL
EELNV: LEVEN
EELNÇ: ÇELEN
       NEÇEL
EELPP: PEPLE
EELRT: LETRE
       TRELE
EELRY: REYEL
EELSV: SEVEL
       VESEL
EELSZ: ZESEL
EELTY: LEYET
EELTÛ: ETELÛ
EELVY: LEVYE
EEMNS: ESNEM
       SEMEN
EEMNÇ: ÇEMEN
EEMPS: ESPEM
EEMPT: PEMET
EEMRT: REMET
EEMRÑ: MEREÑ
EEMSS: SEMES
EEMSY: MESYE
EEMTY: METYE
EEMTÇ: ÇEMET
EEMVY: MEVEY
EENNS: SENEN
EENNT: ENTEN
       ETENN
EENNV: NEVEN
       VENEN
EENOT: ETONE
EENPS: PENSE
EENPT: PENET
EENRS: RENSE
       SEREN
EENRT: TEREN
EENRZ: REZEN
EENSS: SENSE
EENST: SETEN
EENSV: ENVES
EENTÇ: ÇENET
       ÇENTE
EENTÊ: ÊTENE
EENVV: VEVEN
EENVÊ: ÊNEVE
EENYZ: ZENYE
EEOPR: OPERE
EEPRS: ESPRE
       PRESE
       RESPE
EEPRT: PRETE
EEPRV: EPREV
EEPRZ: PEREZ
EEPRÂ: ÂPERE
EEPRÇ: PREÇE
EEPSS: ESPES
EEPST: SEPET
EEPSV: VEPSE
EEPSY: PYESE
EEPTT: PETET
EEPTY: PYETE
EEPTÂ: ETÂPE
EEPZÑ: ZEPEÑ
EEPÂÇ: ÂPEÇE
EERRT: RETRE
EERST: RESET
       TRESE
EERSV: SEVRE
EERSY: SERYE
EERSÑ: SEREÑ
EERTT: TRETE
EERTÂ: ÂTERE
EERTÇ: REÇTE
EERTÊ: ÊTERE
EERVY: REVEY
EESTW: SWETE
EETTY: TETYE
EETTÂ: ÂTETE
EEVVÛ: ÛVEVE
EFFIL: FILFE
EFFNÊ: FÊFEN
       FENFÊ
EFGIR: GRIFE
EFGIY: FIGYE
EFGLÔ: GÔFLE
EFIKR: KEFIR
EFIKS: FIKSE
EFILR: FLERI
EFILS: FISEL
       SIFLE
EFILT: FLITE
EFILY: FIYEL
EFIMN: ENFIM
       FIMEN
EFIMR: FREMI
EFIMT: FEMTI
EFIMY: FIMYE
EFINS: FINES
EFIOR: ORIFE
EFIRS: FRESI
       RESIF
EFIRT: RETIF
EFIRZ: FRIZE
       REFIZ
EFIRÇ: FREÇI
EFIST: FETIS
EFITY: FIYET
EFITÇ: ÇETIF
       FETIÇ
EFIYZ: FIZYE
EFJOR: JOFRE
EFJOZ: JOZEF
EFKLÂ: FLÂKE
EFKNR: FRENK
EFKNW: FWENK
EFKOR: KOFRE
EFKRÂ: FREKÂ
       KÂFRE
EFKRÔ: KÔFRE
EFKYÔ: KÔFYE
EFLMÊ: FÊMEL
EFLNÂ: FLÂNE
EFLOP: POFLE
EFLOT: FLOTE
EFLOW: FLEWO
EFLOÊ: OFELÊ
EFLPS: FELPS
EFLRÂ: FLERÂ
EFLSÛ: SÛFLE
EFLWÔ: WÔFLE
EFLÂÇ: ÂFLEÇ
EFLÇÛ: ÇÛFLE
EFMOÊ: ÊFOME
EFMYÂ: MEFYÂ
EFMÂÊ: ÂFEMÊ
EFNNR: FRENN
EFNNW: FWENN
EFNNÊ: FÊNEN
       FENNÊ
EFNNÛ: FÛNEN
EFNOS: FONSE
EFNYÂ: FENYÂ
EFNZÛ: FÛNEZ
EFORW: FREWO
EFOST: FOSET
EFOSW: FEWOS
EFOTW: FWOTE
EFOTY: FOTEY
EFRSÂ: FRÂSE
EFSTÊ: FESTÊ
EFSYÔ: FÔSYE
EFSÂÔ: ÂFÔSE
EFTYÔ: FÔTYE
EFTÂÂ: ÂFÂTE
EFTÇÛ: FÛÇET
EGGIR: IGREG
EGGNÂ: GENGÂ
EGIIR: IRIGE
EGILM: LEGIM
EGILS: GLISE
EGILV: VILGE
EGILZ: EGZIL
EGIMN: MENGI
EGIMR: MEGRI
EGINN: GINEN
EGINP: PINGE
EGINV: VINEG
EGIPR: GRIPE
EGIRT: GERIT
EGIRY: GRIYE
EGIVÂ: ÂVIGE
EGIWZ: ZEGWI
EGJLÔ: JÔGLE
EGJOT: GOJET
EGJOW: GWOJE
EGJOÂ: ÂGOJE
EGJRÛ: GÛREJ
EGKRÔ: KÔGRE
EGLMÂ: GÂMEL
EGLNO: LONGE
EGLOP: PLOGE
EGLOS: GLOSE
EGLOY: LOGEY
EGLSÂ: SÂGLE
EGLTÂ: LÂGET
EGLZÂ: ÂGLEZ
       LÂGEZ
       ZÂGLE
EGLZÔ: ZÔGLE
EGMNÂ: ENGÂM
EGMNÔ: GÔMEN
EGMNÛ: GÛMEN
EGMRÂ: GRÂME
EGMRÊ: MERÊG
EGMSÂ: SEGMÂ
EGMTÂ: MÂTEG
EGMTÛ: GÛMET
EGNNO: GENON
EGNNR: GRENN
EGNRT: TRENG
EGNRÂ: ÂGREN
EGNSÔ: SEGÔN
EGNTÂ: GENTÂ
EGOSW: GWOSE
EGOVW: GWEVO
EGOVY: VEGOY
EGOYZ: GOZYE
EGPRÊ: GRÊPE
EGPWÛ: GWÛPE
EGPZÂ: EGZÂP
EGPZÊ: ZEPÊG
EGRSÊ: SERÊG
EGRVÂ: ÂGREV
EGTYÛ: GÛTYE
EGWYÛ: GWÛYE
EHKOT: HOKET
EIIKR: EKIRI
EIILZ: EZILI
EIIMT: IMITE
EIINR: IRINE
EIINS: INESI
EIINT: INITE
EIINV: INIVE
EIIRT: IRITE
EIJLM: JIMEL
EIJLT: JILET
EIJMR: REJIM
EIJNN: JENNI
EIJNS: ENJIS
EIJNY: IJYEN
EIJOS: OSIJE
EIJPR: PRIJE
EIJRS: REJIS
EIJRW: REJWI
EIJSW: JWISE
EIJTV: VETIJ
EIJTW: JIWET
EIJYZ: JIZYE
EIKLN: NIKEL
EIKLS: EKLIS
       KILES
       KLESI
       KLISE
EIKLT: LEKTI
EIKLZ: EKZIL
EIKMN: KIMEN
EIKOP: OKIPE
EIKPR: KREPI
       PERIK
EIKPS: PISKE
EIKPT: PIKET
EIKRS: RISKE
       SIKRE
EIKRT: KRITE
EIKRY: KIRYE
       KRIYE
EIKSS: SIKSE
EIKST: KITES
EIKSY: KIYES
EIKSZ: ESKIZ
EIKTV: KIVET
EIKTÇ: ÇIKET
EILLS: SELIL
EILLT: LELIT
EILMN: LIMEN
EILMO: OMELI
EILMS: MELIS
EILMT: MILET
EILMY: LIMYE
EILMZ: ZILEM
EILMÇ: MIÇEL
EILNT: LINET
       LITEN
EILNY: LIYEN
EILNÂ: ÂNILE
EILOZ: IZOLE
EILPS: ELIPS
       PLISE
EILPY: PILYE
       PLIYE
EILPZ: PLEZI
EILPÂ: ÂPILE
EILRS: RISEL
EILRV: LIVRE
EILRY: RIYEL
EILRZ: LIZRE
       REZIL
EILSV: LESIV
EILSW: SIWEL
EILTV: LEVIT
EILTW: TIWEL
EILYZ: LIZYE
EIMNN: MINEN
EIMNS: SIMEN
EIMNT: ENTIM
EIMNV: VEMIN
EIMNÇ: ÇIMEN
EIMPP: PIMPE
EIMPR: PRIME
EIMRZ: REMIZ
EIMST: METIS
EIMSY: MISYE
EIMTY: MIYET
EIMWZ: MWEZI
EIMZÇ: ÇEMIZ
EINNR: RINEN
EINPS: PENIS
EINPT: PENTI
       PITEN
EINPZ: PINEZ
EINPÇ: PENIÇ
EINRT: RETIN
       RETNI
       TIREN
EINRV: REVNI
EINRZ: REZIN
EINSS: SESIN
EINST: SENTI
       SITEN
       TENIS
EINSV: VENIS
EINSY: SIYEN
EINTT: TETIN
EINTY: TINYE
EIPPT: PIPET
EIPRS: ESPRI
EIPRT: PETRI
EIPRV: PRIVE
EIPRY: PRIYE
EIPRÂ: ÂPIRE
EIPRÇ: PERIÇ
EIPST: PITES
EIPSZ: ZEPIS
EIPTW: PIWET
       TWIPE
EIPTY: PITYE
EIPTÂ: ÂPITE
EIPTÛ: EPITÛ
EIPWZ: PWEZI
EIRST: SIRET
EIRSZ: SERIZ
EIRSÇ: RIÇES
EIRTV: VITRE
EIRTY: TRIYE
EIRTÇ: REÇIT
EIRVY: RIVYE
EIRZZ: RIZEZ
EIRÂÇ: ÂÇERI
EISSV: SEVIS
EISTV: VITES
EISVY: VISYE
EITVY: VIYET
EITVÊ: ÊVITE
EITVÛ: ÛVETI
EIVYY: VYEYI
EIVYZ: VIZYE
EIYZZ: ZIZYE
EJJNÂ: JENJÂ
EJKLO: KOLEJ
EJKNO: KONJE
EJLMÂ: MELÂJ
EJLNO: LONJE
EJLOY: JOLYE
EJLPÔ: PLÔJE
EJLWÂ: LWÂJE
EJLWÛ: LEWÛJ
EJNNW: JWENN
EJNNÊ: JÊNEN
       JENNÊ
EJNNÛ: JÛNEN
EJNOP: EPONJ
EJNOS: SONJE
EJNOW: WONJE
EJNOZ: JONZE
EJNOÇ: ÇONJE
EJNSÊ: JÊNES
EJOPW: PWOJE
EJPYÂ: JÂPYE
EJRTÂ: ETRÂJ
EJRVÂ: REVÂJ
EJRYÔ: REJYÔ
EJSYÔ: JESYÔ
EJTWÂ: ÂJWET
EJTZÎ: JEZÎT
EJVYÂ: JÂVYE
EKKNO: KOKEN
EKKNÊ: KÊKEN
       KENKÊ
EKKOR: KOREK
EKKOW: KWOKE
EKKRÔ: KÔKRE
EKKTÔ: KÔKET
EKLLO: LEKOL
EKLMÂ: KLEMÂ
EKLNÂ: KÂNEL
EKLOS: LESKO
EKLOT: KOLET
       KOLTE
EKLOV: KLEVO
EKLOY: KOLYE
EKLOÂ: ÂKOLE
EKLPÔ: KÔPLE
EKLPÛ: KÛPLE
EKLRÊ: KLERÊ
EKLRÛ: KLÛRE
EKLTÔ: LEKÔT
EKLVÛ: KÛLEV
EKLWÔ: KLEWÔ
EKMMÂ: KÂMEM
EKMNO: KONME
EKMOS: KOMES
       MOSKE
EKMOT: KOMET
EKMOW: KWOME
EKMSÔ: KÔMES
EKNNO: KONEN
       OKENN
EKNNW: KWENN
EKNNÔ: KÔNEN
EKNOP: KONPE
       KOPEN
EKNOT: KONET
       KONTE
EKNOZ: KONZE
EKNPS: PENKS
EKNSÛ: KÛSEN
EKNTÂ: KÂNTE
EKNYÛ: KÛNYE
EKNZÊ: KÊZEN
EKNZÛ: KÛZEN
EKOPT: PEKTO
EKOPY: KOPYE
EKORT: REKOT
EKOST: ESTOK
       SOKET
EKOSÇ: ÇESKO
EKOTT: TOKET
EKOTW: TWOKE
       WOKET
EKOTZ: ZETOK
EKOTÇ: KOÇET
       KOÇTE
EKOVÊ: ÊVOKE
EKOWÇ: KWOÇE
EKPSÂ: ESKÂP
EKPSÔ: KÔSEP
EKPSÛ: SEKÛP
EKPYÛ: KÛPYE
EKPÂÇ: KÂPEÇ
EKRSÔ: KRESÔ
EKRTÊ: KRETÊ
       TRÊKE
EKRTÔ: KÔTRE
EKRYÔ: KREYÔ
EKRYÛ: KÛRYE
EKRÂÇ: ÇÂKRE
EKSSÂ: SEKÂS
EKSTÛ: ESKÛT
       SÛKET
EKSWÊ: KWÊSE
EKSYÊ: YESKÊ
EKSYÔ: KESYÔ
       KÔSEY
EKTYÛ: KÛTYE
EKTÇÛ: ÇÛKET
       KÛÇET
EKVZÛ: KÛVEZ
ELLOT: LOTEL
ELLOV: VOLEL
ELMNO: MELON
ELMNÂ: LÂMEN
ELMNÔ: LEMÔN
       LÔMEN
ELMNÛ: MÛLEN
ELMOT: MOTEL
ELMOY: ELYOM
ELMOZ: LEZOM
ELMSÂ: LÂMES
       SELMÂ
ELMTÂ: METLÂ
       TELMÂ
ELMWÂ: LEMWÂ
ELMÇÛ: LEMÛÇ
ELNNO: LONEN
ELNNP: PLENN
ELNNÔ: LÔNEN
ELNOP: POLEN
ELNOS: LESON
       SELON
ELNOT: LENTO
       TONEL
ELNPT: PLENT
ELNPÛ: PÛLEN
ELNTÔ: TÔNEL
ELNTÛ: LÛTEN
ELNVÛ: NÛVEL
ELOPV: VLOPE
ELOPW: PEWOL
ELOPY: PLOYE
       POLYE
ELOPZ: ZEPOL
ELORY: LORYE
ELOSY: LOSYE
       OSYEL
       SOLEY
ELOTV: VOLTE
ELOTZ: LEZOT
ELOVY: VYOLE
ELOVZ: VOLEZ
ELPRÊ: PELRÊ
       REPLÊ
ELPSÛ: SÛPLE
ELPTÂ: LETÂP
       PLÂTE
ELPTÛ: PÛLET
ELPYÛ: PYELÛ
ELPZÛ: PELÛZ
ELPÂÇ: PLÂÇE
ELSTÊ: TÊSEL
ELSVÛ: SÛLVE
ELSYÛ: SÛLYE
ELTWÛ: WÛLET
ELYZÔ: LYEZÔ
EMNNÊ: MÊNEN
       MENNÊ
EMNNÔ: MÔNEN
       NÔMEN
EMNOP: MONPE
EMNOR: REMON
EMNOS: MENOS
EMNOT: MENOT
       MONTE
EMNOW: OMWEN
EMNOY: MONYE
EMNOÇ: MONÇE
EMNPÂ: PÂMEN
EMNRÊ: RÊMEN
       RENMÊ
EMNSW: MWENS
EMNTÂ: TÂMEN
EMNVÂ: MÂNEV
EMNWÛ: WÛMEN
EMNÇÊ: ÇEMÊN
EMORÂ: ÂMORE
EMOST: TEMOS
EMOSW: SEWOM
EMOSY: SOMEY
       SOMYE
EMOTY: MOTYE
EMOVZ: MOVEZ
EMRTÊ: RÊMET
EMRTÔ: MÔTRE
EMRVÂ: VREMÂ
EMRYÂ: RÂMYE
EMRÂÛ: ÂMÛRE
EMSSÂ: SEMÂS
EMSTÛ: SÛMET
EMSVÂ: VESMÂ
EMSYÔ: SÔMEY
EMTWÊ: TEMWÊ
EMTYÎ: ÎTYEM
EMTÂÂ: ÂTEMÂ
EMTÂÇ: MÂÇET
EMVÂÊ: EVÊMÂ
EMYZÔ: ÔZYEM
ENNOT: ONNET
       TONNE
ENNOW: NEWON
ENNPW: PWENN
ENNRT: TRENN
ENNSÊ: SÊNEN
       SENNÊ
ENNSÔ: SÔNEN
ENNTÂ: TÂNEN
ENNTÛ: TÛNEN
ENNVÂ: VÂNEN
ENOPP: PONPE
ENOPS: PENSO
       PESON
ENOPW: PEWON
       WONPE
ENOPZ: ZEPON
ENOPÇ: POÇEN
ENORY: REYON
ENORZ: REZON
ENOST: SONET
ENOSZ: SEZON
ENOTW: WONTE
ENOTÂ: ETONÂ
ENOVÇ: ÇEVON
ENPPÂ: PENPÂ
ENPRS: PRENS
ENPRÔ: PRENÔ
       REPÔN
ENPSÔ: PESÔN
ENPTW: PWENT
ENPTÂ: PÂTEN
       TENPÂ
ENPÇÊ: PÊÇEN
       PENÇÊ
ENRVÂ: REVÂN
ENSSÂ: NESÂS
ENSTÂ: ÂSENT
       ESTÂN
       SÂTEN
ENSTÊ: ENSTÊ
       ÊSTEN
ENSTÔ: SÔNET
ENSTÛ: TÛSEN
ENSVÂ: VENSÂ
ENSYÂ: ÂSYEN
ENTTÊ: TENTÊ
       TÊTEN
ENTVÊ: VÊTEN
ENTWÔ: NETWÔ
ENVVÊ: VEVÊN
ENVÂÊ: ÊNEVÂ
EOOPZ: OPOZE
EOPPY: POPYE
EOPRT: POTRE
EOPRV: PREVO
EOPST: POSTE
EOPSW: PWOSE
EOPTW: PETWO
       POWET
EOPTZ: POTEZ
EOPTÊ: ÊPOTE
EOPWY: PYEWO
EOPWZ: PWOZE
EOPWÇ: PWOÇE
EOPZÊ: ÊPOZE
EORTZ: TREZO
EORYZ: ZOREY
       ZORYE
EORZÔ: OREZÔ
EOSSY: SOSYE
EOSTÇ: ÇOSET
EOSYÂ: OSEYÂ
EOTTW: TWOTE
EOTVÇ: ÇOVET
EOTWZ: WOZET
EOTYZ: ZOTEY
EOVWY: VYEWO
EOWZZ: ZWEZO
EOZÂÇ: OZÂÇE
EPPYÔ: PÔPYE
EPRSÂ: PRESÂ
EPRSÔ: REPÔS
EPRTÂ: TRÂPE
EPRTÊ: PRÊTE
EPRTÛ: TÛPRE
EPRZÂ: PREZÂ
EPSTÂ: ESPÂT
EPSTÊ: PÊSET
EPSTÛ: PÛSET
EPSYÔ: ESPYÔ
EPSYÛ: PÛSYE
EPTTÂ: TÂPET
EPTTÛ: PÛTET
EPTWÊ: PWÊTE
EPTWÔ: TWÔPE
EPTYÂ: PÂTYE
EPTYÔ: PETYÔ
       PYETÔ
EPTÂÇ: ÇÂPET
EPTÇÛ: ÇÛPET
EPVWÛ: PWÛVE
EPÇÊÑ: PÊÇEÑ
ERRTÂ: RÂTRE
ERSSÛ: RESÛS
ERSTÂ: RESTÂ
ERSTÊ: SÊTRE
ERSVÊ: SEVRÊ
ERTÂÇ: TRÂÇE
ERTÂÛ: ÂRETÛ
       ÂTÛRE
ERTÇÛ: RETÛÇ
ESSTÛ: SÛSET
ESSYÂ: SEYÂS
ESSÂÂ: ÂSÂSE
ESTWÊ: SWÊTE
ESTZÂ: ZÂSET
ESTÂÂ: ÂSÂTE
ETVWÛ: TWÛVE
ETVZÛ: VÛZET
ETVÂÊ: ÊVÂTE
ETWYÛ: WÛTYE
ETYÂÇ: ÇÂTYE
ETYÇÊ: ÇYÊTE
ETÂÂÇ: ÂÇÂTE
EWYZÛ: WÛZYE
FFNÛÛ: FÛFÛN
FFOOS: FOSFO
FGSÔÛ: FÔGÛS
FHMOÛ: HÛMFO
FIIKZ: FIZIK
FIJOW: JIWOF
FIKLÔ: KÔFLI
FIKNÂ: KÂNIF
FIKOS: OFIKS
FILMO: FOMIL
FILOS: FOSIL
FILOY: FIYOL
FILSÂ: SÂFIL
FIMOT: MOTIF
FIMWÔ: FWÔMI
FIMÂÂ: ÂFÂMI
FINOT: FOTIN
FINOÇ: ÇIFON
FINSÂ: FINÂS
FIOPW: PWOFI
FIRSÔ: FRISÔ
FIRSÛ: SÛFRI
FIRÂÇ: FRÂÇI
FISTÔ: FÔTIS
FISYÔ: FISYÔ
FITWÛ: WIFÛT
FJNOO: FOJON
FKLOO: FOKOL
FKMOÂ: KÂMFO
FKMOÔ: KÔFOM
FKNOO: KONFO
FKNÔÔ: KÔFÔN
FKYÂÔ: KÔFYÂ
FLMOO: FOMOL
FLMÂÂ: FLÂMÂ
FLNÂÊ: FLÂNÊ
FLOOP: FOLOP
FMOOW: FOWOM
FMOOZ: FOMOZ
FMOTÂ: FÂMOT
       FÂTOM
FNOÇÛ: FÛÇON
FNRÊÊ: FRÊNÊ
FNTÊÔ: FÔTÊN
FNÂÊÛ: ÂFÛNÊ
FOPWÊ: FOPWÊ
FOPWÔ: PWOFÔ
FOSTÊ: FOSTÊ
FPTÂÛ: PÂTÛF
FTÂÂÊ: ÂFÂTÊ
GGIIT: GIGIT
GGNÂÂ: NGÂGÂ
GGNÊÊ: GÊGÊN
GGRÂÛ: GRÂGÛ
GGSÂÂ: GÂGÂS
GHNÂÛ: HÛNGÂ
GIIJR: GRIJI
GIILV: VIGIL
GILNÂ: GILÂN
GILOR: GORIL
       RIGOL
GILSÂ: GLISÂ
GILVÔ: LÔGVI
GIMOR: GRIMO
GIMOY: GIYOM
GIMPÂ: PIGMÂ
GINOS: SINGO
GINOY: GOYIN
GINWZ: ZWING
GINWÂ: IGWÂN
GIORY: GRIYO
GIOSÇ: GOÇIS
GIOTZ: ZIGOT
GIRSÂ: SÂGRI
GIRTÊ: ÊTRIG
GIRYÊ: GRIYÊ
GIRZÔ: GRIZÔ
GJOWÂ: GWOJÂ
GJRÂÂ: GRÂJÂ
GKNOO: KONGO
GLNOÂ: LONGÂ
GLSÊÎ: LÊGÎS
GLTÔÛ: GLÛTÔ
GLWÔÛ: WÛLÔG
GLZÊÊ: ZÊGLÊ
GMNOÊ: GONMÊ
GMSÛÛ: SÛGÛM
GMÂÂÂ: ÂGÂMÂ
GNRÊÊ: GRÊNÊ
GNYÊÔ: GYÔNÊ
GOTYÛ: YOGÛT
GPWÂÛ: ÂGWÛP
GPWÊÊ: PÊGWÊ
GPÇÊÊ: PÊÇÊG
GSWÂÊ: SÂGWÊ
HINSÛ: HÛNSI
IIJLV: VIJIL
IIJMT: JITIM
IIJRS: JIRIS
IIKKT: KIKIT
IIKLT: KILTI
IIKMM: MIMIK
IIKMS: MIKIS
IIKMZ: MIZIK
IIKMÇ: ÇIMIK
IIKNS: SINIK
IIKNZ: KIZIN
IIKNÇ: ÇIKIN
IIKRS: SIRIK
IIKSW: WISKI
IIKVÑ: VIKIÑ
IILLP: PILIL
IILMT: LIMIT
IILNY: LIYIN
IILNZ: LIZIN
IILPT: TILIP
IILSV: SIVIL
IILTY: LIYIT
IIMNS: MINIS
IIMNT: MINIT
       MITIN
IIMNW: MINWI
IIMSÇ: ÇIMIS
IIMTÑ: MITIÑ
IINNO: INONI
IINOW: IWONI
IINPS: PISIN
IIPPT: PIPIT
IIPPW: WIPIP
IIPPY: PIYIP
IIPPÇ: PIPIÇ
IIPTT: PITIT
IIRSV: VIRIS
IIRTÂ: IRITÂ
IIRÂÇ: ÂRIÇI
IISSY: SIYIS
IISVV: SIVIV
IITTT: TITIT
IITVZ: VIZIT
IJJMÂ: JIJMÂ
IJKLO: LOJIK
IJNOP: JIPON
       PIJON
IJNOS: JONIS
IJNOY: JINYO
IJNYÊ: IJYÊN
IJSTÂ: JISTÂ
IJSTÊ: JISTÊ
IJSVÂ: JÂSIV
IJTWÊ: JWÊTI
IKKKÔ: KIKÔK
IKKLO: KOLIK
IKKMO: KOMIK
IKKNÂ: KÂNIK
IKKOT: TIKOK
IKKTÂ: KÂTIK
IKLMÂ: ÂKLIM
IKLNO: KOLIN
IKLNÛ: KÛLIN
IKLOT: KILOT
       KLOTI
IKLPS: KLIPS
IKLSÛ: KÛLIS
IKLYÂ: KLIYÂ
IKMNO: KOMIN
IKMNÂ: KINÂM
IKMOS: KOMSI
       SIMKO
IKMSÔ: KÔMSI
IKMTÛ: KÛTIM
IKNOS: KONSI
IKNOÊ: ÊKONI
IKNRÂ: RÂKIN
IKNTÂ: KÂTIN
IKNWÊ: WIKÊN
IKNZÎ: KÎZIN
IKNZÛ: KÛZIN
IKOPP: PIKOP
IKOPT: OPTIK
IKORT: KOTRI
       TRIKO
IKORZ: KRIZO
IKOSZ: ZIKOS
IKOTV: VIKTO
IKOTÂ: ÂTIKO
IKOWÇ: KWOÇI
IKOYÇ: KIÇOY
IKPYÔ: PIKYÔ
IKRSÊ: ÊSKRI
IKRVÛ: KÛVRI
IKSYÔ: KÔSIY
ILMNO: LIMON
       NOMIL
ILMNÊ: LÊNMI
ILMOP: PLIMO
ILMOV: VOLIM
ILMPÊ: PLIMÊ
ILNOP: PILON
ILNPÛ: LÛPIN
ILNSÊ: SILÊN
ILNVÔ: LÔNVI
ILOPS: POLIS
ILOPT: PILOT
ILORT: LOTRI
ILOST: LOSTI
       OSTIL
ILOZÂ: IZOLÂ
ILPRÂ: RÂPLI
ILPSÂ: ÂPLIS
ILPTÔ: PLITÔ
ILPÇÛ: PÛLIÇ
ILRVÛ: LÛVRI
ILSVÊ: SILVÊ
       VILSÊ
ILTYÂ: LÂTIY
ILYÇÊ: ÇILYÊ
IMNOS: SIMON
IMNOT: MINOT
IMNOV: VONMI
IMNTÛ: TIMÛN
IMORZ: RIZOM
IMOTZ: MITOZ
IMOYZ: MOYIZ
IMRTÊ: TRIMÊ
IMRÂÊ: ÂRIMÊ
IMSTÂ: SÂTIM
IMSYÔ: MISYÔ
IMTÇÊ: TÇIMÊ
INNOY: INYON
INOOV: ONIVO
INOPT: PITON
INOPW: WONPI
INOPZ: IPNOZ
INOPÇ: ÇOPIN
       PIÇON
INOSY: SIYON
INOSÂ: INOSÂ
INOSÔ: OSINÔ
INOTY: TIYON
INOYÇ: ÇIYON
INRSÛ: NÛRIS
INRTÂ: TÂNRI
INSTÛ: SÛTNI
INSVÛ: SÛVNI
INTTÂ: TÂTIN
INTWÛ: WÛTIN
INTZÂ: TIZÂN
INVWÔ: VIWÔN
IOPRÇ: POÇRI
IOPST: POSTI
       TOPSI
IOPTÇ: POTIÇ
IORYÂ: IYORÂ
IOSSS: SOSIS
IOSTZ: SOTIZ
IOTVY: TYOVI
IOTVÇ: TÇOVI
IPPSÔ: PÔPIS
IPPYÂ: PIYÂP
IPRTÂ: TÂPRI
IPRZÂ: ÂPRIZ
IPRZÔ: PRIZÔ
IPSSÂ: PISÂS
IPSTÔ: PISTÔ
IPSWÔ: PISWÔ
IPTWÊ: PWÊTI
IPTÇÛ: ÇÛPIT
IRSTÛ: SÛRIT
       TÛRIS
IRSYÊ: SIRYÊ
ISTWÇ: SWITÇ
ISTWÊ: ÊSTWI
ISTWÔ: SITWÔ
ISVWÂ: SWIVÂ
ISVZÂ: ZÂSIV
ITTZÎ: TIZÎT
IVWÂÔ: ÂVIWÔ
IVYZÔ: VIZYÔ
JJLOÂ: JÂJOL
JJLOÊ: JÊJOL
JJLOÔ: JÔJOL
JJMÂÊ: JÊJÂM
JJNÂÊ: JÊNJÂ
JKTÂÛ: JÛKTÂ
JLLOO: LOLOJ
JLMOÂ: LOJMÂ
JLOWÛ: WÛJOL
JLOZÂ: LOZÂJ
JMNOÊ: JÊNOM
JMÂÂÇ: ÇÂJMÂ
JORZÂ: ZORÂJ
JSTÂÛ: JÛSTÂ
KKLOO: KOLOK
KKMÔÔ: KÔKÔM
KKNOO: KOKON
KKNOÊ: KOKÊN
KKNOÛ: KONKÛ
KKNÛÛ: KÛKÛN
       KÛNÛK
KKOOS: KOKOS
KKOOT: KOKOT
KKTÛÛ: KÛKÛT
KKYÛÛ: KÛKÛY
KLNOO: KOLON
KLNOÔ: KOLÔN
KLOOT: TOKLO
KLOOW: WOKLO
KLOOZ: ZOKLO
KLOPÔ: KÔPLO
KLOTÇ: KLOTÇ
KLOVÂ: VOLKÂ
KLSÛÛ: SÛLÛK
KLTÛÛ: KÛLÛT
KMMÂÊ: KÂMÊM
KMNOÂ: KOMÂN
KMNÔÔ: MÔNÔK
KMOZÂ: KOZMÂ
KMTÊÛ: KÛTMÊ
KNNOÊ: KONNÊ
KNOOT: KOTON
KNOOÇ: KOÇON
KNOPÛ: KÛPON
KNOSÂ: KÂSON
KNOTÂ: KÂNOT
       KÂTON
       KONTÂ
KNOTÛ: KONTÛ
KNOWÛ: KÛWON
KNOYÊ: KONYÊ
KNÇÛÛ: ÇÛKÛN
KOOPT: POTKO
KOOSW: KOWOS
KOPSÔ: KÔPOS
KORÂÛ: OKÛRÂ
KOSYÂ: KOSYÂ
KPRÂÔ: KRÂPÔ
KPSÛÛ: SÛKÛP
KPTÔÛ: PÛKÔT
KPYÔÛ: KÛPYÔ
KRTÂÔ: RÂKÔT
KSTÂÔ: KÔSTÂ
KTÂÊÛ: ÊKÛTÂ
LLOOY: LOLOY
LMNOÊ: LONMÊ
LMTÂÂ: LÂTMÂ
LMWÂÛ: WÛLMÂ
LNNOÊ: LONNÊ
LNOTÂ: LONTÂ
LNPÂÊ: PLÂNÊ
LNTÂÎ: LÂNÎT
LOOPY: POLYO
LOPVÂ: ÂVLOP
LOSSÛ: SÛSOL
LOSVÂ: SOLVÂ
LOSYÔ: LOSYÔ
LOSÂÊ: ÊSOLÂ
LOTVÛ: LÛVTO
LOVYÂ: VYOLÂ
LOVYÔ: VYOLÔ
LOWÑÛ: WÛLOÑ
LPTÂÊ: PLÂTÊ
LPZÂÛ: ZÂPÛL
MMMÂÊ: MÊMMÂ
MMNÊÛ: NÛMÊM
MMVÂÛ: MÛVMÂ
MNNOÊ: MONNÊ
       NONMÊ
MNOOS: SOMON
MNOPÛ: PÛMON
MNOTÛ: MÛTON
MNOVÂ: NOVÂM
MNRÂÂ: RÂNMÂ
MNSÂÂ: SÂNÂM
MNSÊÊ: SÊMÊN
MNZÂÂ: ZÂMÂN
MOOPY: OPYOM
MOOSZ: OSMOZ
MOPYÔ: MOPYÔ
MOSWÂ: WOMÂS
MOSWÊ: OMWÊS
MOSZÂ: ZOSMÂ
MOTÂÇ: ÇÂMOT
MPPÔÔ: PÔPÔM
MPSÂÂ: PÂSMÂ
MSWÂÊ: ÂMWÊS
NNOOS: OSNON
NNOOT: OTONN
NNOSÊ: SONNÊ
NNOWÔ: WONNÔ
       WÔNON
NNTÂÎ: NÂNÎT
NOOSÇ: ÇOSON
NOOTÇ: TOÇON
NOPPÔ: PONPÔ
       PÔPON
NOPTÂ: TÂPON
NOPTÊ: NÊPOT
NOPYÊ: PONYÊ
NOSÂÇ: ÇÂSON
NOTTÔ: TONTÔ
       TÔTON
NOTÂÊ: ÂTONÊ
NOVVÔ: VONVÔ
       VÔVON
NOWYÊ: WONYÊ
NOYYÛ: YOYÛN
NOZZÔ: ZONZÔ
       ZÔZON
NPWÂÊ: NÂPWÊ
NPYÊÔ: PYÔNÊ
NPÂÂÂ: ÂPÂNÂ
NRTÊÊ: TRÊNÊ
NSZÂÎ: NÎZÂS
NYÂÂÎ: ÂNÎYÂ
NZZÛÛ: ZÛZÛN
NÂÇÊÊ: ÂÇÊNÊ
OOTTT: TOTOT
OOTTY: TOTOY
OOTWW: WOWOT
OOTÇÇ: ÇOÇOT
OPSYÔ: OPSYÔ
       POSYÔ
OPTWÔ: PWOTÔ
OPTWÛ: TWÛPO
OPTÂÊ: ÊPOTÂ
ORTYÊ: RÊTYO
ORVYÊ: VORYÊ
OTWYÛ: TWÛYO
PPPÊÊ: PÊPÊP
PPÂÂÊ: ÂPÊPÂ
PRTÂÂ: ÂTRÂP
PRTÂÊ: ÂPRÊT
       PRÊTÂ
PSVÎÛ: PÛSÎV
PSWÊÔ: PWÊSÔ
PSYÂÔ: PÂSYÔ
PTYÂÂ: TYÂPÂ
PTÂÂÇ: TÇÂPÂ
PWWÊÔ: WÔPWÊ
PYÂÇÔ: ÇÂPYÔ
RSVÊÛ: SÛVRÊ
SSTÂÂ: SÂTÂS
STTÛÛ: TÛTÛS
STYÂÔ: TÂSYÔ
STYÊÛ: SÛTYÊ
SYZÂÊ: ZÂSYÊ
TVZÂÛ: VÂTÛZ
