AAABKL: BAKALA
AAABKR: BAKARA
AAABLZ: ALABAZ
AAABNN: BANANA
AAABRT: TABARA
AAABTY: ATYABA
AAADRV: AVADRA
AAAFLW: ALAFWA
AAAFNZ: ANAFAZ
AAAGLT: GALATA
AAAGNS: AGASAN
AAAJLN: ALANAJ
AAAKLP: PAKALA
AAAKLT: ALATAK
AAAKNS: AKASAN
AAAKRW: ARAWAK
AAALMM: LAMAMA
AAALVW: AVALWA
AAAMRS: MARASA
AAAMÇÇ: MAÇAÇA
AAANPR: APARAN
AAANTT: ATANTA
AAANTÇ: ATAÇAN
AAANZZ: ZAZANA
AAAPST: SAPATA
AAAPTV: VATAPA
AAAPYY: PAYAYA
AAAYYY: AYAYAY
AABBDO: ABODAB
AABBIT: ABITAB
AABBKO: BABAKO
        KOBABA
AABBKÛ: KÛBABA
AABBRÂ: ÂBABRA
AABDEL: BALADE
AABDJN: BANDAJ
AABDJÛ: ABÛDJA
AABDLO: ABLADO
AABDNÔ: ABÔDAN
AABDOR: ADORAB
AABDSÂ: ÂBASAD
AABEGR: BAGARE
AABEKL: AKABLE
AABEKN: ANBAKE
AABEKR: KABARE
AABELN: ANBALE
AABENT: ANBATE
AABERÇ: RABAÇE
AABFKN: FABNAK
AABGLÂ: BÂGALA
AABGNO: ANBAGO
AABGVÔ: VAGABÔ
AABIKR: ARABIK
AABIKÇ: KABIÇA
AABIMN: ABIMAN
AABINT: ABITAN
AABINZ: ABIZAN
AABIPR: ABAPRI
AABJLÂ: ÂBALAJ
AABJZÂ: ÂBAZAJ
AABKLN: BANKAL
        LABANK
AABKLO: LABOKA
AABKLS: KALBAS
AABKNN: KABANN
AABKNR: BRANKA
AABKOZ: ZABOKA
AABKPÊ: ÊKAPAB
AABKRW: RAKBWA
AABKRÇ: ÇABRAK
AABKTÇ: BAKÇAT
AABKVÔ: VAKABÔ
AABKWÔ: AKWABÔ
AABKYÛ: BAYAKÛ
        KABÛYA
AABLMY: MABYAL
AABLNN: BANNAL
AABLNS: BALANS
AABLNÂ: ÂBALAN
        ANBALÂ
AABLNÇ: BLANÇA
AABLOV: LAVABO
AABLPÊ: LABAPÊ
AABLÂÇ: ÂBAÇAL
AABMNN: BAMANN
AABMNÛ: MANÛBA
AABMRÛ: MARABÛ
AABMYÂ: MAYÂBA
AABMYÛ: MABÛYA
AABNSS: ABSANS
AABNTV: BAVANT
AABNWZ: ANBWAZ
AABOWZ: AWOZAB
        OZABWA
AABRRÛ: BÛRARA
AABRVY: VARYAB
AABRVÂ: AVÂBRA
AABTWÇ: BWAÇAT
AADDMO: MADODA
AADEGL: ALEGAD
AADEJN: AJENDA
AADEJZ: JEDAZA
AADEKN: DEKANA
AADEKS: SAKADE
AADELL: DELALA
AADELN: ALADEN
AADEPT: ADAPTE
        APATED
AADGLN: ANGLAD
AADGVÂ: AVÂGAD
AADIKN: ANDAKI
AADILM: AMIDAL
        MALADI
AADINZ: DINAZA
AADIPR: PARADI
AADIRT: DARATI
AADIVY: DAYIVA
AADJMN: JANDAM
AADJNÂ: AJÂNDA
AADKKS: KASKAD
AADKLO: AKOLAD
AADKNR: KADRAN
AADKNS: KADANS
AADKOS: SAKADO
AADKPW: PADKWA
AADKWY: DYAKWA
AADKWZ: KWAZAD
AADLMO: ALAMOD
AADLNN: LADANN
AADLNS: SANDAL
AADLOP: PALADO
AADMMN: MADANM
AADMNY: DYAMAN
AADNNN: ANNDAN
AADNNP: PANDAN
AADNYÇ: ÇANDAY
AADPRÛ: RAPADÛ
AADTTÊ: ÊTATAD
AAEFGR: AGRAFE
AAEFJM: AFEMAJ
AAEFLN: ALAFEN
        ANFALE
AAEFNN: ANNAFE
AAEFNV: ANFAVE
AAEGJN: ANGAJE
AAEGNN: ANNEGA
AAEGNT: AGANTE
AAEGRV: AGRAVE
AAEGSW: ASAGWE
AAEJKS: SAKAJE
AAEJNR: ANRAJE
AAEJNT: AJANTE
AAEJNÇ: ANÇAJE
AAEJPS: PASAJE
AAEJPT: PATAJE
        TAPAJE
AAEJRV: RAVAJE
AAEKKN: ANKAKE
AAEKKY: KAKAYE
AAEKLM: AKLAME
AAEKMR: KAMERA
AAEKNP: KANAPE
AAEKNY: AKEYAN
AAEKRT: KARATE
AAELMN: ALAMEN
AAELMR: LAMARE
AAELNV: ALANVE
AAELTT: ALATET
AAEMTÇ: MAÇATE
AAENPR: ANPARE
AAENPT: APANTE
AAENPY: ANPAYE
AAENRT: ANRETA
AAENSS: ASANSE
        ASASEN
AAENSV: AVANSE
AAENSW: AWESAN
AAEPRS: APRESA
AAEPRT: ATRAPE
AAEPRY: APAREY
AAETVY: AVYATE
AAEWYÇ: ÇAWAYE
AAFILM: LAFAMI
AAFIMS: FAMASI
AAFINR: FARINA
AAFJMS: SAJFAM
AAFKWÇ: KWAÇAF
AAFLMN: FLAMAN
AAFLNN: FANNAL
AAFLST: ASFALT
AAFMTÛ: MAFÛTA
AAFNPR: FRAPAN
AAFNSW: SANFWA
AAFNSY: FAYANS
AAFRWÔ: FARAWÔ
AAGGIR: GAGARI
AAGGNN: GAGANN
        GANGAN
AAGIMN: AGIMAN
        MANIGA
AAGISY: GASIYA
AAGJLN: LANGAJ
AAGJLS: GLASAJ
AAGKNR: KARANG
AAGLMW: MAGLWA
AAGLMÂ: MALÂGA
AAGLNY: LAGANY
AAGMNÂ: AGÂMAN
        AGANMÂ
AAGMZÂ: MAZÂGA
AAGMZÊ: MAGAZÊ
        MAZÊGA
AAGNNR: ANGRAN
AAGNOW: AWOGAN
AAGNVÛ: AVANGÛ
AAGOTW: OGATWA
AAGRTW: GRATWA
AAGRVW: GRAVWA
AAGRVÂ: AGRAVÂ
AAGVWY: GWAYAV
AAHSSÛ: HAÛSSA
AAIJMP: PIJAMA
AAIKKS: KASIKA
AAIKKY: AKAYIK
AAIKLL: ALKALI
AAIKLM: AKALMI
        AKAMIL
        AMIKAL
AAIKNR: KANARI
AAIKSS: KISASA
AAILMN: ALIMAN
AAILNP: APLANI
AAILNT: LANATI
AAILNV: ALAVNI
AAILNZ: ANALIZ
AAIMNZ: AMIZAN
AAINPR: PANARI
AAINRT: ATIRAN
AAINSÇ: ANAÇIS
AAINTV: AVANTI
AAINTZ: ATIZAN
AAINVY: ANVAYI
AAINYZ: AYIZAN
AAIPTT: PATATI
AAIRSV: AVARIS
AAIRTÇ: ARITÇA
AAIRVV: VAVARI
AAITYZ: ATIZAY
AAIWWÇ: ÇIWAWA
AAIWYZ: ZAYIWA
AAJKKÂ: JÂKAKA
AAJLPS: PLASAJ
AAJMNÇ: ÇAJMAN
AAJMRY: MARYAJ
AAJNTÊ: AJANTÊ
AAJNVÛ: AVANJÛ
AAJPRY: PARYAJ
AAJTVÂ: AVÂTAJ
AAJVWY: VWAYAJ
AAKKNY: KAYANK
AAKKOR: KARAKO
AAKKOW: KAKAWO
AAKKTT: KATKAT
AAKKÇÇ: KAÇKAÇ
AAKLLÊ: ALKALÊ
AAKLLÛ: KALALÛ
AAKLMN: KALMAN
AAKLNN: KANNAL
AAKLNP: ANPLAK
AAKMOW: MAWOKA
AAKMWÔ: MAKAWÔ
AAKNNR: KARANN
AAKNNY: KANNAY
AAKNOÇ: AKAÇON
AAKNPT: PANKAT
AAKNRT: KARANT
        KATRAN
AAKNSV: VAKANS
AAKNTV: KANTAV
AAKNTÛ: ANTÛKA
AAKNWY: KWAYAN
AAKORW: KARAWO
AAKPSY: SAKPAY
AAKPWZ: KAPWAZ
AAKRST: KASTRA
AAKRTV: KRAVAT
AAKSTÂ: KÂTASA
AALLMV: MALVAL
AALLNS: LASNAL
AALLPS: LAPLAS
AALLPÛ: LAPÛLA
AALMMN: MALMAN
AALMNN: LANMAN
AALMNO: ANOMAL
AALMNP: PALMAN
AALMNT: MANTAL
AALMNV: LAVMAN
AALMNÇ: LAÇANM
AALMSY: MASYAL
AALNNS: LANSAN
AALNPS: ANPLAS
AALNPT: ANPLAT
AALNSS: SANSAL
AALNSV: SALNAV
AALNSY: ALYANS
AALNTV: LAVANT
AALNTÛ: ALANTÛ
AALNWÔ: ALAWÔN
AALOPS: PALASO
AALPSY: PLASAY
AALTWY: LATYAW
AALTYÇ: LATÇAY
AALTÂÇ: ÇALATÂ
AAMMNN: MANMAN
AAMMYY: MAYMAY
AAMNNN: MANNAN
AAMNNS: ANSANM
AAMNNÇ: MAÇANN
AAMNRT: RATMAN
AAMNTT: MATANT
AAMORZ: MAZORA
AAMPTÂ: APATMÂ
AAMRTÊ: TAMARÊ
AAMTÂÇ: ATAÇMÂ
AANNNN: NANNAN
AANNNT: ANTANN
AANNPP: PANPAN
AANNPR: APRANN
AANNPT: ANPANT
        PANTAN
AANNPÂ: ANPÂNA
        ÂPANNA
AANNSV: SAVANN
AANNTT: ANTANT
AANNTW: ANTWAN
AANNVY: VANYAN
AANNVÂ: ÂNAVAN
        ANNAVÂ
AANNWÇ: ANÇWAN
        ÇANWAN
AANORS: ARANSO
AANOTT: ATATON
AANPST: PATANS
AANPSÂ: ANPASÂ
        ÂPASAN
AANPTT: PATANT
AANPTÂ: ANPATÂ
        ÂPATAN
AANPTÇ: ÇAPANT
AANPYÇ: ÇANPAY
AANRTV: ANTRAV
AANRVW: RANVWA
AANSSÊ: ANSASÊ
AANTVY: VANTAY
AANTYÇ: AÇTAYN
        ÇANTAY
AANVWY: VWAYAN
AAOPPR: PARAPO
AAORTW: ORATWA
AAOWWZ: AWOZWA
AAOWYZ: AWOZAY
AAPPTT: TAPTAP
AAPRSÂ: APARÂS
AAPRTÂ: ATRAPÂ
AAPRVÂ: PARAVÂ
AAPRYY: PARYAY
        RAPYAY
AAPTYÂ: APÂTAY
AARTVY: TRAVAY
AARTWÛ: ARAWÛT
AATTYY: TYATYA
AATTÇÇ: TÇATÇA
AAWWÇÇ: WAÇWAÇ
ABBDEÔ: BÔBADE
ABBENN: BANBEN
ABBEOS: ABSOBE
ABBEOT: BABOTE
ABBIKÛ: KÛBABI
ABBKNÛ: BÛKBAN
ABBKÂÛ: BABÂKÛ
ABBLOY: BABYOL
ABBLSÂ: SÂBLAB
ABBLÂÛ: BÂBÛLA
ABBNOÇ: BANBOÇ
ABBNSÔ: BÔBANS
ABBOPW: PWOBAB
ABBOSÂ: ABSOBÂ
ABDEEK: DEBAKE
ABDEEL: DEBALE
ABDEER: DEBARE
ABDEEY: DEBAYE
ABDEGL: BELGAD
ABDEIÇ: DEBAÇI
ABDENN: BADNEN
        BEDANN
ABDERÛ: BÛRADE
ABDETY: DYABET
ABDEYÛ: DEBÛYA
ABDGIR: BRIGAD
ABDGOW: GADWOB
ABDGRÛ: GRADÛB
ABDIIT: ABITID
        DIBITA
ABDIMR: BRIMAD
ABDINÂ: BADINÂ
ABDINÊ: BADINÊ
ABDJMÛ: DJÛMBA
ABDJNO: BANDJO
ABDMOW: BWADOM
ABDNNO: DONNAB
ABDNOÂ: ABONDÂ
ABDNSÔ: BÔDANS
ABDNWÊ: BWADÊN
ABDOPY: PODYAB
ABDSÂÔ: ABÔDÂS
ABEEGN: ANBEGE
ABEENT: ANBETE
ABEFIL: AFEBLI
ABEFLN: FEBLAN
        FLANBE
ABEFNR: FANBRE
ABEFYÊ: ABYÊFE
ABEGRT: BRAGET
ABEGTW: BWAGET
ABEIKN: KABINE
ABEILN: ANBELI
ABEILR: LIBERA
ABEILS: SELIBA
        SILABE
ABEILT: ETABLI
ABEILZ: BALIZE
ABEIMN: ABIMEN
ABEIRT: ABITRE
ABEITY: ABITYE
ABEITZ: BATIZE
ABEJNY: JANBYE
ABEKNR: KANBRE
ABEKNT: BANKET
ABEKOS: KABOSE
ABEKRS: ESKRAB
ABEKRT: KABRET
ABEKRY: KRABYE
ABEKTW: KABWET
ABELMN: ANBLEM
ABELNN: BALENN
ABELNR: RANBLE
ABELNS: BELANS
        SANBLE
        SENBAL
ABELNT: TENBAL
ABELNÇ: BLANÇE
ABELOS: BOSALE
ABELOT: BALOTE
ABELRS: BRASLE
ABELRÛ: LABÛRE
ABELSÂ: ASÂBLE
        BALÂSE
        SALÂBE
ABELTT: TABLET
ABELTW: BATWEL
ABEMNR: MANBRE
ABEMÇÔ: BÔMAÇE
ABENNO: ABONEN
ABENNY: ANBYEN
ABENOÇ: ANBOÇE
ABENPW: BWAPEN
ABENRÇ: ÇANBRE
ABENST: ABSENT
ABENTÂ: ÂBETAN
        ANBETÂ
ABENWY: BENYWA
ABENYÛ: ANBÛYE
ABEORT: RABOTE
ABEPWY: PYEBWA
ABERRÛ: RABÛRE
ABERST: ABSTRE
ABERSÂ: ÂBRASE
ABERTV: BETRAV
ABERYZ: BRAZYE
ABESTÂ: ABSÂTE
ABESVY: SEVYAB
ABETYÇ: BETÇAY
ABFIIN: ANFIBI
ABFIKR: FABRIK
ABFKOS: BOSKAF
ABFLNO: FLANBO
ABFLOS: FOBLAS
ABFLÛÛ: FÛLÛBA
ABFNOW: BONFWA
ABFNTÛ: BÛFANT
ABGINR: BRIGAN
ABGLLO: GLOBAL
ABGNOY: GABYON
ABHRÂÑ: BRÂHAÑ
ABIKLN: BLAKIN
ABIKLÂ: ALÂBIK
ABIKNZ: KANBIZ
ABIKOR: ABRIKO
ABIKRS: BRISAK
ABIKRT: KABRIT
ABIKRÛ: KARIBÛ
ABIKTÛ: KÛBATI
ABILNR: LABRIN
ABILNT: TIBLAN
ABILNÇ: BLANÇI
ABILOS: ABSOLI
ABILOV: BOLIVA
ABILRT: BRITAL
ABILRV: LIVRAB
ABILRZ: LABRIZ
ABILVV: BIVALV
ABILYÛ: LABÛYI
ABILÇÊ: LABIÇÊ
ABIMTÂ: BATIMÂ
ABINRY: BRIYAN
ABINSS: SANSIB
ABINWZ: BIZNAW
ABINÇÛ: ANBÛÇI
ABIRRS: BRASRI
ABITWY: TIBWAY
ABJLNÂ: JÂBLAN
        JANBLÂ
ABJLRÔ: LÔBRAJ
ABJNNO: BONANJ
        BONJAN
        JANBON
ABJNNÔ: BÔNANJ
ABKKOO: BAKOKO
ABKLNO: BALKON
ABKLRÂ: KÂBRAL
ABKLÇÛ: ÇÛBLAK
ABKLÛÛ: BAKÛLÛ
ABKMOO: KOMABO
ABKMOÛ: KÛMABO
ABKMÂÂ: ÂBAKMÂ
ABKNOT: KONBAT
        KONTAB
ABKOTÔ: BAKOTÔ
ABKRTÛ: TRABÛK
ABKTÊÛ: ÊKÛTAB
ABKWÇÛ: ÇÛKBWA
ABLMNÊ: BLANMÊ
ABLNRÊ: LABRÊN
ABLNSÂ: SÂBLAN
        SANBLÂ
ABLNÊÔ: BALÔNÊ
ABLOOS: SOLOBA
ABLOTÔ: TÔBOLA
ABLRYÔ: LÔBRAY
ABLSTÊ: LABSÊT
ABMNOÂ: ABONMÂ
ABMNRÂ: MÂBRAN
ABNNNÂ: BÂNANN
        BANNÂN
ABNNRÊ: BRANNÊ
ABNOSW: BONSWA
        BWASON
ABNOWW: BWAWON
ABNSSÔ: BÔSANS
ABNSYÂ: ÂBYANS
        ANBYÂS
ABOORT: RABOTO
ABOYÂÇ: ÂBOÇAY
ABTVÂÂ: ÂBAVÂT
ADDEEM: MADEDE
ADDEJÂ: ADJEDÂ
ADDEKÛ: DEAKÛD
ADDELN: DLANDE
ADDENÂ: ÂDEDAN
        ANDEDÂ
ADDIJÂ: ADJIDÂ
ADDIKÂ: KÂDIDA
ADDOOZ: DOZADO
ADEEGJ: DEGAJE
ADEEGL: DELAGE
ADEEGR: REGADE
ADEEGY: DEGAYE
ADEEJÇ: DEÇAJE
ADEEKL: DEKALE
        DELAKE
ADEEKP: DEKAPE
ADEEKT: DETAKE
ADEELL: LALEDE
ADEELP: DEPALE
        PEDALE
ADEELS: DELASE
        DESALE
ADEELV: DELAVE
ADEEMN: ADEMEN
        ANMEDE
ADEEMR: DEMARE
ADEEMY: DEMAYE
        MEDAYE
ADEEMZ: DEZAME
ADEENP: DEPANE
ADEEPR: DERAPE
ADEEPS: DEPASE
ADEEPT: DEPATE
ADEEPY: DEPAYE
        PADEYE
ADEERS: ADRESE
ADEERT: RETADE
ADEERY: DERAYE
ADEESV: ADVESE
ADEETY: DETAYE
ADEETÇ: DETAÇE
ADEFGR: DEGRAF
ADEFIZ: ADEZIF
        DEZAFI
ADEFKN: FEDKAN
ADEFNN: DEFANN
ADEFNO: ANDEFO
ADEFNS: DEFANS
ADEFNÊ: FÊDANE
ADEGIR: GERADI
ADEGIV: DIVAGE
ADEGJR: GADJER
ADEGJÂ: DEGAJÂ
ADEGNR: GRADEN
        GRANDE
        GRENAD
ADEGNY: GADYEN
ADEGNÂ: ÂNEGAD
ADEGRY: GRADYE
ADEGRÂ: REGADÂ
ADEIKL: DELIKA
ADEILM: LEMADI
ADEILN: ILANDE
ADEILT: ADILTE
        DILATE
ADEILY: IDEYAL
ADEIMR: ADMIRE
ADEIMS: DIMASE
ADEIMÇ: AÇIMED
ADEINR: ANDIRE
ADEINT: ETANDI
ADEIPS: PADESI
ADEIPT: DEPATI
ADEIST: SETADI
ADEITY: DEYITA
ADEIVY: AVIDEY
ADEJKT: DJAKET
ADEJMO: DOMAJE
ADEJNR: DRENAJ
ADEJNW: ADJWEN
ADEJNÂ: ÂDANJE
        ANDÂJE
ADEKNO: ADOKEN
ADEKNÔ: KÔDANE
ADEKOS: KODASE
ADEKOZ: DEZAKO
ADEKRÂ: ÂKADRE
ADEKSW: ESKWAD
ADELMN: LANMED
ADELNO: OLANDE
ADELNT: DANTEL
ADELNÇ: ÇANDEL
ADELRS: LADRES
ADEMMT: METDAM
ADEMNN: DANMEN
        DEMANN
ADEMNS: DESANM
ADEMNY: DANMYE
        MEDYAN
ADEMNÂ: ÂMEDAN
        ANMEDÂ
ADEMOW: MAWODE
ADEMPÂ: DEPAMÂ
ADEMTY: DYAMET
ADEMTÂ: MÂDATE
ADEMTÔ: ADMETÔ
ADEMÂÇ: MAÇÂDE
ADENNP: DEPANN
ADENNS: DESANN
ADENNT: DETANN
ADENNÇ: ÇENDAN
ADENNÑ: NANDEÑ
ADENNÔ: ADÔNEN
ADENOP: PADONE
ADENOS: ANDOSE
ADENOY: ANDEYO
ADENPS: DEPANS
ADENPT: PENTAD
ADENPY: PANDYE
ADENSS: DESANS
        SANDES
ADENST: DESANT
ADENSÊ: ÊDESAN
ADENTT: DETANT
ADEOPT: ADOPTE
        PETADO
ADEORT: RADOTE
ADEOSY: ODASYE
ADEOTW: TAWODE
ADEPRT: TRAPDE
ADEPTY: PEDYAT
ADERSS: SEDRAS
ADESTÂ: ESTÂDA
ADESWW: SWEDWA
ADETYÂ: ÂDETAY
        DETAYÂ
ADEYZÂ: ÂDEZAY
ADEYZÔ: ADEZYÔ
ADFIKÜ: KAFÜDI
ADFNSÂ: DÂFANS
        DANFÂS
ADFOYÛ: FÛYADO
ADGILS: GLISAD
ADGINR: GRANDI
ADGINÛ: ANGÛDI
ADGIPR: GRIDAP
ADGIRY: GRIYAD
ADGIRÂ: AGRÂDI
ADGKOT: GADKOT
ADGLOY: DYALOG
ADGLSÛ: DÛGLAS
ADGMÛÜ: MADÜGÛ
ADGNNÊ: NANDÊG
ADGNOR: DRAGON
ADGNRÊ: GRÊNAD
ADGNRÔ: GRANDÔ
ADGNRÛ: GRANDÛ
ADGNYÛ: DYÛGAN
ADGRRÂ: GRÂDRA
ADGWYÛ: GWÛYAD
ADIITT: ATITID
ADIITY: DAYITI
ADIJKO: JIDOKA
ADIJNN: DJANNI
ADIJNÊ: ÊDIJAN
ADIKLS: KLISAD
ADIKMS: MISKAD
ADIKPÂ: ÂDIKAP
ADIKSÂ: AKSIDÂ
ADIKSÊ: SÊDIKA
ADIKTÂ: DÂTIKA
ADILNP: PANDIL
ADILOP: APLODI
ADILOS: SALIDO
ADILOT: ALTIDO
ADILYZ: DYALIZ
ADIMNO: ANDOMI
        DINAMO
ADIMNÇ: DIMANÇ
ADIMOZ: MIZADO
ADIMTÊ: DIMATÊ
ADIMÇÔ: MADIÇÔ
ADINNS: DISANN
        NANSID
ADINNY: DYANNI
ADINOW: AWONDI
ADINPR: PANDRI
        PRIDAN
ADINRY: DIRYAN
ADINST: DANTIS
ADINÇÊ: ÇIÊDAN
ADIOÇÇ: ÇIÇADO
ADIPRR: DRAPRI
ADIPSÊ: APÊDIS
ADIRYÊ: ADRIYÊ
ADISYÔ: ADISYÔ
ADJKTÛ: DJAKÛT
ADJLNÛ: JÛDLAN
ADJOPT: DJAPOT
ADJORÂ: ORÂJAD
ADKKOÔ: KÔKODA
ADKMOÊ: MADOKÊ
ADKNWÔ: DAKWÔN
ADKOÇÛ: KÛÇADO
ADKTYÛ: DYAKÛT
ADKYYÛ: KÛDYAY
ADLMNÊ: LANDMÊ
ADLMYÔ: MÔDYAL
ADLNOP: DAPLON
ADLNOW: WOLDAN
ADLPWÛ: PLAWÛD
ADLTWÂ: LÂDWAT
ADMNOP: PONMAD
ADMNRÂ: RÂDMAN
        RANDMÂ
ADMNSÛ: DÛSMAN
ADMNYÂ: MÂDYAN
        MANDYÂ
ADMNÊÔ: ANDÊMÔ
ADMOTY: DYATOM
ADMOYÂ: ADYOMÂ
ADNNNO: DONNAN
ADNNOT: TANDON
ADNNOÊ: ADONNÊ
ADNOSY: ODYANS
ADNOWÇ: ÇADWON
ADNPZÛ: ZANPÛD
ADNPÊÔ: PADÔNÊ
ADNRTÛ: TÛNDRA
ADNRÂÛ: ÂDÛRAN
        ANDÛRÂ
ADNSTÂ: TÂDANS
        TANDÂS
ADNSTÛ: DÛTANS
ADOPTY: DYAPOT
ADTTWÛ: TÛDWAT
AEEFKT: AFEKTE
AEEFLN: ELEFAN
AEEFMN: AFEMEN
        ANFEME
AEEFRY: FERAYE
AEEGLN: ELEGAN
AEEGLV: AVEGLE
AEEGLY: LEGAYE
AEEGMZ: EGZEMA
AEEGRS: AGRESE
AEEGRY: AGREYE
AEEGTZ: EGZEAT
AEEJMN: MENAJE
AEEJPS: ASPEJE
AEEKLN: ALEKEN
AEEKLT: EKLATE
AEEKMR: REMAKE
AEEKMZ: EKZEMA
AEEKNN: ENKANE
AEEKNS: ANKESE
AEEKNT: ANKETE
AEEKRS: KARESE
AEEKRT: RAKETE
AEEKTT: KATETE
AEEKVÇ: AÇEVEK
AEELMN: ELEMAN
AEELMR: MALERE
AEELMY: ALEMYE
AEELNV: ALEVEN
AEELRS: SELERA
AEELRT: LATERE
AEELTW: ETWALE
AEELTY: ATELYE
AEELVY: EVALYE
AEENPR: ANPERE
AEENPT: ETANPE
AEENPÇ: ANPEÇE
AEENRT: ANTERE
AEENST: SENATE
AEENTT: ANTETE
AEEPPR: APEPRE
AEEPPZ: PEZAPE
AEEPRR: REPARE
AEEPRS: PARESE
        REPASE
        SEPARE
AEEPST: ASEPTE
AEEPWZ: PAWEZE
AEERRY: ARYERE
AEESTT: ATESTE
        ESTATE
AEFGIT: FATIGE
AEFGJR: GREFAJ
AEFIJL: AFLIJE
AEFIKS: EFIKAS
AEFILY: AFILYE
AEFIMM: MAMIFE
AEFINR: RAFINE
AEFJLL: FLAJEL
AEFJOZ: EZOFAJ
AEFKKW: KEKFWA
AEFKLN: FLANKE
AEFKNR: FREKAN
        KANFRE
AEFKTY: KAFTYE
AEFKWZ: KWAFEZ
AEFLLN: FLANEL
AEFLNN: FLANNE
AEFLNR: FLERAN
AEFLNÇ: ANFLEÇ
AEFLNÊ: ÊFENAL
AEFLVY: LAFYEV
AEFMNY: MEFYAN
AEFMNÊ: ANFEMÊ
AEFMOT: FOMATE
AEFMRÂ: AFREMÂ
AEFMSÎ: MASÎFE
AEFMYÂ: ÂFEMAY
AEFNNY: FENYAN
AEFNNÜ: ANFÜEN
AEFNRS: FRANSE
AEFNSÔ: ANFÔSE
AEFNTÂ: ÂFANTE
        ANFÂTE
AEFPRS: PREFAS
AEFRYÛ: FÛRAYE
AEFTWÔ: AFWÔTE
AEFTYÔ: FAYETÔ
AEFTZÛ: ATÛFEZ
AEFWÇÛ: FAWÛÇE
AEGGNN: GENGAN
AEGGOT: GAGOTE
AEGILL: ILEGAL
AEGILN: INEGAL
AEGILR: GALERI
AEGILZ: GALIZE
AEGINV: ANVIGE
        NAVIGE
AEGINY: GIYANE
AEGIRY: GERIYA
AEGJLN: LAJENG
AEGJNO: ANGOJE
AEGLLR: LAGREL
AEGLLY: GLAYEL
AEGLMN: GANMEL
        MALENG
AEGLMR: MALGRE
AEGLNO: OGANEL
AEGLNS: SANGLE
AEGLNT: LANGET
        LATENG
AEGLNZ: ANGLEZ
        LANGEZ
        ZANGLE
AEGLOP: GALOPE
AEGLRT: GRATEL
AEGLSY: GLASYE
AEGLVÂ: AVEGLÂ
AEGMNN: ENGANM
AEGMNR: GRANME
AEGMNS: SEGMAN
AEGMNT: MANTEG
AEGMZÊ: EGZAMÊ
AEGNNR: ANGREN
        GRENNA
AEGNNT: GENTAN
AEGNPZ: EGZANP
AEGNRT: GRATEN
AEGNRV: ANGREV
AEGNRÇ: ÇAGREN
AEGPTÂ: GETAPÂ
AEGRSY: GRASYE
        GRESAY
AEGRVY: GRAVYE
AEGSWÂ: AGWESÂ
AEGTWÂ: WÂGATE
AEGYZÛ: GAZÛYE
AEIJPY: PIYAJE
AEIJRT: ERITAJ
AEIJST: AJISTE
AEIKLP: APLIKE
        KAPILE
AEIKLR: ALEKRI
        EKLARI
AEIKLS: ALEKSI
AEIKLT: KALITE
AEIKMY: MAKIYE
AEIKNT: TAKINE
AEIKPY: EKIPAY
AEIKTV: KAVITE
AEIKTÇ: AÇITEK
AEILMR: LAMERI
AEILMS: SILEMA
AEILMT: ALIMET
AEILNN: ANNILE
AEILNP: ANPILE
AEILNS: SELINA
AEILNY: ALIYEN
AEILSY: SIYALE
AEILTT: TITALE
AEILTY: LAYITE
AEIMNS: SINEMA
AEIMNT: ETAMIN
        MATINE
AEIMSY: SIMAYE
AEIMTY: AMITYE
AEIMYZ: MAYEZI
AEINPR: ANPIRE
AEINPT: ANPITE
AEINPV: PAVENI
AEINPZ: ZEPINA
AEINRÇ: ANÇERI
AEINSY: ASIYEN
AEINTV: VANITE
AEINTZ: ANIZET
AEIPRS: ASPIRE
AEIRSY: ASYERI
AEIRTY: ERITAY
        TIRAYE
AEIRTÇ: ÇARITE
AEIRVÇ: ÇAVIRE
AEIRYÇ: REÇIYA
        YERAÇI
AEISST: ASISTE
AEISTT: ESTATI
AEIWYZ: AZWEYI
AEJJNN: JENJAN
AEJLMN: MELANJ
AEJLMO: MALOJE
AEJLNO: ALONJE
AEJLNW: LWANJE
AEJLNÜ: LAJÜEN
AEJLRÔ: RALÔJE
AEJLSÛ: SÛLAJE
AEJLVY: LAVYEJ
AEJLYÜ: JÜALYE
AEJMNS: JASMEN
AEJNOP: JAPONE
AEJNPY: JANPYE
AEJNRT: ETRANJ
AEJNRV: REVANJ
AEJNTW: ANJWET
AEJNTÂ: AJÂTEN
AEJNVY: JANVYE
AEJOPT: POTAJE
AEJOVW: JEWOVA
AEKKNY: KENKAY
AEKKST: KASKET
AEKLLO: ALKOLE
AEKLMN: KLEMAN
AEKLMR: MAKREL
        REKLAM
AEKLNN: KANNEL
AEKLNO: ANKOLE
AEKLNV: KALVEN
AEKLOP: ALEPOK
AEKLOS: ALOSKE
AEKLOT: KALOTE
AEKLST: LATEKS
AEKLSV: ESKLAV
AEKLTY: AKTYEL
AEKLTÛ: ALEKÛT
AEKLVY: KLAVYE
AEKLWZ: KAZWEL
AEKMMN: KANMEM
AEKMNÂ: AMÂNKE
AEKMPY: MAKPYE
AEKMRS: KREMAS
AEKMRÂ: KAREMÂ
AEKMWÊ: AMWÊKE
AEKMZÊ: EKZAMÊ
AEKNNT: KANNTE
AEKNPS: ESKANP
AEKNPÇ: KANPEÇ
AEKNRW: RAKWEN
AEKNRÇ: ÇANKRE
AEKNSS: SEKANS
AEKNSV: VAKSEN
AEKOPT: KAPOTE
AEKOST: AKOSTE
AEKOSZ: KASEZO
AEKOTW: KAWOTE
AEKOWÇ: AKWOÇE
AEKPRÔ: KÔPARE
AEKRST: EKSTRA
AEKRSÂ: KARESÂ
AEKRTT: TRAKTE
AEKRTÑ: REKTAÑ
AEKRTÔ: RAKÔTE
AEKSTZ: EKSTAZ
AEKTYÇ: TÇYAKE
AEKTÂÇ: ÂKAÇET
AEKWYZ: KWAZYE
AELLTW: LALWET
AELMNN: LANMEN
AELMNS: LANMES
        MASLEN
        SELMAN
AELMNT: METLAN
        TELMAN
AELMNW: LEMWAN
AELMPY: PALMYE
AELMSÇ: ÇALMES
AELMTT: MALTET
AELMTÊ: LEMATÊ
AELMTÔ: ALÔTEM
AELMWÛ: MAWÛLE
AELNOW: ANWOLE
AELNPT: LETANP
        PLANET
        PLANTE
AELNPÇ: ÇAPLEN
        PLANÇE
AELNST: LASENT
AELNSV: VALSEN
AELNSY: LAYENS
AELOPS: SALOPE
AELOPV: VALOPE
AELOPY: LEYOPA
AELORY: AREYOL
AELOTÇ: EÇALOT
AELPPY: PLAPYE
AELPRT: PERALT
        PLATRE
AELPRV: PREVAL
AELPSS: LESPAS
AELPSW: LESPWA
AELPTÇ: ÇAPLET
AELPWY: PLWAYE
AELPYÛ: PÛLAYE
AELRSÂ: ARÂSEL
AELSSY: LASYES
AELSTÂ: LASÂTE
AELSTÊ: ÊSTALE
AELSZÔ: SALEZÔ
AELTTW: TWALET
AELTTÛ: TÛTALE
AELTVÊ: ÊTEVAL
AELTWZ: ZETWAL
AELTWÔ: LAWÔTE
AELVWY: VWALYE
        VWAYEL
AELWZÛ: LAWÛZE
AEMMNW: MENMWA
AEMMOT: MAMOTE
AEMNNP: PANMEN
AEMNNR: MARENN
AEMNNT: TANMEN
AEMNNV: MANNEV
AEMNNY: MANYEN
AEMNOR: ANMORE
AEMNPÇ: PAÇMEN
AEMNRV: VREMAN
AEMNRY: MARYEN
        RANMYE
AEMNRÛ: ANMÛRE
AEMNSS: SEMANS
AEMNSV: VESMAN
AEMNSW: MASWEN
AEMNTÂ: ANTEMÂ
        ÂTEMAN
AEMNTÇ: MANÇET
AEMNVÊ: EVÊMAN
AEMNWY: MWAYEN
AEMOST: ESTOMA
AEMPZÂ: APEZMÂ
AEMRSÂ: RÂMASE
AEMRZÛ: AMÛREZ
AEMTWY: MWATYE
AENNNT: TANNEN
AENNNV: VANNEN
AENNOS: ANONSE
AENNOT: ETONAN
AENNPP: PENPAN
AENNPR: PARENN
AENNPT: PANTEN
        TENPAN
AENNPY: PANYEN
AENNRV: REVANN
AENNSS: NESANS
AENNST: ANSENT
        ESTANN
        SANTEN
AENNSV: VENSAN
AENNSY: ANSYEN
AENNTÔ: TAÔNEN
AENNVÊ: ÊNEVAN
AENOST: ASETON
AENOSY: OSEYAN
AENOSZ: ASEZON
AENOTV: TAVENO
AENOZÇ: OZANÇE
AENPRS: PRESAN
AENPRT: TRANPE
AENPRZ: PREZAN
AENPST: ESPANT
AENPTT: TANPET
AENPTY: PANTYE
AENPTÇ: ÇANPET
AENRRT: RANTRE
AENRST: RESTAN
AENRTÇ: TRANÇE
AENRTÛ: ANRETÛ
        ANTÛRE
AENRYÂ: ÂNARYE
AENRYÇ: REÇANY
AENSSY: SEYANS
AENSSÂ: ANSÂSE
        ÂSANSE
        ÂSASEN
AENSTZ: ZANSET
AENSTÂ: ANSÂTE
        ÂSANTE
AENTVÊ: ÊVANTE
AENTYÇ: ÇANTYE
AENTÂÇ: ÂÇANTE
        ANÇÂTE
AENVWZ: VWAZEN
AEOPRT: RAPOTE
AEOPRV: VAPORE
AEOPWÇ: APWOÇE
AEORVW: OREVWA
AEOSSY: ASOSYE
AEOTVY: OVETAY
AEOTWY: WAYOTE
AEPRTZ: TRAPEZ
AEPRVW: PREVWA
AEPSWZ: ZESPWA
AEPVWÛ: APWÛVE
AERSTV: TRAVES
AERTVÂ: ÂTRAVE
AERTZÔ: RATEZÔ
AERYYÊ: AYERYÊ
AESTTW: TWASET
AESVZÂ: SÂZAVE
AETVYÂ: AVÂTYE
        EVÂTAY
AFFNWÂ: FÂNFWA
AFGIKR: GRAFIK
AFGIRT: GRAFIT
AFGITÂ: FATIGÂ
AFGLRÂ: FLAGRÂ
AFIIST: ATIFIS
AFIJKÜ: KAFÜJI
AFIJLR: FRAJIL
AFIKNN: KANNIF
AFIKRT: FRAKTI
        TRAFIK
AFIKRÊ: AFRIKÊ
AFILMÂ: LAFÂMI
AFILMÊ: LAFIMÊ
AFILNS: SANFIL
AFIMNÂ: ÂFANMI
        ANFÂMI
AFIMSÂ: FÂMASI
AFIMSÔ: FÔMASI
AFIMTÂ: FATIMÂ
AFINNS: FINANS
AFINRÇ: FRANÇI
AFINRÊ: FARINÊ
AFIRTY: FRITAY
AFIRÂÇ: AFRÂÇI
AFITTÂ: ATÂTIF
AFITYÂ: ÂFAYIT
AFJMOW: FWOMAJ
AFJMSÂ: FÂMSAJ
AFJMWÔ: FWÔMAJ
AFJNOR: NOFRAJ
AFKLNO: FLAKON
AFKMNO: KANMFO
AFKNYÔ: KÔFYAN
AFKORY: KOFRAY
AFKOSY: FYASKO
AFKRSÊ: FARÊKS
AFKSYÔ: FAKSYÔ
AFLMNÂ: FLÂMAN
        FLANMÂ
AFLNNÊ: FLANNÊ
AFLNOP: PLAFON
AFLTYÂ: LAFYÂT
AFLTÂÔ: LAFÔTÂ
AFMNOT: FANMOT
        FANTOM
AFMSYÂ: FÂMSAY
AFNNÊÛ: ANFÛNÊ
AFNPTÛ: PANTÛF
AFNTÂÊ: ÂFANTÊ
        ANFÂTÊ
AFPTÊÛ: PAFÛTÊ
AFRSWÂ: FRÂSWA
AGGIZZ: ZIGZAG
AGGNNÂ: NGÂGAN
        NGANGÂ
AGGNRÛ: GRANGÛ
AGGNSÂ: GÂGANS
        GANGÂS
AGGNÂÊ: GAGÂNÊ
AGHNNÛ: HÛNGAN
AGIINT: GANITI
AGIJRY: GRIYAJ
AGIKST: GASKIT
AGILLN: LALING
AGILMÂ: LIGAMÂ
AGILNN: GILANN
AGILNO: LAGONI
AGILNS: GLISAN
AGILWY: GWAYIL
AGIMNP: PIGMAN
AGIMRS: GRIMAS
AGINNW: IGWANN
AGINOS: OGANIS
AGINRS: SANGRI
AGINRT: GRANIT
AGINZÔ: GANIZÔ
AGIRST: GRATIS
AGIRTÂ: GARÂTI
AGIRWZ: RIGWAZ
AGIRYY: GRIYAY
AGISTÔ: TIGASÔ
AGISVW: SIGWAV
AGJMÂÂ: ÂGAJMÂ
AGJNOW: GWOJAN
AGJNRÂ: GRÂJAN
        GRANJÂ
AGKLOT: KOLGAT
AGLNNO: LONGAN
AGLNÊÔ: GALÔNÊ
AGLOPT: GALPOT
AGLWÛÛ: LÛGAWÛ
AGMNRÜ: GRANMÜ
AGMNÂÂ: ÂGÂMAN
        ÂGANMÂ
        ANGÂMÂ
AGMOSÂ: MASOGÂ
AGMRTÂ: GRATMÂ
AGMSÂÛ: MÂGÛSA
AGNNOY: YOGANN
AGNORT: GRATON
AGNORY: GARYON
AGNPWÛ: ANGWÛP
AGNSWÊ: SANGWÊ
AGOSWÂ: AWOGÂS
AIIKLT: ITALIK
AIIKMN: MANIKI
AIIKMZ: KAZIMI
AIILLN: ALILIN
AIILNS: LASINI
AIILNT: LITANI
AIILPP: LAPIPI
AIIMSS: MASISI
AIINRT: IRITAN
AIINRW: IRINWA
AIINRÇ: ANRIÇI
AIINZZ: ZIZANI
AIIRSV: ARIVIS
AIISTY: SIYATI
AIISVÇ: AÇIVIS
AIIVVZ: VIZAVI
AIJJMN: JIJMAN
AIJLSÜ: JÜALIS
AIJLZÛ: JALÛZI
AIJMSÂ: AJISMÂ
AIJNST: JISTAN
AIJNSV: JANSIV
AIJRTÂ: AJÂTRI
AIKKLL: KALKIL
AIKKLS: KALIKS
        KLASIK
AIKKNN: KANNIK
AIKKNT: KANTIK
AIKKST: KAKTIS
AIKLMN: ANKLIM
AIKLMO: KALOMI
AIKLNY: KLIYAN
AIKLOR: KALORI
AIKLOT: AKOLIT
AIKLPÔ: AKÔPLI
AIKLST: LASTIK
AIKLSY: KLISAY
AIKMMO: KAMOMI
AIKMNN: KINANM
AIKMOT: ATOMIK
        TIKOMA
AIKMST: MASTIK
AIKMTÛ: MAKÛTI
AIKMYÂ: KAYIMÂ
AIKMÂÇ: KAÇIMÂ
AIKNNP: NAPKIN
AIKNNR: RANKIN
AIKNNT: KANTIN
AIKNOT: ANTIKO
AIKNOV: KANIVO
AIKNOZ: KAZINO
AIKNRÂ: KÂNARI
AIKNSV: VAKSIN
AIKNSÇ: ÇASKIN
AIKNTÊ: TAKINÊ
AIKOPT: PAKOTI
AIKOSZ: SIZOKA
AIKPRS: KAPRIS
AIKPRT: PRATIK
AIKPRY: KRIPYA
AIKPSÛ: PÛKISA
AIKPYÔ: KÔPAYI
AIKRST: AKTRIS
AIKRYÔ: KARIYÔ
AIKTTÂ: ÂTATIK
AIKTVW: VIKTWA
AILMOR: RAMOLI
AILMOY: MAYILO
AILMOÇ: ÇALIMO
AILMPS: PALMIS
AILMPT: MILPAT
AILMYÂ: ALIYMÂ
AILNOW: ALOWIN
AILNOZ: IZOLAN
AILNPR: RANPLI
AILNPS: ANPLIS
AILNPT: PLATIN
AILNPÑ: PLANIÑ
AILNRT: LATRIN
AILNTY: LANTIY
AILNVZ: VAZLIN
AILOPT: PALITO
AILORT: ORALTI
AILOTT: LATOTI
AILOWZ: IZOLWA
AILSSÂ: SALISÂ
AILSTW: LISTWA
AILTYÊ: ITALYÊ
AILVYÔ: ALIVYÔ
AILYZÔ: ALIZYÔ
AIMMTÜ: TIMAMÜ
AIMMZÂ: AMIZMÂ
AIMNNO: ANONIM
AIMNOT: MATINO
AIMNOÇ: MONAÇI
AIMNRÊ: ANRIMÊ
        MARINÊ
AIMNST: SANTIM
AIMNTÊ: MATINÊ
AIMPÂÇ: PAÇIMÂ
AIMRST: MATRIS
AIMTÂÇ: ÇATIMÂ
AINNOS: INOSAN
AINNRT: TANNRI
AINNTT: TANTIN
AINNTZ: TIZANN
AINORY: IYORAN
AINOTY: TAYINO
AINPPY: PIYANP
AINPRT: TANPRI
AINPRZ: ANPRIZ
AINPRÂ: PÂNARI
AINPSS: PISANS
AINPSY: PYANIS
AINPTÊ: PATINÊ
AINPÇÊ: PÊÇINA
AINRSW: NWARIS
AINSSÊ: SASINÊ
AINSVW: SWIVAN
AINSVZ: ZANSIV
AINTTÛ: TATÛNI
AINVWZ: VWAZIN
AINVWÔ: ANVIWÔ
AINWZÇ: ÇINWAZ
AIOPRZ: PARIZO
AIOPST: PITOSA
        SAPOTI
AIOPTÇ: ÇAPITO
AIOTTT: TITATO
AIPPYÔ: PAPIYÔ
AIPRSÂ: ASPIRÂ
AIPRTÂ: APRÂTI
AIPRTÛ: ATÛPRI
AIPSTÇ: PISTAÇ
AIPTZÂ: PATIZÂ
AIRSSÂ: ASIRÂS
AIRSTÂ: ATIRÂS
AIRTYÑ: TRIYAÑ
AIRYZÊ: ZARIYÊ
AISSTÂ: ASISTÂ
AISTVÜ: TÜAVIS
AISYYÊ: AYISYÊ
AJJLNO: JANJOL
AJJMNÊ: JÊJANM
AJJNNÊ: JÊNJAN
AJKNTÛ: JÛKTAN
AJLMNO: LOJMAN
AJLNOR: RALONJ
AJLNOZ: LOZANJ
AJLNÊÛ: LAJÛNÊ
AJLOTV: VOLTAJ
AJMNÂÇ: ÇÂJMAN
        ÇANJMÂ
AJMRÂÂ: ARÂJMÂ
AJNORZ: ZORANJ
AJNSTÛ: JÛSTAN
AJPVWÛ: JAPWÛV
AJRTÂÛ: ÂTÛRAJ
AKKMOÊ: KAMOKÊ
AKKNOT: KONTAK
AKKNOV: KONKAV
AKKORZ: KOKRAZ
AKLMSÂ: KLASMÂ
AKLNOS: KALSON
AKLNOV: VOLKAN
AKLNOÊ: KALONÊ
AKLNÊÔ: KALÔNÊ
AKLOOÇ: ÇOKOLA
AKLORT: KLORAT
AKLORÊ: KORALÊ
AKLOSV: VOKSAL
AKLOSW: KASWOL
AKLOWÊ: KAWOLÊ
AKLOÇÔ: LAKOÇÔ
AKLPRÂ: LAKRÂP
AKLPYÛ: KÛPLAY
AKLRSÊ: LARÊKS
AKLWZÔ: KLWAZÔ
AKMMNÊ: KANMÊM
AKMNNO: KOMANN
AKMNOY: KAMYON
        MANYOK
AKMNOZ: KOZMAN
AKMNWÊ: MWÊNKA
AKMNÊÔ: MAKÔNÊ
AKMOOS: MASOKO
AKMOST: MASTOK
AKMOVY: VAKYOM
AKMOWÊ: MAWOKÊ
AKMRÂÛ: KÛRAMÂ
AKMTVÛ: VÛMTAK
AKMWZÂ: KWAZMÂ
AKMÂÇÛ: AKÛÇMÂ
AKNNOS: KANSON
AKNNOT: KANNOT
        KANTON
        KONTAN
AKNOPY: KONPAY
AKNORT: KONTRA
AKNORÛ: OKÛRAN
AKNOST: KONSTA
AKNOSY: AKSYON
        KOSYAN
AKNOTW: KONTWA
AKNPRÔ: KRANPÔ
AKNPTÊ: KAPTÊN
AKNPYÔ: KÔPANY
AKNPÊÔ: KAPÔNÊ
AKNRTÔ: RANKÔT
AKNSTÔ: KÔSTAN
AKNTÊÛ: ÊKÛTAN
AKOYZÔ: OKAZYÔ
AKPYÔÔ: KÔPAYÔ
AKSSWÂ: KWASÂS
AKSWYÂ: KWAYÂS
AKSÂÇÛ: SÂKÛÇA
AKTÇÛÛ: KAÛTÇÛ
AKWYÂÊ: ÊKWAYÂ
ALLNPÊ: LAPLÊN
ALLPÂÇ: LAPLÂÇ
ALMMOÊ: MALOMÊ
ALMNOT: LATONM
ALMNTÂ: LANTMÂ
        LÂTMAN
ALMNWÛ: WÛLMAN
ALMORÂ: ORALMÂ
ALMOSÔ: SALOMÔ
ALMOTT: MATLOT
ALMPSÂ: PLASMÂ
ALMSWÊ: MALSWÊ
ALMSÂÇ: MALÇÂS
ALMSÊÛ: SÛLAMÊ
ALNNOT: LONTAN
ALNNOW: LAWONN
ALNNPÊ: PLANNÊ
ALNNTÎ: LANNÎT
ALNOPT: PLATON
ALNOPV: ANVLOP
ALNOPY: PANYOL
ALNOSV: SOLVAN
ALNOSÊ: ÊSOLAN
ALNOVY: VYOLAN
ALNPTÊ: PLANTÊ
ALNPZÛ: ZANPÛL
ALNTÊÔ: TALÔNÊ
ALOPST: POSTAL
ALOSSY: SOSYAL
ALPTVÂ: PLAVÂT
ALPTÂÔ: PÂTALÔ
ALRTÂÂ: ALÂTRÂ
ALSSYÂ: LASYÂS
ALSTÊÛ: LATÛSÊ
ALVYÂÛ: YÂVALÛ
AMMMNÊ: MÊMMAN
AMMNVÛ: MÛVMAN
AMMNÂÂ: AMÂNMÂ
AMNNOS: MASONN
AMNNOV: NOVANM
AMNNRÂ: RÂNMAN
        RANNMÂ
AMNNSÂ: SÂNANM
        SANNÂM
AMNNZÂ: ZÂMANN
        ZANMÂN
AMNOSW: MWASON
        WOMANS
AMNOSZ: ZOSMAN
AMNOTY: MONTAY
AMNOTÇ: ÇANMOT
AMNOYÇ: ÇONMAY
AMNPSÂ: PANSMÂ
        PÂSMAN
AMNSWÊ: ANMWÊS
AMNSÂÇ: ÇÂNMAS
AMNSÊÔ: MASÔNÊ
AMNWÂÇ: WAÇMÂN
AMORWÊ: WOMARÊ
AMOTVÂ: AVOTMÂ
AMRSÊÛ: SÛMARÊ
AMSTÇÛ: MÛSTAÇ
AMSVÂÂ: AVÂSMÂ
AMTWÂÇ: WATÇMÂ
AMZÛÛÜ: AZÛMÜÛ
ANNNTÎ: NANNÎT
ANNOPT: TANPON
ANNOPW: NAPWON
ANNORY: RANYON
ANNOSY: NASYON
ANNOSÇ: ÇANSON
ANNOTÊ: ANTONÊ
        TAONNÊ
ANNPWÊ: NANPWÊ
ANNPÂÂ: ANPÂNÂ
        ÂPÂNAN
        ÂPANNÂ
ANNSZÎ: NÎZANS
ANNYÂÎ: ÂNÎYAN
        ANNÎYÂ
ANNZÂÂ: ZÂNÂNA
ANNÇÊÊ: ANÇÊNÊ
ANOPSW: PWASON
ANOPSY: PASYON
ANOPTW: PATWON
ANOPTÊ: ÊPOTAN
ANOPWZ: PWAZON
ANOTWÂ: ÂTONWA
ANOWYY: WONYAY
ANOWYÇ: ÇAWONY
ANPPÂÊ: ANPÊPÂ
        ÂPÊPAN
ANPRTÂ: ANTRÂP
        ÂTRANP
ANPRTÊ: ANPRÊT
        PRÊTAN
ANPSYÔ: PANSYÔ
ANPTWÂ: PWATÂN
ANPTYÂ: TYANPÂ
        TYÂPAN
ANPTÂÇ: TÇANPÂ
        TÇÂPAN
ANPYÇÔ: ÇANPYÔ
ANRYÂÔ: ÂRANYÔ
ANSSTÂ: SANTÂS
        SÂTANS
ANSSWÂ: SWASÂN
ANSTWÔ: SANWÔT
ANSTYÔ: TANSYÔ
ANSVÂÂ: ÂNAVÂS
ANSVÊÔ: SAVÔNÊ
ANSYZÊ: ZANSYÊ
ANTTÊÔ: TATÔNÊ
ANTVZÛ: VANTÛZ
ANYÇÇÛ: ÇÛÇANY
AOPSVÂ: AVÂPOS
AOPTTÂ: POTÂTA
AOPTYÇ: POTÇAY
AOPVWÛ: OPÛVWA
AOTTWW: TWOTWA
APSSYÂ: PASYÂS
APSYÂÊ: ÊPASYÂ
APTTÛÛ: TÛPATÛ
APTWYÛ: PATWÛY
ARTYZÂ: ZÂTRAY
ARTYÂÛ: ÂTÛRAY
ASSTWÂ: SWASÂT
ASSYÂÔ: ASÂSYÔ
ASTYÂÔ: ATÂSYÔ
AVYZÊÔ: ÊVAZYÔ
BBEEIT: TIBEBE
BBEILÂ: BÂBILE
BBEINO: BOBINE
BBELOZ: BEZBOL
BBEMNO: BENMBO
BBENOR: BOBREN
BBEOÂÇ: BÂBOÇE
BBIIKL: BIBLIK
BBIIOÇ: IBOBIÇ
BBILOÂ: BÂBILO
BBINOW: BIBWON
BBINOÊ: BOBINÊ
BBIOOR: BOBORI
BBLLÊÊ: BLÊBLÊ
BBNNOO: BONBON
BBNOSÂ: BONBÂS
BBNOÇÛ: BONBÛÇ
BDEEEJ: JEBEDE
BDEEGO: DEGOBE
BDEEIT: DEBITE
BDEELN: BLENDE
BDEENY: DEBYEN
BDEEOÇ: DEBOÇE
BDEERÛ: DEBÛRE
BDEESÛ: DEBÛSE
BDEEYÛ: DEBÛYE
BDEEÇÛ: DEBÛÇE
BDEILR: DRIBLE
BDEIRÔ: REBÔDI
BDEITÂ: DEBITÂ
BDEJLÂ: DJÂBEL
BDELOZ: BLODEZ
BDENOY: BONDYE
BDGIIÛ: BIGÛDI
BDGLOÛ: BÛLDOG
BDIILO: LIBIDO
BDIILÑ: BILDIÑ
BDIORW: BWODRI
BDLNOÛ: DÛBLON
BDLOWÂ: BÂDWOL
BDNOOY: DONBOY
BDNOSÂ: BONDÂS
BDNÂÊÔ: BÂDÔNÊ
BDNÊÔÛ: BÛDÔNÊ
BEEEKK: BEKEKE
BEEELR: REBELE
BEEENT: ENBETE
BEEFLS: FEBLES
BEEGMÂ: ÂMBEGE
BEEILT: LIBETE
BEEINS: EBENIS
BEEIPT: PIBETE
BEEIRT: REBITE
BEEITZ: BETIZE
BEEKLÊ: KELÊBE
BEELRT: BRETEL
BEENNY: BENYEN
BEENPÇ: PENBEÇ
BEENRT: TENBRE
BEENWZ: BEZWEN
BEEOSV: OBSEVE
BEERVY: BREVYE
BEERYÂ: ÂBREYE
BEFGNO: FONGBE
BEFIKT: BIFTEK
BEFILT: FLEBIT
BEFIRZ: BRIZFE
BEFNÇÊ: BEFÇÊN
BEGILN: BILENG
BEGIOT: BIGOTE
BEGLOW: GWOBLE
BEGMNÂ: BEGMÂN
BEIIJL: JIBILE
BEIIKL: EKILIB
BEIJLO: OBLIJE
BEIKLR: KRIBLE
BEIKLÊ: KILÊBE
BEIKRÛ: BÛRIKE
BEIKST: BISKET
BEIKSÂ: ÂBISKE
BEILNT: BILTEN
BEILST: TIBLES
BEILSÊ: ÊBESIL
BEILWÛ: WÛLIBE
BEINST: BISENT
BEIRTÂ: REBITÂ
BEIRÇÊ: ÇERIBÊ
BEISYÂ: ÂBISYE
BEIYZÛ: BÛZIYE
BEJLÂÛ: BÛLÂJE
BEJTWÛ: BETWÛJ
BEKKOO: KOKOBE
BEKLNO: KONBLE
BEKLTÛ: BÛKLET
BEKNNO: KONBEN
BEKNOS: SENKOB
BEKNYÔ: KÔBYEN
BEKORY: BOKYER
BEKRÂÔ: ÂKÔBRE
BEKTÂÛ: BÛKÂTE
BELMNÂ: BLÂMEN
BELMNÊ: BLÊMEN
        BLENMÊ
BELMOP: POBLEM
BELMWÛ: WÛMBLE
BELMÂÛ: EBÛLMÂ
BELNOP: PLONBE
BELNOS: SENBOL
BELOOW: BOLEWO
BELOOZ: BOLOZE
BELPYÔ: PLÔBYE
BELRTÂ: TRÂBLE
BELSVÛ: BÛLVES
BELTWÛ: TWÛBLE
BEMNNO: MONBEN
BEMNOW: BEWONM
BENNOT: BONNET
        BONTEN
BENNRÂ: BRÂNEN
BENORT: BRETON
BENTYÊ: BYÊNET
BENTÊÔ: BETÔNÊ
BEOPVW: PWOVEB
BEOSTY: SOBTYE
BERSÂÛ: RÂBÛSE
BERZÊÑ: BRÊZEÑ
BEWYÂÛ: ÂBWÛYE
BFIMOW: FIBWOM
BFIOSW: WOSBIF
BFKLOÛ: FÛKBOL
BFLOOP: FLOBOP
BFLOTÛ: FÛTBOL
BFMÂÊÛ: MÂFÛBÊ
BGHRÂÂ: BRÂHÂG
BGILLO: GLOBIL
BGIOZÂ: BIZÂGO
BGNÊÔÛ: BÛGÔNÊ
BGRZÊÊ: BRÊZÊG
BIIIKN: BIKINI
BIIKLP: PIBLIK
BIIKRR: BRIKRI
BIIKRÇ: KRIBIÇ
BIILST: SIBTIL
BIINSZ: BIZNIS
BIISTW: BISWIT
BIIVZÊ: ÊVIZIB
BIKLOS: BLOKIS
BIKLPÛ: BÛLPIK
BIKLRÔ: LÔBRIK
BIKMOW: MIKWOB
BIKMTÛ: KÛMBIT
BIKNOT: KONBIT
BIKOST: BOKSIT
BIKOSÂ: BOKÂSI
BIKSTÎ: BISKÎT
BILNÂÛ: ÂBÛLIN
BILOWÛ: WÛLOBI
BILRTÔ: LÔBRIT
BILSÂÂ: ÂBILÂS
BIMNOT: TIBONM
BIMORÔ: MORIBÔ
BINORS: BRISON
BINRTÔ: NÔBRIT
BIOOST: OTOBIS
BIOPSÊ: ÊPOSIB
BIRYÂÔ: ÂBRIYÔ
BISSÂÊ: ÊSÂSIB
BISYÂÔ: ÂBISYÔ
BITWÇÔ: BWÔÇIT
BITYÔÛ: TÛBIYÔ
BJNNOÂ: BONNÂJ
BJNÊÔÛ: BÛJÔNÊ
BKLÛÛÛ: BÛKÛLÛ
BKMNÂÛ: BÛKMÂN
BKNOYÊ: KONBYÊ
BKNWÂÔ: KÂBWÔN
BKNÂÊÛ: BÛKÂNÊ
BKSÛÛÛ: BÛKÛSÛ
BLNOWÛ: WÛBLON
BLNOZÛ: BLÛZON
BLNÊÔÛ: BÛLÔNÊ
BMNNOÔ: BONNÔM
        BÔNONM
BMTYÛÛ: TYÛBÛM
BMTÇÛÛ: TÇÛBÛM
BMZÂÂÂ: BÂZÂMÂ
BNOOOÇ: BONOÇO
BNOSSÂ: BONSÂS
BNTÊÔÛ: BÛTÔNÊ
BOOWÂÇ: WOÇÂBO
BOSYZÊ: SÊBYOZ
BRSÇÊÛ: RÊSBÛÇ
BTYÔÛÛ: TÛBÛYÔ
DDEEET: DEDETE
DDEEIS: DESIDE
DDEEIV: DEVIDE
DDEEJJ: DJEDJE
DDEEKO: DEKODE
DDEEMO: DEMODE
DDEEOY: DEYEDO
DDEGIÛ: DEGÛDI
DDEGÊÛ: DEGÛDÊ
DDEIOY: ODEYID
DDEOZÂ: ÂDEZOD
DDIIRR: DRIDRI
DDIISÂ: DISIDÂ
DDIIZÔ: DIZÔDI
DDIKOS: DISKOD
DDINOÊ: DODINÊ
DDJJÂÂ: DJÂDJÂ
DDJJÔÔ: DJÔDJÔ
DDKKÛÛ: DÛKDÛK
DDRRÂÂ: DRÂDRÂ
DDSÊÊÊ: SÊDÊDÊ
DDYYÂÂ: DYÂDYÂ
DDYYÔÔ: DYÔDYÔ
DEEEGL: DELEGE
DEEEGY: YEGEDE
DEEEJN: DEJENE
DEEELM: DEMELE
DEEELS: DESELE
DEEELY: DELEYE
DEEENS: DESENE
DEEEPÇ: DEPEÇE
DEEERS: DESERE
DEEERT: DETERE
DEEESV: DEVESE
DEEETT: DETETE
DEEETZ: DEZETE
DEEFIL: DEFILE
DEEFIY: EDIFYE
DEEFKÔ: FEKÔDE
DEEFKÛ: DEFÛKE
DEEFLÛ: DEFÛLE
DEEFMO: DEFOME
DEEFNÜ: DEFÜEN
DEEFRÔ: EFÔDRE
DEEFSÔ: DEFÔSE
DEEFTY: FETDYE
DEEGIP: DEGEPI
DEEGIV: GEDEVI
DEEGIZ: DEGIZE
DEEGJO: DEGOJE
DEEGLÊ: GÊDELE
DEEGNN: DEGENN
DEEGOÇ: DEGOÇE
DEEGSÔ: SEGÔDE
DEEGSÛ: DEGÛSE
DEEGTÛ: DEGÛTE
DEEIJL: LEJEDI
DEEIJR: DIJERE
DEEIKN: ENDIKE
        KENEDI
DEEIKS: DISEKE
DEEIKT: DETIKE
DEEILR: DELIRE
DEEIMP: EPIDEM
DEEIMT: MEDITE
DEEINS: DESENI
        DESINE
DEEINV: DEVINE
DEEINY: ENDIYE
DEEINÇ: DENIÇE
DEEIPR: DEPERI
DEEIPT: DEPITE
DEEIPZ: DEZIPE
DEEIRT: DETIRE
DEEIRV: DERIVE
        DEVIRE
DEEIRZ: DEZIRE
DEEIRÇ: DEÇIRE
DEEISV: DESEVI
        DEVISE
DEEITY: ETIDYE
DEEJKÛ: DEJÛKE
DEEJLO: DELOJE
DEEJNN: DEJNEN
DEEJRÂ: DÂJERE
        DERÂJE
DEEJTÂ: DEJÂTE
        DETEJÂ
DEEKKO: DEKOKE
DEEKKW: KWEDEK
DEEKLN: DEKLEN
DEEKLO: DEKOLE
DEEKOR: DEKORE
DEEKPÂ: DEKÂPE
DEEKPÛ: DEKÛPE
DEEKÇÛ: DEÇÛKE
DEELMN: MENDEL
DEELNS: DELENS
DEELNW: DELWEN
DEELOZ: DEZOLE
DEELPÂ: LEPEDÂ
DEELTÛ: TÛLEDE
DEELWÛ: DEWÛLE
DEEMNN: DENMEN
DEEMNS: MEDSEN
DEEMNV: MENDEV
DEEMOR: MODERE
DEEMOW: EMEWOD
DEEMOZ: DEZOME
DEEMTÔ: DEMÔTE
DEEMYZ: DEZYEM
DEEMÂÇ: DEMÂÇE
DEENNP: DEPENN
DEENNT: DETENN
DEENNV: DEVENN
DEENNY: ENDYEN
DEENOZ: DEZONE
DEENRY: DERYEN
DEENST: DESTEN
DEENSÂ: ENDESÂ
DEENSÔ: DENÔSE
DEENSÜ: DESÜEN
DEENTÜ: DETÜEN
DEENYÂ: ÂDENYE
DEENZÔ: DEZÔNE
DEEOPT: DEPOTE
DEEOPZ: DEPOZE
DEEORV: DEVORE
DEEOSZ: DEZOSE
DEEOSÇ: DEÇOSE
DEEPSÂ: DEPÂSE
DEERST: DETRES
DEERTÂ: ÂTREDE
DEERTÛ: DERETÛ
DEERVÂ: REVÂDE
DEESVÂ: DESEVÂ
        DEVÂSE
DEETWÛ: DEWÛTE
DEFIIN: DEFINI
DEFIIS: DEFISI
        EDIFIS
DEFILÊ: ÊFIDEL
DEFIMÂ: DEFÂMI
DEFINS: DISNEF
DEFINÛ: DEFÛNI
DEFIRÂ: DIFERÂ
DEFJNO: JONDEF
DEFNÊÛ: DEFÛNÊ
DEFRÂÔ: ÂFÔDRE
DEGIJT: DJIGET
DEGILÔ: LIGÔDE
DEGIOÇ: DEGOÇI
DEGLOÔ: GÔDOLE
DEGMNO: DOMENG
DEGMÂÂ: ÂMEGDÂ
DEGNNO: DEGONN
DEGNNÂ: NÂDENG
DEGNNÔ: DENGÔN
DEGNOS: SEGOND
DEGNOW: GWONDE
DEGTÂÛ: DEGÛTÂ
DEGTÇÔ: DETÇÔG
DEIIJR: DIRIJE
DEIIKV: DIVIKE
DEIINV: DIVINE
DEIINZ: DEZINI
DEIITV: DIVETI
DEIITY: DIYITE
DEIIVZ: DIVIZE
DEIJNÂ: ENDIJÂ
DEIJSÊ: ÊDIJES
DEIKLS: DELIKS
DEIKMO: KOMEDI
DEIKMÔ: KÔMEDI
DEIKRÂ: ÂDIREK
DEILLÊ: LELÊDI
DEILMO: DEMOLI
        MELODI
DEILOS: SOLIDE
DEILVÛ: EDÛVIL
DEILZÂ: ILÂDEZ
DEIMNO: DOMINE
DEIMNS: MEDSIN
DEIMOZ: MEZIDO
DEIMSÂ: SEDIMÂ
DEIMTÂ: DEMÂTI
DEIMTÛ: DEMITÛ
DEIMYZ: DIZYEM
DEIMZÂ: MEDIZÂ
DEINNO: INONDE
DEINOZ: DEZINO
DEINRV: VEDRIN
DEINÂÇ: ÇIENDÂ
DEIOPV: PEDOVI
DEIOSV: DIVOSE
DEIOVY: VIDEYO
DEIRST: DISTRE
DEIRSÊ: DERISÊ
DEISTÂ: DÂSITE
        DISETÂ
DEISYÔ: EDISYÔ
DEITVÂ: DEVÂTI
DEITYÂ: ETIDYÂ
DEJORÔ: DOJERÔ
DEJRÂÂ: ÂJÂDRE
DEJVÂÛ: DEVÂJÛ
DEKLSÊ: LÊDEKS
DEKLÂÊ: DELÊKÂ
DEKMOY: MEDYOK
DEKMOÂ: KOMÂDE
DEKMÂÔ: KÔMÂDE
DEKNNO: KODENN
DEKOTZ: DOKTEZ
DEKRÂÛ: KÛRÂDE
DEKSÂÔ: KÔDÂSE
DELMNO: LEMOND
DELMNÂ: LÂDMEN
DELMPÂ: PLEDMÂ
DELMÂÊ: LÂDEMÊ
DELNOW: WONDEL
DELOOT: DOLOTE
DELOZÂ: OLÂDEZ
DEMMOY: MEDYOM
DEMNNO: MONDEN
DEMNÂÊ: NÂDEMÊ
DEMNÂÔ: ÂDENMÔ
DEMTÂÜ: DETÜMÂ
DEMVÂÛ: DEVÛMÂ
DEMYZÛ: DÛZYEM
DENNNO: DONNEN
DENNOT: ENDONT
DENOST: SENTOD
DENOSW: NODWES
DENOTZ: TONDEZ
DENOYÂ: DÂNOYE
DENPÂÊ: DEPÂNÊ
DENSÊÛ: DESÛNÊ
DENTÊÛ: DETÛNÊ
DENÇÊÊ: DEÇÊNÊ
DEOOTY: TEYODO
DEOPRY: PERYOD
DEOPST: DESPOT
DEOSYZ: DYOSEZ
DEOSYÂ: ODYÂSE
DEOTTÂ: ETÂDOT
DEOTÇÑ: DETÇOÑ
DEOYZÂ: ÂDYOZE
DERSTÂ: TÂDRES
DERVÂÛ: RÂDEVÛ
DESSÂÊ: ÊDESÂS
DESTÔÔ: ÔDÔSTE
DESTÔÜ: ÜDÔSTE
DETTÂÎ: ÎTEDTÂ
DFIKÂÔ: KÔFIDÂ
DFINOR: FONDRI
DFMÂÂÂ: FÂDÂMÂ
DGIILV: GILDIV
DGINOR: GODRIN
DGIOPW: PWODIG
DGNNOÊ: DÊGONN
DGNORÂ: GRÂDON
DGNOWÛ: GÛDWON
DGNOÊÔ: GODÔNÊ
DIIJKO: KIJODI
DIIJLÂ: DILIJÂ
DIIJOS: SIJODI
DIIJRÂ: DIRIJÂ
DIIKTÂ: IDÂTIK
DIILPS: DIPLIS
DIIMOS: SIMIDO
DIINOV: DIVINO
DIIPST: DISPIT
DIISSW: SWISID
DIJMÂÂ: DÂMIJÂ
DIJSÂÊ: ÊDIJÂS
DIKKNO: KIDONK
DIKMOÂ: DOKIMÂ
DIKOOR: KORIDO
DIKSYÔ: DIKSYÔ
DILMOP: DIPLOM
DILMPÔ: DÔPLIM
DILMÂÔ: LÂMIDÔ
DIMNOO: DOMINO
DIMNOÂ: DOMINÂ
        NÂDOMI
DIMNÊÔ: MIDÔNÊ
DINOOZ: DINOZO
DINSÂÛ: ÂSÛDIN
DIOOPP: DIPOPO
DIOOWZ: DIWOZO
DIOPSÇ: ÇODPIS
DIOTTÂ: ÂTIDOT
DIPRÂÊ: ÊPRIDÂ
DIPSSÂ: DISPÂS
DIRSÂÂ: ÂDIRÂS
DIRTTÂ: DÂTRIT
DIRTÂÂ: DIRÂTÂ
DIRYÊÔ: ÔDIRYÊ
DISSTÂ: DISTÂS
DISWÂÇ: SÂDWIÇ
DJKLOÂ: JÂKLOD
DJVÂÛÛ: DÛVÂJÛ
DKMOÂÂ: KOMÂDÂ
DKMÂÂÔ: KÔMÂDÂ
DKNNOO: KONDON
DKNOOW: KODWON
DKNOTÎ: KONDÎT
DKNÛÛÛ: DÛKÛNÛ
DKTÊÎÔ: ÊKÔDÎT
DMNOÂÊ: ÂDÊMON
DMOOPY: PODYOM
DMOWÔÔ: WÔDOMÔ
DMWÔÔÔ: WÔDÔMÔ
EEEGSZ: EGZESE
EEEJNR: JENERE
EEEJRT: REJETE
EEEJTV: VEJETE
EEEKLR: EKLERE
EEEKLT: ELEKTE
EEEKSZ: EKZESE
EEELLT: TELELE
EEELLW: WELELE
EEELNT: ETENEL
EEELRS: RESELE
EEELVÇ: LEVEÇE
EEENNT: ENTENE
EEENNV: ENNEVE
EEENRT: ENTERE
EEENSS: NESESE
EEEPRR: REPERE
EEEPRS: ESPERE
EEEPRT: REPETE
EEEPRÇ: REPEÇE
EEEPST: ESEPTE
EEEPSV: PEVESE
EEERVY: REVEYE
EEERVZ: REZEVE
EEFFJO: FEFOJE
EEFFNN: FENFEN
EEFGRY: GREFYE
EEFIMS: EMISFE
EEFIRZ: REFIZE
EEFKSÔ: KÔFESE
EEFKTÊ: ÊFEKTE
EEFLMN: FENMEL
EEFLNO: OFELEN
EEFMNO: ENFOME
EEFMNÂ: ÂFEMEN
EEFMTÂ: FEMÂTE
EEFNNN: FENNEN
EEFNST: FESTEN
EEFRYÂ: EFREYÂ
EEFRYÊ: ÊFERYE
EEGILZ: EGZILE
EEGIMZ: EGZIME
EEGIRS: GERISE
EEGMNR: MERENG
EEGNNY: GENYEN
EEGNPR: GRENPE
EEGNPZ: ZEPENG
EEGNRS: SERENG
EEGNRY: GRENYE
EEGOSZ: EGZOSE
EEGRRT: REGRET
EEGRSÂ: ÂGRESE
EEGRTZ: ZEGRET
EEGTZÂ: EGZÂTE
EEIJKN: EJENIK
        ENEJIK
EEIJNS: EJENIS
EEIKLS: EKLESI
EEIKLZ: EKZILE
EEIKRT: EKRITE
EEIKRY: EKIREY
EEIKST: EKSITE
EEIKSV: ESKIVE
EEIKTT: ETIKET
EEILRS: SELERI
EEILRT: ILETRE
        LITERE
EEILST: ESTILE
EEIMNV: VENIME
EEIMPR: PERIME
EEIMRS: REMESI
EEIMRT: MERITE
EEIMRZ: MEZIRE
        REMIZE
EEIMST: ESTIME
EEINTV: ENVITE
EEIPRT: REPITE
EEIPTV: PETEVI
EEIRRT: RETIRE
EEIRST: RESITE
EEIRTV: VERITE
EEIRTY: ERITYE
        ETRIYE
EEISTV: SEVITE
EEISVY: SIVEYE
EEITVV: VETIVE
EEJLMÂ: LEJEMÂ
        MELÂJE
EEJLSÊ: SÊLEJE
EEJMNN: MENENJ
EEJNNN: JENNEN
EEJNNS: JENNES
EEJNYÊ: ÊJENYE
EEJRTÂ: ETRÂJE
EEKKNN: KENKEN
EEKKTT: TEKTEK
EEKLNR: KLEREN
EEKLOS: ESKOLE
EEKLSÂ: ÂSEKLE
EEKNNZ: KENZEN
EEKNOV: ENVOKE
EEKNRT: KRETEN
        TRENKE
EEKNST: EKSTEN
EEKNSW: KWENSE
EEKNSY: YESKEN
EEKOPT: POTEKE
EEKORT: RETOKE
EEKORV: REVOKE
EEKOTZ: EKZOTE
EEKPRS: PRESKE
EEKPSÂ: ESKÂPE
EEKRSÂ: ÂSEKRE
EEKRSÛ: SEKÛRE
EEKRTV: KREVET
EEKSTÜ: ESTEKÜ
EEKSVÔ: KÔSEVE
EEKSYÔ: KÔSEYE
EEKTYÊ: ÊKYETE
EELLMP: PELMEL
EELLSY: LESYEL
EELNPR: PELREN
        REPLEN
EELNST: TENSEL
EELORT: TOLERE
EELOVY: EVOLYE
        VOLEYE
EELPRÂ: LÂPERE
EELPSS: LESPES
EELSTÊ: ETÊSEL
EEMNNN: MENNEN
EEMNNR: RENMEN
EEMNNÇ: ÇEMENN
EEMNOR: RENOME
EEMNOT: MENOTE
        MONETE
EEMNRT: RENMET
EEMNTW: TEMWEN
EEMNVY: NEVYEM
EEMNVÂ: EVENMÂ
EEMOTY: METEYO
EEMPRY: PREMYE
EEMRST: METRES
EEMRTÔ: REMÔTE
EEMRZÂ: EREZMÂ
EEMSTY: ESTYEM
        SETYEM
EEMSTÂ: SEMÂTE
EEMSYZ: SEZYEM
EEMSYÔ: MÔSEYE
EEMTYZ: MYEZET
EENNNN: NENENN
EENNNS: SENNEN
EENNPY: PENYEN
EENNPÇ: PENÇEN
EENNST: ENSTEN
EENNSY: SENYEN
EENNTT: TENTEN
EENNTV: VENTEN
EENNTY: TENYEN
EENNVV: VEVENN
EENNVÂ: ENNEVÂ
EENNYY: YENYEN
EENOPT: ENPOTE
EENOPW: PEWONE
EENOPZ: ENPOZE
EENORZ: REZONE
EENPRT: PRENTE
EENPST: PENSET
EENPSY: PESYEN
EENPTW: PWENTE
EENPÇÑ: PENÇEÑ
EENRST: SENTRE
EENRSV: SEVREN
EENRSÔ: RENÔSE
EENRTZ: ZETREN
EENRTÂ: ÂTRENE
EENRTÜ: RETÜEN
EENSTW: SWENTE
EENTTÊ: ÊTENET
EENTVÂ: ENVÂTE
EENTYZ: ETZYEN
EENTYÇ: ÇYENTE
EENYZZ: ZENYEZ
EEOPRZ: REPOZE
EEORSY: OSERYE
EEPPTT: PETPET
EEPRSS: ESPRES
EEPRSÛ: REPÛSE
EEPRTÂ: ÂPETRE
        TÂPERE
EEPSTÂ: ÂPESTE
        ESPÂTE
EEPTTÂ: TÂPETE
EEPTZÂ: PEZÂTE
EERRTT: RETRET
EERSSÇ: SEÇRES
EERSSÛ: RESÛSE
EERTVÂ: EVÂTRE
EERTVÇ: ÇEVRET
EERTÇÛ: RETÛÇE
EESTVY: SEVYET
EESVYY: VYEYES
EESYÂÇ: EÇEYÂS
EFFILO: FOFILE
EFGILÂ: FILÂGE
EFGLNO: GONFLE
EFGLTÊ: FLÊGET
EFIILN: LEFINI
EFIILS: LISIFE
EFIIYZ: FIZIYE
EFIKMÔ: KÔFIME
EFIKNO: KONIFE
EFIKOS: OFISKE
        SIFOKE
EFILMO: EMOFIL
EFILOY: FIYOLE
EFILST: SIFLET
EFIMNÊ: FEMINÊ
EFIMYÊ: ÊFIMYE
EFIMZÂ: ÂFIZEM
EFINSÂ: FINÂSE
EFINSÛ: FÛNISE
EFIOSY: OFISYE
EFISYÂ: FIYÂSE
EFITZÂ: FÂTEZI
EFKMOÔ: KÔFOME
EFKNOR: KONFRE
EFKNOY: KONFYE
EFKNÂÂ: ÂFÂNKE
EFKORS: FRESKO
EFKOTÔ: KÔFOTE
EFKRSÂ: FREKÂS
EFKSÂÔ: KÂSÔFE
EFLMOÊ: ÊFOMEL
EFLNNÂ: FLÂNEN
EFLNOW: WONFLE
EFLOSÂ: SELOFÂ
EFLSTÛ: SÛFLET
EFMTÂÛ: ETÛFMÂ
EFNNRÊ: FRÊNEN
        FRENNÊ
EFNNTÔ: FÔTENN
EFNNWÊ: FWÊNEN
        FWENNÊ
EFNNÂÛ: ÂFÛNEN
EFNOPW: FOPWEN
EFNOST: FOSTEN
EFNOSY: FONSYE
EFNOSÂ: ÂFONSE
EFNOTY: FONTYE
EFNTÂÂ: ÂFÂTEN
EFNTÛÜ: TÛFÜEN
EFOPTW: PWOFET
EFORST: FOTRES
EFORTÇ: ÇOFRET
EFRSZÂ: FRÂSEZ
EFTWYÔ: FWÔTYE
EGGLOÊ: GÊGOLE
EGGNNÊ: GÊGENN
        GENGÊN
EGIJKÔ: KÔJIGE
EGIJOT: JIGOTE
EGIJZÂ: EGZIJÂ
EGILLZ: LEGLIZ
EGILMR: GRIMEL
EGIMNR: MIGREN
EGINOY: EGOYIN
EGINRT: ENTRIG
EGINRY: GRIYEN
EGINSÂ: SÂGINE
EGIOPT: POTIGE
EGIOSY: EGOYIS
EGIRST: TIGRES
EGIRSV: GREVIS
EGIRZÔ: GERIZÔ
EGJLNO: JONGLE
EGKNOR: KONGRE
EGKRTÂ: REKTÂG
EGKSTÂ: GÂKSTE
EGLNOZ: ZONGLE
EGLNSÎ: LENGÎS
EGLNZÊ: ZÊGLEN
        ZENGLÊ
EGLRTÂ: TRÂGLE
EGMNNO: GONMEN
EGMNOÂ: MÂGONE
EGMRTÂ: GRÂMET
EGNNOS: SEGONN
EGNNRÊ: GRÊNEN
        GRENNÊ
EGNNYÔ: GYÔNEN
EGNOOR: GONORE
EGNPWÊ: PÊGWEN
        PENGWÊ
EGNPÇÊ: PÊÇENG
        PENÇÊG
EGNRYÛ: GRENÛY
EGNSWÂ: SÂGWEN
EGOPRW: PWOGRE
EGOSSW: GWOSES
EGOSWY: GWOSYE
EIIJPT: JIPITE
EIIKLR: LEKIRI
EIIKLS: SIKILE
EIIKRT: EKRITI
EIILMT: MILITE
EIILMY: IMILYE
EIILNV: LINIVE
EIILTT: TITILE
EIINRY: REYINI
EIINSY: INISYE
EIIRST: ITERIS
        SITIRE
EIIRSY: REYISI
EIIRYZ: IZIRYE
EIITVZ: VIZITE
EIJKLO: JOLIKE
EIJKLÂ: ÂJELIK
EIJKOR: KORIJE
EIJLMP: PLIMJE
EIJLNY: LIJYEN
EIJLSÂ: ÂJELIS
EIJLTÂ: ÂTIJEL
EIJLVÂ: EVÂJIL
EIJMRÂ: REJIMÂ
EIJNNY: IJYENN
EIJNST: JISTEN
EIJNTW: JWENTI
EIJNTÂ: ÂTIJEN
EIJOPW: PEWOJI
EIJSSÛ: SEJÛSI
EIJSWZ: JWISEZ
EIKKNT: TEKNIK
EIKKRT: KRIKET
EIKKRÔ: KÔKERI
EIKKSZ: EKSKIZ
EIKLPS: EKLIPS
        KLIPSE
        PLISKE
EIKLPÂ: PELIKÂ
EIKLRY: KRIYEL
EIKLTÇ: ÇIKLET
EIKMOS: KOMISE
EIKMOT: KOMITE
EIKMPÂ: EKIPMÂ
EIKMRÊ: MERIKÊ
EIKMTÔ: KÔMITE
EIKNNO: ENKONI
EIKNNW: WIKENN
EIKNRS: ENSKRI
EIKNRY: KRINYE
EIKOPT: IPOTEK
EIKORT: EKRITO
EIKOSV: SIVOKE
EIKOWY: EWOYIK
EIKPSS: SISPEK
EIKPST: PISKET
EIKPSW: PWISKE
EIKRSÛ: SEKÛRI
EIKRVÊ: EKRIVÊ
EIKRYZ: KIRYEZ
EIKRYÂ: ÂKRIYE
EIKSTÂ: EKSITÂ
EIKTTÂ: KÂTITE
EIKTVÔ: KÔVETI
EIKTVÛ: KÛVETI
EILLPT: PLETIL
EILMMY: MILYEM
EILMNN: LENNMI
EILMNP: PLIMEN
EILMOW: LIMEWO
EILMPY: MILPYE
EILMRÂ: MERILÂ
EILMZÂ: LÂMIZE
EILNNS: SILENN
EILNSV: SILVEN
        VILSEN
EILNYÇ: ÇILYEN
EILOPP: POPILE
EILOSZ: IZOSEL
EILPRS: LESPRI
EILPRT: REPTIL
        TRIPLE
EILPWY: PYELWI
EILPYZ: PLIZYE
EILRST: LISTRE
EILRSÔ: LERISÔ
EILSTÊ: ÊSILTE
EILTVÛ: LÛVETI
EIMNNO: NEMONI
EIMNOT: MINOTE
        MONITE
EIMNOW: NIMEWO
EIMNRT: TRIMEN
EIMNRÂ: ÂRIMEN
EIMNST: METSIN
EIMNTÇ: TÇIMEN
EIMOTV: MOTIVE
EIMPRZ: MEPRIZ
EIMPRÊ: ÊPRIME
EIMRST: TRIMES
EIMSST: SISTEM
EIMSTÂ: SIMÂTE
EIMSYZ: SIZYEM
EIMSYÔ: MÔSIYE
EIMTYÂ: ÂMIYET
EINNPT: NEPTIN
EINNRT: TRENIN
EINOWY: EWOYIN
EINPRV: PREVNI
EINPTW: PWENTI
EINPYÂ: ÂNIPYE
EINRSY: SIRYEN
EINSTW: ENSTWI
EINTVÊ: ÊTEVNI
EIOPST: SIPOTE
EIOPSZ: SIPOZE
EIOPTZ: IPOTEZ
EIOPTÇ: ÇIPOTE
EIPPYÂ: PEPIYÂ
EIPRTÂ: REPÂTI
EIPRTÊ: PÊTIRE
EIPRYÂ: REPIYÂ
EIPYZÂ: PEYIZÂ
EIRTYZ: TRIYEZ
EIRVYÛ: ÛVRIYE
EIRYZÊ: REZIYÊ
EISSTÊ: ÊSISTE
EISTVÂ: ÂVITES
EISTVÊ: ÊVESTI
EISVYÂ: SIVEYÂ
EJJLNO: JENJOL
EJJMNÂ: JENJÂM
EJJNNÂ: JENNJÂ
EJLMÂÜ: JÜELMÂ
EJLNOP: PLONJE
EJMNNO: JENNOM
EJNORY: REJYON
EJNOSY: JESYON
EJNYÊÊ: ÊJÊNYE
EJOPTW: PWOTEJ
EJRSÂÊ: ÊJERÂS
EKKKLÔ: KELKÔK
EKKLOT: KOKTEL
EKKNNO: KOKENN
EKKNOR: KONKRE
EKKNOT: KONKET
EKKOOY: KOKOYE
EKKOST: KOTEKS
EKKOVÔ: KÔVOKE
EKKRÂÔ: KÔKERÂ
EKKSVÔ: KÔVEKS
EKKSYÔ: KEKSYÔ
EKKSÂÔ: KÔSEKÂ
EKLMOR: KREMOL
EKLMÂÛ: EKÛLMÂ
EKLNOP: KONPLE
EKLNOT: LEKONT
EKLNOW: KLEWON
EKLOOP: KOPELO
EKLORT: REKOLT
EKLORY: KREYOL
EKLOSÔ: KÔSOLE
EKLWÛÛ: WÛKÛLE
EKMMNÂ: KÂMENM
EKMNOO: EKONOM
EKMNOS: KONMES
EKMNTÛ: KÛTMEN
EKMORT: REKTOM
EKMOSÂ: KOMÂSE
        KOMESÂ
EKMOTÂ: KOMÂTE
EKMPTÔ: PÔMKET
EKMPÔÔ: MÔKÔPE
EKMSTÂ: SEKTÂM
EKMSYÊ: SÊKYEM
EKMSÂÔ: KÔMÂSE
        KÔMESÂ
EKMSÂÛ: KÛMÂSE
EKMTÂÔ: MEKÔTÂ
EKMYZÊ: KÊZYEM
EKNNNO: KONNEN
EKNNOY: KONYEN
EKNOPS: KONSEP
EKNORS: KRESON
EKNORT: KONTRE
        KRETON
EKNORY: KREYON
EKNOSY: KESYON
        KONSEY
EKNPSÊ: KEPÊNS
EKNTÂÛ: ENKÛTÂ
EKOPTÔ: KÔPOTE
EKOPYZ: KOPYEZ
EKOPZÔ: KÔPOZE
EKORTÔ: OKÔTRE
EKORYÊ: KOREYÊ
EKOSTW: ESTWOK
EKOSTÛ: SÛKOTE
EKOSWZ: ZEWOKS
EKOTTW: TWOKET
EKOTWÇ: KWOÇET
        KWOÇTE
EKPRSÔ: KÔPRES
EKRTYÊ: KRETYÊ
EKSSYÔ: SEKSYÔ
EKTÇÛÜ: ÇÛKÜET
ELMMZÂ: MÂMZEL
ELMNNO: LEMONN
        LONMEN
ELMOOZ: MOZOLE
ELMTÂÂ: LÂTEMÂ
ELNNNO: LONNEN
ELNNOT: TONNEL
ELNNPÂ: PLÂNEN
ELNOOP: POLONE
ELNOSÂ: ENSOLÂ
ELNOYZ: LYEZON
ELNPTÂ: PLÂTEN
ELNTYÂ: LYETNÂ
ELOOVW: OVEWOL
ELORST: SOTREL
ELOSTY: LOSTYE
ELOTVY: VYOLET
ELOTVÔ: VOLÔTE
ELPRÂÇ: ÇÂPREL
ELPSWÂ: SÂPWEL
ELPTÂÇ: PLÂÇET
ELPWÂÇ: ÇÂPWEL
ELRTTÛ: TÛTREL
ELSÂÇÛ: SÛLEÇÂ
EMMMNÂ: MENMMÂ
EMMNNÛ: NÛMENM
EMNNNO: MONNEN
        NONMEN
EMNNSÊ: SÊMENN
        SENMÊN
EMNORT: MONTRE
EMNOSW: OMWENS
EMNOSY: SONMEY
EMNOYZ: ONZYEM
EMNRÊÔ: RENÔMÊ
EMNSWÂ: ÂMWENS
EMNTYÔ: TYEMÔN
EMOPSW: PWOMES
EMOPTW: PWOMET
EMORTÂ: OTREMÂ
EMORZÂ: ÂMOREZ
EMOSYÔ: EMOSYÔ
EMPSTÂ: SEPTÂM
EMPSWÔ: PWÔMES
EMPTWÔ: PWÔMET
EMPÂÂÇ: ÂPEÇMÂ
EMRTTÂ: TRETMÂ
EMRZÂÛ: ÂMÛREZ
EMSSÂÊ: SÊSEMÂ
EMSTYÂ: SÂTYEM
EMSYÂÂ: ÂSEYMÂ
EMTTÂÛ: TÛMÂTE
EMTVYÊ: VÊTYEM
EMTVÂÛ: ÛVETMÂ
ENNNOS: SONNEN
ENNOPR: PRENON
        REPONN
ENNOPS: PESONN
ENNOPT: NENPOT
ENNOPY: PONYEN
ENNOST: SONNET
ENNOTW: NETWON
ENNOTÂ: ÂTONEN
ENNOWY: WONYEN
ENNPWÂ: NÂPWEN
ENNPYÔ: PYÔNEN
ENNRTÊ: TRÊNEN
        TRENNÊ
ENNÂÇÊ: ÂÇÊNEN
        ÂÇENNÊ
ENOORZ: OREZON
ENOPPY: PONPYE
ENOPRS: REPONS
ENOPSY: ESPYON
ENOPTW: TWONPE
ENOPTY: PETYON
        PONYET
        PYETON
ENOPTÂ: ENPOTÂ
ENOPWÇ: PWOÇEN
ENORTY: RENTYO
ENORVY: VORYEN
ENPPPÊ: PENPÊP
        PÊPENP
ENPPÂÂ: ÂPENPÂ
ENPRRÂ: REPRÂN
ENPRTÂ: ÂPRENT
        PRENTÂ
        PRETÂN
ENPSWÔ: PWENSÔ
ENPWWÔ: WÔPWEN
ENRSVÛ: SÛVREN
ENRTTÂ: TRÂTEN
ENRTZÊ: ZETRÊN
ENRTÂÛ: ÂTRENÛ
ENRTÊÛ: RETÛNÊ
ENSTYÛ: SÛTYEN
ENSYZÂ: ZÂSYEN
ENSZÊÔ: SEZÔNÊ
EOPPTW: PWOPTE
EOPRWÇ: REPWOÇ
EOPSTY: SOPTYE
EOTTYÂ: ÂTOTYE
EOWYZÔ: EWOZYÔ
EPRSSÊ: PRÊSES
EPRSYÔ: PRESYÔ
EPRSZÂ: PREZÂS
EPRVYÊ: PREVYÊ
EPTTWÔ: TWÔPET
EPTYÇÛ: TÇYÛPE
EPZÂÇÊ: ÇÊPÂZE
ERSSTÛ: SÛSTRE
ERSTVÂ: VÂTRES
ERSTÊÛ: SÛTERÊ
ERTTÂÂ: ÂTRETÂ
ESTTÊÊ: ÊTESTÊ
FFOOTT: TOFTOF
FFOOYY: FYOFYO
FGIINR: GRIFIN
FGINOR: GRIFON
FGINRÔ: GRIFÔN
FGNOSÛ: FONGÛS
FGNÊÔÛ: FÛGÔNÊ
FIIKTÔ: KÔFITI
FIIMNO: INIFOM
FIIMRÊ: ÊFIMRI
FIINTÛ: FÛNITI
FIKLNO: KONFLI
FIKMÊÔ: KÔFIMÊ
FIKOSÂ: OFISKÂ
FIKRSÂ: FRÂSIK
FILOPW: PWOFIL
FILORV: FRIVOL
FIMNOW: FWONMI
FINORS: FRISON
FINOST: FONTIS
FINOSY: FISYON
FINTÂÂ: ÂFÂTIN
FINÇÊÔ: ÇIFÔNÊ
FIRTÂÊ: ÊFÂTRI
FKLOYÔ: KÔFYOL
FKMNOO: KONFOM
FKNNOÔ: KÔFONN
        KONFÔN
FKNOYÂ: KONFYÂ
FKOSÇÛ: FOSKÛÇ
FKSYÂÔ: KÔFYÂS
FKSYÔÔ: FÔKSYÔ
FMOTWÂ: FWOTMÂ
FMRÂÂÇ: FRÂÇMÂ
FNNOTÊ: FONTÊN
FNOOPW: PWOFON
FNSÂÂÂ: ÂNÂFÂS
FNTÊÛÛ: TÛFÛNÊ
FRSSÂÛ: SÛFRÂS
GGIIRR: GRIGRI
GGLOOÔ: GÔGOLO
GGNRÂÊ: GÂGRÊN
GGPÔÔÔ: PÔGÔGÔ
GHINTÛ: TÛHING
GIIKNV: VIKING
GIIMNT: MITING
GIIMRÂ: IMIGRÂ
GIKKOÔ: KIKÔGO
GIKLOZ: GLIKOZ
GIKLÂÂ: ÂGLIKÂ
GILMSÂ: GLISMÂ
GILNOV: LONGVI
GILTÂÛ: ÂGLÛTI
GINNOS: SINNGO
GINORZ: GRIZON
GINOTÂ: ÂTIGON
GINYÊÔ: GIYÔNÊ
GIORST: GOSTRI
GIOSSW: GWOSIS
GIOSTÊ: OGISTÊ
GIOSWÂ: ÂGWOSI
GIRTYÂ: TRIYÂG
GKLMOO: GLOKOM
GKLOOÔ: KÔGOLO
GKNTÔÛ: KÔNGÛT
GKTTÔÛ: KÔTGÛT
GKWÂÛÛ: KÂGÛWÛ
GLNOTÛ: GLÛTON
GLNOWÛ: WÛLONG
GMMÂÊÔ: MÂGÔMÊ
GMMÊÔÔ: MÔGÔMÊ
GMNRÂÛ: GRÂMÛN
GMPWÂÛ: GWÛPMÂ
GMYÂÂÛ: MÂGÛYÂ
GNNOYÊ: GYONNÊ
GNOTYÂ: TYOGÂN
GOTVWÂ: GWOVÂT
IIIJJR: JIJIRI
IIIJLT: LITIJI
IIIJRÇ: ÇIRIJI
IIILNT: INITIL
IIIMPT: PITIMI
IIIPTT: TIPITI
IIJLVÂ: VIJILÂ
IIJNOR: ORIJIN
IIJSST: JISTIS
IIKKLM: KILMIK
IIKKLN: KLINIK
IIKKNP: PIKNIK
IIKKOZ: ZOKIKI
IIKKRT: KRITIK
IIKKTT: KITKIT
IIKLPZ: PIKLIZ
IIKLSS: SIKLIS
IIKLTZ: ZILTIK
IIKMST: MISTIK
IIKMTV: VIKTIM
IIKNOW: IWONIK
IIKNWZ: KWIZIN
IIKOPT: ITOPIK
IIKRWZ: RIZWIK
IIKSSÔ: SIKÔSI
IILLTT: LITLIT
IILMNÊ: LIMINÊ
IILMRV: MIRVIL
IILMTÔ: MILITÔ
IILMYÂ: IMILYÂ
IILNSÊ: ÊSILIN
IILOPT: IPOLIT
IILPSS: SIPLIS
IILPST: PISTIL
IILPWÛ: PIWÛLI
IILYZÔ: ILIZYÔ
IIMNRÂ: RIMINÂ
IINRTV: VITRIN
IINRTÛ: NÛRITI
IIPPRR: PRIPRI
IIPPÇÇ: PIÇPIÇ
IIPRSS: SIPRIS
IIPRSZ: SIPRIZ
IIPRTÛ: PÛRITI
IIPTZÛ: TÛPIZI
IJMTÂÂ: JÂTIMÂ
IJSSWÂ: JWISÂS
IKKKNO: KIKONK
IKKLOÇ: KOKLIÇ
IKKNOW: KWONIK
IKKOOT: KOKOTI
IKKOSS: KOKSIS
IKKRÂÔ: KÔKIRÂ
IKKSÎÛ: KÛSIKÎ
IKLMOS: MOLISK
IKLNOO: KOLONI
IKLNOS: SIKLON
IKLOVÂ: VILOKÂ
IKLOZÂ: ÂKILOZ
IKLRTÂ: TRÂKIL
IKMNOO: KIMONO
IKMNOS: KONMSI
IKMOST: KOSTIM
IKMSTÛ: MÛSTIK
IKNOPY: PIKYON
IKNOSY: KONSIY
IKNOVÂ: KÂNIVO
IKNRÂÊ: RIKÂNÊ
IKNTÂÔ: KÔTINÂ
IKOPTW: TWOPIK
IKOPWÔ: KOWÔPI
IKOSST: SIKSTO
IKOTTÂ: OTÂTIK
IKOTÂÇ: ÂTIÇOK
IKSTWÔ: KÔSTWI
IKSTÂÔ: KÔSÂTI
ILMORÂ: LÂMORI
ILMOZÂ: IZOLMÂ
ILMTÂÂ: LÂMITÂ
ILMTÊÛ: TÛLIMÊ
ILMVÂÊ: ÂVLIMÊ
ILNNOV: LONNVI
ILNOPP: POPLIN
ILNOPT: PLITON
ILNPÊÔ: PILÔNÊ
ILNTWÂ: LÂNWIT
ILOOWW: WOWOLI
ILSYÊÛ: SÛLIYÊ
IMMNOÂ: MONIMÂ
IMNOOV: OMNIVO
IMNOSY: MISYON
IMNOTÂ: ÂTONIM
IMNOZÂ: ZÂNIMO
IMNYÊÔ: MIYÔNÊ
IMOORS: MORISO
IMOPST: POSTIM
INNOOS: OSINON
INNOVW: VIWONN
INNTWÂ: NÂNWIT
INOPPS: PONPIS
INOPRZ: PRIZON
INOPST: PISTON
INOPSW: PISWON
INOPYÔ: OPINYÔ
INORYÂ: INYORÂ
INOSSÂ: INOSÂS
INOSTW: SITWON
INOSTÂ: INOSÂT
INOVWÂ: ÂVIWON
INOVWÊ: VIWONÊ
INOVYZ: VIZYON
INPRSÂ: SIPRÂN
INPSSÂ: SISPÂN
INRSÂÛ: NÛRISÂ
INSTVÔ: TÔNVIS
INSTVÛ: TÛNVIS
INTTÛÛ: TÛTÛNI
INVWÊÔ: VIWÔNÊ
IOOPST: OTOPSI
IOOSSW: SOWOSI
IOPPRÛ: POPÛRI
IOPRTT: TRIPOT
IOPSTW: TWOPIS
IOPSTÂ: SIPOTÂ
IOPSZÔ: SIPOZÔ
IORSYÂ: IYORÂS
IOSSSÔ: SOSISÔ
IPPRSÊ: PRÊSIP
IPRTWÔ: TWÔPRI
IPSSWÂ: PWISÂS
IPYÂÇÔ: ÇÂPIYÔ
ISSSÂÛ: SÂSÛSI
ISSTYÂ: SYÂTIS
ISTTWÛ: TÛSWIT
ISTWÊÔ: SÊTIWÔ
IVWZÂÔ: ZÂVIWÔ
JJLNOO: JONJOL
KKLOOO: KOKOLO
KKMNOÔ: KÔKONM
        KONKÔM
KKMOOW: KWOKMO
KKNÂÂÊ: KÂKÂNÊ
KKOOOT: KOKOTO
KKOOTT: TOKTOK
KKOOWW: KWOKWO
KKÇÇÛÛ: KÛÇKÛÇ
KLNNOO: KOLONN
KLNOOP: KONPLO
KLOTWÔ: KÔTWOL
KMMOÂÂ: KOMÂMÂ
KMMÂÂÛ: KÛMÂMÂ
KMMÔÔÔ: MÔKÔMÔ
KMNNOÔ: MONNÔK
        MÔNONK
KMSÊÔÔ: KÔSÔMÊ
KNNÂÂÂ: KÂNÂNÂ
KNOOPP: POPKON
KNOOPS: KONPOS
KNOPRÂ: KRÂPON
KNOPTÂ: PÂNKOT
KNOPTÛ: PÛKONT
KNOPYÛ: KÛPYON
KNORTÂ: RÂKONT
KNOSTÂ: KONSTÂ
KNPRÂÔ: KÔPRÂN
KOPZÂÔ: KÔPOZÂ
KPWYÔÛ: KWÛPYÔ
KSYÂÊÔ: ÊKÔSYÂ
LLMOOO: MOLOLO
LLOOOY: OLOLOY
LLTÛÛÛ: TÛLÛLÛ
LMNYÂÂ: LÂMYÂN
LNOOSY: LOSYON
LNOOVY: VYOLON
LOOTZÂ: ZOTOLÂ
LOSSÂÊ: ÊSOLÂS
LOSVYÂ: VYOLÂS
MMSÂÂÂ: SÂMÂMÂ
MMTTÔÔ: TÔMTÔM
MMÂÂÇÇ: ÇÂMÇÂM
MNOOOT: OTONOM
MNOOPY: MOPYON
MNOPPÔ: PONPÔM
        PÔPONM
MNPWÊÔ: PWÔMNÊ
MOPTÂÂ: ÂPOTMÂ
MRTÂÂÊ: ÂTRÊMÂ
NNNOOW: WONNON
NNOOPP: PONPON
NNOOPW: PWONON
NNOOTT: TONTON
NNOOVV: VONVON
NNOOYZ: ZONYON
NNOOZZ: ZONZON
NNOPYÊ: PYONNÊ
NNVVÛÛ: VÛNVÛN
NNWYÂÛ: NYÛWÂN
NOOPRÂ: RÂPONO
NOOPSY: OPSYON
        POSYON
NOOPTW: PWOTON
NOPRÂÂ: RÂPÂNO
NOPSWÊ: PWÊSON
NOPSYÂ: PÂSYON
NOPWWÊ: WONPWÊ
NOPYÂÇ: ÇÂPYON
NOSTYÂ: TÂSYON
NOTÇÊÔ: TOÇÔNÊ
NPPÊÊÊ: PÊPÊNÊ
NPTÂÊÔ: TÂPÔNÊ
NRTÂÂÂ: ÂNÂTRÂ
NSSVÂÛ: SÛVNÂS
NTÂÇÊÔ: ÇÂTÔNÊ
OOOYYY: OYOYOY
OOTTWW: TOWTOW
OOTTWÛ: OTOWÛT
OOTTYY: TYOTYO
OOWWYY: WOYWOY
OPSTÂÊ: ÊPOTÂS
OPSVWÊ: PWOVÊS
OTTTÂÛ: TÛTOTÂ
OTTTÛÛ: TÛTOTÛ
PTTÂÇÊ: ÂÇTPÊT
STYÂÊÔ: ÊTÂSYÔ
SVYÂÊÔ: ÊVÂSYÔ
TTZÂÂÂ: TÂZÂTÂ
TTÇÇÊÊ: TÇÊTÇÊ
VVYYÊÊ: VYÊVYÊ
