AAABBMR: BAMBARA
AAABBNR: ANBABRA
AAABDNS: ANBASAD
AAABDPT: ADAPTAB
AAABGLN: BANGALA
AAABGLR: LAGRABA
AAABJLN: ANBALAJ
AAABJNZ: ANBAZAJ
AAABKLN: BAKANAL
AAABKLR: ALBARAK
AAABLMY: ALAMYAB
AAABLNN: ANBALAN
AAABLNÇ: ANBAÇAL
AAABLTW: LABATWA
AAABMNY: MAYANBA
AAABMRR: ABRARAM
AAABNRV: AVANBRA
AAABRYÇ: ÇARABYA
AAADGNV: AVANGAD
AAADJKL: KALADJA
AAADJKT: DJAKATA
AAADJNN: AJANNDA
AAADKMR: KAMARAD
AAAFKLT: KATAFAL
AAAGLMM: AMALGAM
AAAGLMN: MALANGA
AAAGLMW: LAMAGWA
AAAGMNN: AGANMAN
AAAGMNZ: MAZANGA
AAAGNRV: AGRAVAN
AAAGNWY: YAGWANA
AAAGRWZ: ZARAGWA
AAAINTZ: ATIZANA
AAAJKKN: JANKAKA
AAAJNTV: AVANTAJ
AAAKKTÇ: KAKAÇAT
AAAKLMN: ALMANAK
AAAKLNV: KANAVAL
AAAKLPT: KAPLATA
AAAKNST: KANTASA
AAAKPPZ: PAPZAKA
AAAKPRS: KARAPAS
AAAKPRT: KARAPAT
AAAKRTT: KATARAT
AAAKRTY: AKARYAT
AAALLPS: ALAPLAS
AAALLSV: LAVALAS
AAALMRY: MALARYA
AAALNTT: TALATAN
AAALNTÇ: ÇALATAN
AAALPPW: PAPALWA
AAALTTÔ: ALATATÔ
AAAMNPT: APATMAN
AAAMNTÇ: ATAÇMAN
AAANNNP: ANPANNA
AAANNNV: ANNAVAN
AAANNPS: ANPASAN
AAANNPT: ANPATAN
AAANPRS: APARANS
AAANPRT: ATRAPAN
AAANPRV: PARAVAN
AAANPTY: APANTAY
AABBDOY: BABYADO
AABBKNÛ: BABANKÛ
AABBLNS: SANBLAB
AABBLNÛ: BANBÛLA
AABBNOS: ABSOBAN
AABDEGR: DEGRABA
AABDESÂ: ÂBASADE
AABDIKR: BARIKAD
AABDIMR: ADMIRAB
AABDINN: BADINAN
AABDLMÂ: DÂMBALA
AABDNNO: ABONDAN
AABDNOP: PADONAB
AABDNSÔ: ABÔDANS
AABDORY: RABODAY
AABDRSÂ: ÂBRASAD
AABEFLT: ALFABET
AABEGRY: AGREYAB
AABEKNP: ENKAPAB
AABELMY: MALEYAB
AABELNP: LABAPEN
AABELNS: ASANBLE
         BALANSE
         SALANBE
AABELNY: LABANYE
AABELWY: WAYABEL
AABEMÇÔ: ABÔMAÇE
AABENNT: ANBETAN
AABENRS: ANBRASE
AABENST: ABSANTE
AABEPST: ASEPTAB
AABERSÂ: ÂBARASE
AABERVW: ABREVWA
AABETTY: TABATYE
AABGJOT: GABOTAJ
AABGNOV: VAGABON
AABIJRT: ABITRAJ
AABIJST: AJISTAB
AABIKKS: KABASIK
AABIKLN: ALANBIK
AABIKLP: APLIKAB
AABIKNR: KABRINA
         KARABIN
AABIKRY: KARAYIB
AABILLS: LASILAB
AABILRÇ: ÇALBARI
AABILYZ: BALIZAY
AABIMMN: MANIMBA
AABIMNT: BATIMAN
AABIRSY: RAYISAB
AABIRTÇ: ÇARITAB
AABJKOT: KABOTAJ
AABJLNN: JANBLAN
AABJLRÛ: LABÛRAJ
AABJLSÂ: ASÂBLAJ
AABKLNR: KANBRAL
AABKLSÛ: KALABÛS
AABKLWÛ: KABÛLAW
AABKLYÛ: KABÛLAY
AABKMNÂ: ÂBAKMAN
         ANBAKMÂ
AABKNOO: KAONABO
AABKNOV: VAKABON
AABKNOW: AKWABON
AABKNRÂ: KARABÂN
AABKOTW: AKWOBAT
AABKWYÊ: ÊKWAYAB
AABKYYÛ: KABÛYAY
AABLLNÊ: LABALÊN
AABLNNS: SANBLAN
AABLOPR: PARABOL
AABLOSW: ALABWOS
AABLSWÂ: BALÂSWA
AABMMYÂ: MAYÂMBA
AABMNNO: ABONMAN
AABMNNR: MANBRAN
AABNNNN: BANNANN
AABNNSY: ANBYANS
AABNOPT: BONAPAT
AABNOYÇ: ANBOÇAY
AABNTVÂ: ÂBAVANT
         ANBAVÂT
AABNWYÔ: BAYAWÔN
AABRSÂÂ: ÂBARASÂ
AADDEJN: ADJEDAN
AADDENN: ANDEDAN
AADDIJN: ADJIDAN
AADDIKN: KANDIDA
AADEGJN: DEGAJAN
AADEGNN: ANNEGAD
AADEGNR: REGADAN
AADEGNY: GADENYA
AADEIKM: AKADEMI
AADEJKK: KADEJAK
AADEJKL: DEKALAJ
AADEJNN: ANDANJE
AADEJPR: DERAPAJ
AADEKMY: DEMAKAY
AADEKNR: ANKADRE
AADEKTY: DEKATYA
AADELNR: ADRENAL
AADEMNN: ANMEDAN
AADEMNP: DEPAMAN
AADEMNT: MANDATE
AADEMNÇ: MAÇANDE
AADENST: ESTANDA
AADENTT: ENTATAD
AADENTY: ANDETAY
         DETAYAN
AADENYZ: ANDEZAY
AADEORT: ADORATE
AADEPTY: DEPATYA
AADEPTÇ: DEPATÇA
AADERTY: RADYATE
AADFIIV: AFIDAVI
AADFMRY: DYAFRAM
AADFNNS: DANFANS
AADGILM: AMIGDAL
AADGIMR: MADIGRA
AADGINR: AGRANDI
AADGLVÂ: LAVÂGAD
AADGNRR: GRANDRA
AADIJNY: JADINAY
AADIKLM: MALKADI
AADIKLN: KADINAL
         KALINDA
AADIKLR: RADIKAL
AADIKNP: ANDIKAP
AADIKNS: AKSIDAN
AADIKNT: DANTIKA
AADIKRW: DIRAKWA
AADILPS: PALISAD
AADILRV: ALADRIV
AADILTW: DILATWA
AADIMNR: MARINAD
AADINOY: ADONAYI
AADJNOR: ORANJAD
AADKLMÂ: MAKÂDAL
AADKMRÂ: KÂMARAD
AADKNYÊ: KANADYÊ
AADKOPP: PAPADOK
AADLNTW: LANDWAT
AADMNNR: RANDMAN
AADMNNY: MANDYAN
AADMNOY: ADYOMAN
AADNNRÛ: ANDÛRAN
AADNNST: TANDANS
AADORTY: RADOTAY
AAEEJLL: ALALEJE
AAEEPRY: APAREYE
AAEFKRS: FRAKASE
AAEFLST: ASFALTE
AAEFMNR: AFREMAN
AAEFMNY: ANFEMAY
AAEFMTZ: METAFAZ
AAEFNNT: ANFANTE
AAEFTTY: TAFYATE
AAEGLNV: AVEGLAN
AAEGMNZ: MAGAZEN
         MAZENGA
AAEGNPT: GETAPAN
AAEGNSW: AGWESAN
AAEGNTW: WANGATE
AAEIJTT: AJITATE
AAEIKTZ: AKIZATE
AAEILNZ: ANALIZE
AAEILVZ: AVALIZE
AAEIMNT: ANIMATE
AAEINSS: ASASINE
AAEITVY: AVIYATE
AAEJNNT: AJANTEN
AAEJTVÂ: AVÂTAJE
AAEJVWY: VWAYAJE
AAEKKLR: KAKAREL
AAEKKRT: KARAKTE
AAEKKTW: KAKATWE
         KAKAWET
AAEKLLN: ALKALEN
AAEKLMR: KARAMEL
AAEKLMY: KAMELYA
AAEKLRV: KARAVEL
AAEKLRW: AKWAREL
AAEKLSÔ: ALEKÔSA
AAEKLVY: KAVALYE
AAEKMMR: MAKRAME
AAEKMNN: AMANNKE
AAEKMNR: KAREMAN
AAEKMPT: METAKAP
AAEKMRS: MASAKRE
AAEKMRY: MAREKAY
AAEKNRS: KARESAN
AAEKNTÇ: ANKAÇET
AAEKNYZ: KAZANYE
AAEKPYÔ: AKÔPAYE
AAEKSSW: AKSESWA
AAELLPR: PARALEL
AAELLYÛ: ALELÛYA
AAELMRY: LAMARYE
AAELMTY: MALTAYE
AAELNRS: ARANSEL
AAELNST: LASANTE
AAELNTY: LATANYE
AAELOPT: ALAPOTE
AAELPRS: LAPARES
AAELRST: LATERAS
AAELTTW: TATAWEL
AAEMNNP: PEMANAN
AAEMNNT: ANTEMAN
AAEMNPZ: APEZMAN
AAEMNRS: RANMASE
AAEMNRT: TAMAREN
AAENNRY: ANNARYE
AAENNSS: ANSANSE
         ANSASEN
AAENNST: ANSANTE
AAENNTW: ANWETAN
AAENNTÇ: ANÇANTE
AAENRTV: ANTRAVE
AAENSTY: SATANYE
AAENSVZ: SANZAVE
AAENTVY: AVANTYE
         EVANTAY
AAERTVY: TRAVAYE
AAFFNNW: FANNFWA
AAFGINT: FATIGAN
AAFGLNR: FLAGRAN
AAFIKNT: FANATIK
AAFILMN: LAFANMI
AAFIMNN: ANFANMI
AAFIMNS: FANMASI
AAFIMNT: FATIMAN
AAFINRY: FARINAY
AAFINRÇ: AFRANÇI
AAFINTT: ATANTIF
AAFINTY: ANFAYIT
AAFJMNS: FANMSAJ
AAFLMNN: FLANMAN
AAFLNTY: LAFYANT
AAFLNTÔ: LAFÔTAN
AAFMNSY: FANMSAY
AAFMSYÊ: FAMASYÊ
AAFNNTÊ: ANFANTÊ
AAFNORW: FARAWON
AAFNRSW: FRANSWA
AAGGNNN: NGANGAN
AAGGNNS: GANGANS
AAGGNNÊ: GAGANNÊ
AAGGOTY: GAGOTAY
AAGIILT: ALIGATI
AAGIKLS: GALAKSI
AAGILMN: LIGAMAN
AAGIMNR: MAGARIN
AAGINRT: GARANTI
AAGIPSY: GASPIYA
AAGJLWÛ: ALAGWÛJ
AAGJMNÂ: ÂGAJMAN
         ANGAJMÂ
AAGJNNR: GRANJAN
AAGKLOT: KATALOG
AAGLLSY: GLASYAL
AAGLMOÇ: MALAGOÇ
AAGLPYÂ: GALAPYÂ
AAGLWYÛ: ALAGWÛY
AAGMNNÂ: ÂGANMAN
         ANGÂMAN
         ANGANMÂ
AAGMNOS: MASOGAN
AAGMNRT: GRATMAN
AAGMNSÛ: MANGÛSA
AAGNOSW: AWOGANS
AAGOTWW: WOGATWA
AAGPPRÂ: GRÂPAPA
AAIJKMY: MAKIYAJ
AAIJLNV: VAJINAL
AAIJMNS: AJISMAN
AAIJNPT: PATINAJ
AAIJNRT: AJANTRI
AAIJPRT: PATIRAJ
AAIJSTY: AJISTAY
AAIKKMR: MAKAKRI
AAIKKRT: KAKATRI
AAIKKTW: AKWATIK
AAIKLMW: MAKWALI
         MIKALAW
AAIKLPT: KAPITAL
AAIKLTY: KATILAY
AAIKMNO: AMONIKA
AAIKMNY: KAYIMAN
AAIKMNÇ: KAÇIMAN
AAIKMST: ASMATIK
AAIKNNR: KANNARI
AAIKNPR: KAPRINA
AAIKNSW: SINAKWA
AAIKNTT: ANTATIK
AAIKTYZ: AZYATIK
AAILLVY: ALIVYAL
AAILMNT: MATINAL
AAILMNY: ALIYMAN
AAILNSS: SALISAN
AAILPPR: PARAPLI
AAILPTY: TILAPYA
AAILRSV: LAVARIS
AAIMMNZ: AMIZMAN
AAIMNOT: ANATOMI
AAIMNPÇ: PAÇIMAN
AAIMNRY: MARYANI
AAIMNTÇ: ÇATIMAN
AAINNPR: PANNARI
AAINPRS: ASPIRAN
AAINPRT: APRANTI
AAINPTY: PATINAY
AAINPTZ: PATIZAN
AAINRSS: ASIRANS
AAINRST: ATIRANS
AAINSST: ASISTAN
AAIOTYY: ATIYAYO
AAIPRTY: PATIRAY
AAIPRTZ: PARAZIT
AAIPRTÇ: PARAÇIT
AAIPSTT: PATATIS
         PATATSI
AAIWYZZ: ZAYIWAZ
AAJKNPÔ: KAPÔNAJ
AAJKOTW: KAWOTAJ
AAJKOWÇ: AKWOÇAJ
AAJMNNÇ: ÇANJMAN
AAJMNOW: MAWONAJ
AAJMNRÂ: ARÂJMAN
         ARANJMÂ
AAJNRTÛ: ANTÛRAJ
AAKKNNY: KANYANK
AAKKORY: KARYOKA
AAKLMNS: KLASMAN
AAKLMSÔ: KALMASÔ
AAKLMSÛ: MAKALÛS
AAKLNPR: LAKRANP
AAKLOPR: KAPORAL
AAKLOSW: LASKAWO
AAKLOSY: KASAYOL
AAKLOSÇ: ÇALOSKA
AAKMNOW: MAKAWON
AAKMNOY: AMONYAK
AAKMNRÛ: KÛRAMAN
AAKMNWZ: KWAZMAN
AAKMNÇÛ: AKÛÇMAN
AAKNPYÔ: KAPÔNAY
AAKNSSW: KWASANS
AAKNSWY: KWAYANS
AAKNSÇÛ: SANKÛÇA
AAKNWYÊ: ÊKWAYAN
AALLMOY: LAMAYOL
AALLNPÇ: LAPLANÇ
AALMMVÛ: MALAVÛM
AALMNNT: LANTMAN
AALMNOR: ORALMAN
AALMNPS: PLASMAN
AALMNSÇ: MALÇANS
AALMOTY: LAMAYOT
AALNNOW: ALAWONN
AALNPTV: PLAVANT
AALNPTÔ: PANTALÔ
AALNRTÂ: ALANTRÂ
         ALÂTRAN
AALNSSY: LASYANS
AALNTYÊ: LATANYÊ
AALNVYÛ: YANVALÛ
AALOPRS: PARASOL
AALPRSÂ: LAPARÂS
AALPRTÂ: ALATRÂP
AALPSTÂ: PLASÂTA
AALPSTÊ: PLASÊTA
AAMMNNÂ: AMÂNMAN
         AMANNMÂ
AAMNNNR: RANNMAN
AAMNNNS: SANNANM
AAMNNNZ: ZANMANN
AAMNNPS: PANSMAN
AAMNNSÇ: ÇANNMAS
AAMNNWÇ: WAÇMANN
AAMNOTV: AVOTMAN
AAMNSVÂ: AVANSMÂ
         AVÂSMAN
AAMNTWÇ: WATÇMAN
AANNNPÂ: ANPÂNAN
         ANPANNÂ
         ÂPANNAN
AANNNYÎ: ANNÎYAN
AANNNZÂ: ZÂNANNA
         ZANNÂNA
AANNOTW: ANTONWA
AANNPPÊ: ANPÊPAN
AANNPRT: ANTRANP
AANNPTW: PWATANN
AANNPTY: TYANPAN
AANNPTÇ: TÇANPAN
AANNRYÔ: ANRANYÔ
AANNSST: SANTANS
AANNSSW: SWASANN
AANNSVÂ: ÂNAVANS
         ANNAVÂS
AANOPSV: AVANPOS
AANOPTT: POTANTA
AANPSSY: PASYANS
AANPSYÊ: ÊPASYAN
AANPTZÂ: ZAPATÂN
AANRTYZ: ZANTRAY
AANRTYÛ: ANTÛRAY
AANSSTW: SWASANT
AANSSYÔ: ASANSYÔ
AANSTYÔ: ATANSYÔ
AAPRTWY: PWATRAY
AARTTYÛ: RATATÛY
AARTVYÂ: TRAVAYÂ
ABBDENO: BONBADE
ABBDEYÔ: BÔBADYE
ABBDMÂÔ: BÔBADMÂ
ABBEELZ: ZEBABLE
ABBEILN: BANBILE
ABBEJYÛ: JÛBABYE
ABBEKTÛ: BABÛKET
ABBENOÇ: BANBOÇE
ABBEOTZ: BABOTEZ
ABBILNO: BANBILO
ABBILYÂ: BÂBILAY
ABBINOY: BOBINAY
ABBIOOY: AYIBOBO
ABBLOOS: SOLOBAB
ABBNNOS: BONBANS
ABDDEFÂ: DEFÂDAB
ABDDEYÂ: DEBÂDAY
ABDDIIT: DABITID
ABDEEKS: DEKABES
ABDEELR: DELABRE
ABDEERY: DEBRAYE
ABDEEWZ: DEBWAZE
ABDEINN: BADINEN
ABDEINT: DEBITAN
ABDEJLN: DJANBEL
ABDEJLS: DJABLES
ABDEKLÂ: KÂDELAB
ABDEKMÂ: DEBAKMÂ
ABDELSY: DYABLES
ABDELSÊ: SALDEBÊ
ABDELYÂ: ÂDYABLE
ABDEMNO: ABDOMEN
ABDEMTÂ: DEBATMÂ
ABDENNW: BWADENN
ABDENOÂ: ABÂDONE
ABDENWÇ: BWADÇEN
ABDEYYÛ: DEBÛYAY
ABDIIJR: DIRIJAB
ABDIIMS: ADMISIB
ABDIKSÂ: ÂBISKAD
ABDILOY: BLIYADO
ABDLNOW: BANDWOL
ABDNNOS: BONDANS
ABDNNÊÔ: BANDÔNÊ
ABDNOSÂ: ABONDÂS
ABDNOÂÊ: ABÂDONÊ
ABDOSWÂ: BWOSADÂ
ABEEFNY: ABYENFE
ABEEGMN: ANMBEGE
ABEEKKW: KEBEKWA
ABEEKST: BASKETE
         ESTEBAK
ABEELOR: ELABORE
ABEELYÇ: BAÇELYE
ABEEMPY: PEMEYAB
ABEENRY: ANBREYE
ABEFLMS: BLASFEM
ABEFWYÛ: BWAFÛYE
ABEGLMÔ: LAGÔMBE
ABEGMNN: BEGMANN
ABEGNVÛ: GÛVENAB
ABEIILT: ABILITE
ABEIKLS: BASKILE
ABEIKNO: OKABINE
ABEIKNS: ANBISKE
         BEKASIN
ABEIKRT: BAKTERI
ABEIKTÊ: ÊKIBATE
ABEILNÇ: LABIÇEN
ABEILRT: RETABLI
ABEILSY: SABLIYE
ABEILTY: TABLIYE
ABEILWZ: BIZAWEL
ABEIMRZ: MIZERAB
ABEINRT: REBITAN
ABEINSY: ANBISYE
ABEIRTV: VERITAB
ABEISTT: BATISTE
ABEJLNÛ: BÛLANJE
ABEJRYÂ: ÂBREYAJ
ABEKLNY: NAYKLEB
ABEKLOS: KALBOSE
ABEKNOY: BAKONYE
ABEKNRÔ: ANKÔBRE
ABEKNTÛ: BÛKANTE
         ENKÛTAB
ABEKNYÛ: BÛKANYE
ABELMNN: BLANMEN
ABELMNÛ: EBÛLMAN
ABELMZÔ: MAZÔBEL
ABELNNR: LABRENN
ABELNNÔ: BALÔNEN
ABELNRT: TRANBLE
ABELNST: LABSENT
ABELORY: BOREYAL
         LABORYE
ABELRSÂ: RASÂBLE
ABEMNOÇ: BONMAÇE
ABEMOTW: BAWOMET
ABENNNR: BRANNEN
ABENORZ: REZONAB
ABENOTY: BAYONET
         BETONAY
ABENOYÇ: ÇABONYE
ABENRSÛ: RANBÛSE
ABENWYÛ: ANBWÛYE
ABEOSTÇ: BAÇOSET
ABFKOTÔ: KÔFOTAB
ABFMNÊÛ: MANFÛBÊ
ABFRWZÂ: FRÂBWAZ
ABGHNRÂ: BRÂHANG
         BRANHÂG
ABGIKNR: GRINBAK
ABGINOZ: BIZANGO
ABGIRRÛ: RABÛGRI
ABIIKLZ: BAZILIK
ABIILMN: ALBIMIN
ABIIRSZ: RAZIBIS
ABIJSTÂ: JÂBATIS
ABIJWZÛ: BÛJWAZI
ABIKLNY: NAYKLIB
ABIKLOT: BAKILOT
ABIKMOÇ: KAÇIMBO
ABIKNOS: BOKANSI
ABIKNOT: BOTANIK
ABIKNRÊ: KRABINÊ
ABIKORZ: ZABRIKO
ABILNNÛ: ANBÛLIN
ABILNOS: ALBINOS
ABILNSÂ: ÂBILANS
         ANBILÂS
         BALÂSIN
ABIMOSY: BIYOMAS
ABIMSTÂ: BATISMÂ
ABINOST: BOTANIS
ABINRYÔ: ANBRIYÔ
ABINSSÊ: ÊSANSIB
ABINSYÔ: ANBISYÔ
ABIOPWW: BWAPIWO
ABISTYÔ: BITASYÔ
ABJLNOR: LONBRAJ
ABJNNNO: BONNANJ
ABKLLOP: PLAKBOL
ABKLTÂÂ: BATÂKLÂ
ABKMNNÛ: BÛKMANN
ABKNNWÔ: KANBWÔN
ABKNNÊÛ: BÛKANNÊ
ABKNOOT: BAKOTON
ABKTYÂÛ: BÛKÂTAY
ABLMNÂÔ: BALÔNMÂ
ABLNNOÊ: BALONNÊ
ABLNOOT: TONBOLA
ABLNORY: LONBRAY
ABLNPTÂ: PLATBÂN
ABMNZÂÂ: BANZÂMÂ
         BÂZÂMAN
         BÂZANMÂ
ABMPYÂÛ: MAPYÂBÛ
ABNNOSS: BONSANS
ABNOOWÇ: WOÇANBO
ABNTWÇÊ: BWATÇÊN
ABTZÛÛÛ: AZÛBÛTÛ
ADDEEGR: DEGRADE
ADDEENW: DEDWANE
ADDEGRÂ: DEGRADÂ
ADDEIKS: DEDIKAS
ADDEKSÂ: DEKADÂS
ADDEKYÛ: DEYAKÛD
ADDENOZ: ANDEZOD
ADDIILV: DIVIDAL
ADDIINS: DISIDAN
ADDINOY: DODINAY
ADDJJNÂ: DJÂDJAN
         DJANDJÂ
ADDNRRÂ: DRÂDRAN
         DRANDRÂ
ADDNYYÂ: DYÂDYAN
         DYANDYÂ
ADEEFKL: DEFALKE
ADEEFNN: FENDANE
ADEEFPY: PAYDEFE
ADEEGJZ: DEGAJEZ
ADEEGPR: DEGRAPE
ADEEGYZ: EGZAYED
ADEEIKT: EDIKATE
ADEEJNR: DANJERE
         DERANJE
ADEEJNT: DEJANTE
         DETEJAN
ADEEKKL: DEKALKE
ADEEKLR: DEKLARE
         DELAKER
ADEEKLZ: DELAKEZ
ADEEKMS: DEMASKE
ADEEKMT: DEKAMET
ADEEKNP: DEKANPE
ADEEKRT: DEKRETA
ADEEKSZ: DEZAKSE
ADEEKTÇ: DEKAÇTE
ADEEKYY: DEYEKAY
ADEELNP: LEPEDAN
ADEELPS: DEPLASE
ADEEMNÇ: DEMANÇE
ADEENNS: ENDESAN
ADEENNY: ANDENYE
ADEENPS: DEPANSE
ADEENRT: ANTREDE
ADEENRV: REVANDE
ADEENSV: DESEVAN
         DEVANSE
ADEEPRT: PREDATE
ADEEPRV: DEPRAVE
ADEERTV: DETRAVE
ADEERVY: DEVARYE
ADEESTV: DEVASTE
ADEFIMN: DEFANMI
ADEFINR: DIFERAN
ADEFIRR: RAFREDI
ADEFIRW: REFWADI
ADEFLOR: ALFREDO
ADEFNRÔ: ANFÔDRE
ADEGGMO: DEMAGOG
ADEGGOP: PEDAGOG
ADEGJMÂ: GADMÂJE
ADEGKNO: DEKAGON
ADEGLOY: DYALOGE
ADEGMNÂ: ÂMEGDAN
         ANMEGDÂ
ADEGNNN: NANDENG
ADEGNNR: GRENNAD
ADEGNTÛ: DEGÛTAN
ADEIIRT: ARIDITE
ADEIIST: ASIDITE
ADEIJNN: ENDIJAN
ADEIJNY: JADINYE
ADEIJTV: DAVETIJ
ADEIKKR: KADERIK
ADEIKLM: MEDIKAL
ADEIKNR: ANDIREK
ADEIKNS: SENDIKA
ADEIKOY: AKODIYE
ADEIKPÂ: ÂDIKAPE
ADEIKTT: DIKTATE
ADEIKTÊ: ÊDIKATE
ADEILMS: DESIMAL
ADEILNS: DESALIN
ADEILNZ: ILANDEZ
ADEILST: SITADEL
ADEILVY: DIVALYE
ADEIMNS: SEDIMAN
ADEIMNT: DEMANTI
         DIMATEN
ADEIMNZ: MEDIZAN
ADEIMRY: MADRIYE
ADEIMST: DEMITAS
ADEIMTY: IMEDYAT
ADEINNÇ: ÇIENDAN
ADEINOT: ODINATE
ADEINPS: APENDIS
ADEINRY: ADRIYEN
ADEINST: DANSITE
         DISETAN
ADEINTV: DEVANTI
ADEINTY: ETIDYAN
ADEIRSY: RADIYES
ADEIRVY: DEVIRAY
         DRIVAYE
ADEIRWZ: DERIZWA
ADEJKLO: DEKOLAJ
ADEJNRÂ: ÂJANDRE
         ANJÂDRE
ADEJNVÛ: DEVANJÛ
ADEJPTÂ: DJETAPÂ
ADEJRTÛ: RETÛDAJ
ADEKLNÊ: DELÊKAN
ADEKLSÂ: ESKÂDAL
ADEKLVÂ: VALKÂDE
ADEKMNO: KOMANDE
         MADOKEN
ADEKMNÔ: KÔMANDE
ADEKMOO: AKOMODE
ADEKNNO: KONDANE
ADEKNRÛ: KÛRANDE
ADEKNSÔ: KÔDANSE
ADEKOTY: OKTAYED
ADEKOYÔ: AKODEYÔ
ADEKYÇÛ: DEÇÛKAY
ADELMNN: LANDMEN
ADELMNP: PLEDMAN
ADELMNÂ: LADEMÂN
         MÂNDELA
ADELMNÊ: LANDEMÊ
ADELMOT: MOTADEL
ADELNOZ: OLANDEZ
ADELNYÊ: LADÊNYE
ADELOSÂ: ADOLESÂ
ADELSTÂ: LADESÂT
ADELTYÛ: LADÛYET
ADEMNNÊ: NANDEMÊ
ADEMNNÔ: ANDENMÔ
ADEMNOT: ADMETON
ADEMNTÜ: DETÜMAN
ADEMNVÛ: DEVÛMAN
ADEMPTÂ: DEPATMÂ
ADENNNO: ADONNEN
ADENNOY: DANNOYE
ADENNPÊ: DEPANNÊ
ADENNPÔ: PADÔNEN
ADENOPY: PONYADE
ADENOSY: ODYANSE
ADENOTT: ETANDOT
ADENOWZ: DANWEZO
ADENOYZ: ADEZYON
         ANDYOZE
ADENOYÇ: ÇADONYE
ADENRST: TANDRES
ADENRVÛ: RANDEVÛ
ADENSSÊ: ÊDESANS
ADENTTÎ: ÎTEDTAN
ADEOPTW: DEPOTWA
ADESWWZ: SWEDWAZ
ADETWZÛ: DEZÛTWA
ADETYZÂ: ÂTDEZAY
ADFIKNÔ: KÔFIDAN
ADFIKNÛ: KAFÛNDI
ADFILOR: FLORIDA
ADFIOPT: ADOPTIF
ADFMNÂÂ: FÂDÂMAN
         FÂDANMÂ
         FANDÂMÂ
ADFSYÔÔ: FÔDASYÔ
ADGMNÛÛ: MADÛNGÛ
ADGNNOR: GRANDON
ADIIJLN: DILIJAN
ADIIJNR: DIRIJAN
ADIIKMN: DINAMIK
ADIIKNT: IDANTIK
ADIIKTT: DIKTATI
ADIILMT: DILAMIT
ADIILPS: PALIDIS
ADIILTT: ALTITID
         LATITID
ADIIMNS: DINAMIS
ADIIMNT: DINAMIT
ADIIMNV: MADIVIN
ADIIMPR: PIRAMID
ADIIPTT: APTITID
ADIIRST: ARISTID
ADIIRSY: RADIYIS
ADIJMNÂ: DÂMIJAN
         DANMIJÂ
ADIJMRÂ: JÂDAMRI
ADIJNSÊ: ÊDIJANS
ADIKMNO: DOKIMAN
ADIKMSÊ: MISKADÊ
ADIKORS: SIKRADO
ADIKOTW: KAWOTID
ADILMNO: LIMONAD
ADILMNÔ: LANMIDÔ
         LIMÔNAD
ADIMNNO: DOMINAN
         NANDOMI
ADIMNOÇ: MADIÇON
ADIMNRÂ: MÂDARIN
ADIMNÊÔ: AMIDÔNÊ
ADIMPRÂ: RAPIDMÂ
ADIMPTÂ: PIMÂTAD
ADIMSYÔ: ADMISYÔ
ADIMZÂÇ: MAÇÂDIZ
ADINNSÛ: ANSÛDIN
ADINOSY: ADISYON
ADINOTT: ANTIDOT
ADINPRÊ: ÊPRIDAN
ADINPSS: DISPANS
ADINRSÂ: ÂDIRANS
         ANDIRÂS
ADINRTT: DANTRIT
ADINRTÂ: DIRANTÂ
         DIRÂTAN
ADINRVY: DRAYVIN
ADINSST: DISTANS
ADINSWÇ: SANDWIÇ
ADIPPYÂ: DAPIYÂP
ADIRVYÔ: IDRAVYÔ
ADISTVÂ: ADVÂTIS
ADISWZÂ: SWADIZÂ
ADJKKOO: DJAKOKO
ADJKLMO: MALDJOK
ADJKLNO: JANKLOD
ADJMMOÂ: DOMAJMÂ
ADJMNZÂ: DJAZMÂN
ADJNVÛÛ: DÛVANJÛ
ADKKNOO: KONKODA
ADKLMOY: MALDYOK
ADKMNOÂ: KOMÂDAN
         KOMANDÂ
ADKMNÂÔ: KÔMÂDAN
         KÔMANDÂ
ADKNNOW: DAKWONN
ADKOORT: DOKTORA
ADLMNOY: MONDYAL
ADLMRÂÊ: MALÂDRÊ
ADMNNOÊ: ANDÊMON
ADMNOPW: PWOMNAD
ADMNOSÂ: DASOMÂN
ADMNSÂÔ: ADÂMSÔN
ADNNOPÊ: PADONNÊ
ADNTTÊÊ: TÊTÊNAD
ADNTÂÂÂ: ÂNATÂDÂ
ADOPSYÔ: ADOPSYÔ
ADRSYÂÎ: RÂDÎSAY
AEEELTV: ELEVATE
AEEEVÇÇ: AÇEVEÇE
AEEFKTY: KAFETYE
AEEFLNN: ENFENAL
AEEFLRY: LAFERYE
AEEFLRÇ: LAFREÇE
AEEFMNN: ANFEMEN
AEEFMNT: FEMANTE
AEEFMWZ: MAFWEZE
AEEFNRY: EFREYAN
AEEFRTY: RATYEFE
AEEFWÇÛ: EFAWÛÇE
AEEGGLO: EGALEGO
AEEGILT: EGALITE
AEEGILZ: EGALIZE
AEEGLNW: EGLENWA
AEEGMNZ: EGZAMEN
AEEGNRS: ANGRESE
AEEGNTZ: EGZANTE
AEEGTYZ: EGZEYAT
AEEIJKL: EJAKILE
AEEIKLL: ALEKILE
AEEINSV: ANIVESE
AEEIPPY: EPAPIYE
AEEITTZ: ETATIZE
AEEJLMN: LEJEMAN
         MELANJE
AEEJLNR: JENERAL
AEEJNRT: ETRANJE
AEEJPRÇ: REPEÇAJ
AEEKKRR: AKREKRE
AEEKLMR: REKLAME
AEEKLMT: TELEMAK
AEEKLNS: ANSEKLE
AEEKLSW: KALEWES
AEEKLSY: ESKALYE
AEEKMNW: AMWENKE
AEEKMNZ: EKZAMEN
AEEKNPS: ESKANPE
AEEKNRS: ANSEKRE
AEEKNST: EKSTENA
AEEKPRS: RESKAPE
AEEKPST: AKSEPTE
AEEKPTW: PATEKWE
AEEKRTZ: RAKETEZ
AEEKSSY: ASEKSYE
AEEKTZÇ: KATEÇEZ
AEELMNT: LEMATEN
         MATENEL
AEELMRZ: MALEREZ
AEELNPR: LANPERE
AEELNST: ENSTALE
AEELNTV: ENTEVAL
AEELPRZ: LAPEREZ
AEELRSY: SEREYAL
AEELRTÊ: ALÊTERE
AEELTTV: LAVETET
AEELTVÇ: ÇEVALET
AEELVYÇ: ÇEVALYE
AEEMNNV: EVENMAN
AEEMNRZ: EREZMAN
AEEMNST: SEMANTE
AEENNNV: ENNEVAN
AEENNRT: ANTRENE
AEENNRY: ARENYEN
AEENNTV: ENVANTE
AEENPRT: ANPETRE
         TANPERE
AEENPST: ANPESTE
         ESPANTE
AEENPTT: TANPETE
AEENPTZ: PEZANTE
AEENRTV: EVANTRE
AEENRYY: AYERYEN
AEENSYÇ: EÇEYANS
AEENTWY: NETWAYE
AEEOPRT: OPERATE
AEEOPRV: EVAPORE
AEEPPRR: PREPARE
AEEPRST: TREPASE
AEEPRSY: APRESYE
AEEPRSZ: PARESEZ
         REPASEZ
AEERSTV: TRAVESE
AEERSVW: RESEVWA
AEERSWY: YERESWA
AEERTVY: VARYETE
AEERTWZ: RAZWETE
AEERVWZ: REZEVWA
AEFGILN: FILANGE
AEFGINT: NEGATIF
AEFGIRS: AGRESIF
AEFIJRS: JESIFRA
AEFIKLM: MALEFIK
AEFIKLT: FAKILTE
AEFIKNR: AFRIKEN
AEFIKNY: KAFEYIN
AEFIKRS: FRIKASE
AEFIKRY: EFRAYIK
AEFILMN: LAFIMEN
AEFILMS: MALEFIS
AEFIMNZ: ANFIZEM
AEFIMSW: MASWIFE
AEFINNR: FARINEN
AEFINNS: FINANSE
AEFINRY: FINERAY
AEFINSY: FIYANSE
AEFINTZ: FANTEZI
AEFIPSY: PASIFYE
AEFIRRÇ: RAFREÇI
AEFISST: SATISFE
AEFITVY: VEYATIF
AEFKLNO: KAFENOL
AEFKNNÂ: ÂFANNKE
         ANFÂNKE
AEFKNRS: FARENKS
         FREKANS
AEFKNSÔ: KANSÔFE
AEFKSYÔ: AFEKSYÔ
AEFLMZÂ: MALFEZÂ
AEFLNNN: FLANNEN
AEFLNOS: SELOFAN
AEFLOST: LAFOSET
AEFMNTÛ: ETÛFMAN
AEFMOST: ATMOSFE
AEFMOTÊ: ÊFOMATE
AEFMPTÂ: PAFETMÂ
AEFNNNÛ: ANFÛNEN
AEFNNOS: ANFONSE
AEFNNTÂ: ÂFANTEN
         ANFÂTEN
AEFNOPW: PWOFANE
AEFNOTW: AFWONTE
AEFNOTY: FAYETON
AEFNPTÛ: PAFÛTEN
AEFNRSZ: FRANSEZ
AEFORTW: OTREFWA
AEFOTWY: ATWOFYE
AEFRYÂÛ: ÂFÛRAYE
AEGGIZZ: ZIGZAGE
AEGGNNÂ: GAGÂNEN
AEGGNOZ: EGZAGON
AEGIJNZ: EGZIJAN
AEGILSY: GLASIYE
AEGINNS: SANGINE
AEGINOZ: AGONIZE
         OGANIZE
AEGIPSY: GASPIYE
AEGIRST: SIGARET
AEGIRTV: GRAVITE
AEGJNRÂ: ÂGRENAJ
AEGKNOZ: EKZAGON
AEGKNRT: REKTANG
AEGKNST: GANKSTE
AEGLNNÔ: GALÔNEN
AEGLNRT: TRANGLE
AEGMNNO: MANGONE
AEGMNRT: GRANMET
AEGNNSW: SANGWEN
AEGNVYÛ: GÛVENAY
AEGRSYÔ: AGRESYÔ
AEGTWZÂ: WÂGATEZ
AEIIJLT: AJILITE
AEIIJMN: IMAJINE
AEIIKLM: AKIMILE
         IMAKILE
AEIILNV: ALEVINI
AEIIMNT: IMANITE
AEIJKLN: ANJELIK
AEIJLNS: ANJELIS
AEIJLNT: ANTIJEL
         JELATIN
         JENITAL
AEIJLNV: EVANJIL
AEIJMNR: REJIMAN
AEIJMOR: EMORAJI
AEIJNNT: ANTIJEN
AEIJPYZ: PIYAJEZ
AEIKKLL: KALKILE
AEIKKMN: MEKANIK
AEIKKSY: KISKEYA
AEIKLMS: MAKSILE
AEIKLMT: KALIMET
         METALIK
AEIKLNP: PELIKAN
AEIKLPY: LEKIPAY
AEIKLST: ELASTIK
AEIKLTV: VETIKAL
AEIKLVÂ: EKIVALÂ
AEIKMNP: EKIPMAN
AEIKMRS: SERAMIK
AEIKMRÊ: AMERIKÊ
AEIKMST: MASTIKE
AEIKNNT: TAKINEN
AEIKNPT: KAPITEN
AEIKNRY: ANKRIYE
AEIKNST: EKSITAN
         KANISTE
AEIKNSV: VAKSINE
AEIKNTT: KANTITE
AEIKPRT: PRATIKE
AEIKRTY: KREYATI
AEIKRYÇ: YERAÇIK
AEIKSSY: KASEYIS
AEIKSTT: ESTATIK
AEIKSTÇ: KATEÇIS
AEIKTYÇ: ÇAKITYE
AEILMNR: MERILAN
         MINERAL
AEILMNT: TEMINAL
AEILMNZ: LANMIZE
AEILMTY: LAMITYE
AEILMTZ: ZALIMET
AEILMTÂ: ALIMÂTE
AEILNRT: NATIREL
AEILNTY: ITALYEN
AEILPRS: ESPIRAL
AEILPRY: LAPRIYE
AEILRST: RESITAL
AEILRTY: LATRIYE
         LERITAY
AEILRTZ: REZILTA
AEILRVY: LARIVYE
AEILSTT: SATELIT
AEILWZZ: AZIZWEL
AEIMNNR: ANRIMEN
         MARINEN
AEIMNNT: MATINEN
AEIMNOZ: AMONIZE
AEIMNST: SIMANTE
AEIMNTT: MATINET
AEIMNTY: ANMIYET
AEIMOTY: ATEMIYO
AEIMSTY: MAYETIS
AEINNPT: PATINEN
AEINNPY: ANNIPYE
AEINNPÇ: PENÇINA
AEINNSS: SASINEN
AEINPPY: PEPIYAN
AEINPRT: REPANTI
AEINPRY: REPIYAN
AEINPYZ: PEYIZAN
AEINRYZ: ZARIYEN
AEINSTV: ANVITES
AEINSVY: SIVEYAN
AEINSYY: AYISYEN
AEIOPSZ: ASIPOZE
AEIPRVY: PREYAVI
AEIPSTÂ: APETISÂ
AEIRRST: RATRESI
AEIRTTW: TERITWA
AEIRTVÂ: AVÂTIRE
AEITTYZ: ZATIYET
AEJJMNN: JENJANM
AEJJNNN: JENNJAN
AEJKRÂÛ: ÂKÛRAJE
AEJLMNO: MAJOLEN
AEJLNNÛ: LAJÛNEN
AEJLNOR: RALONJE
AEJLNYÛ: JÛNALYE
AEJLOTÇ: JEÇALOT
AEJLRYÊ: ALJERYÊ
AEJNOPS: PESONAJ
AEJNOPT: PATOJEN
AEJNOPZ: JAPONEZ
AEJNPSÔ: PESÔNAJ
AEJNRSÊ: ÊJERANS
AEJOPPW: PWOPAJE
AEKKMNO: KAMOKEN
AEKKNRÔ: KÔKERAN
AEKKNSÔ: KÔSEKAN
AEKLLOT: LAKOLET
AEKLMNO: MAKONEL
AEKLMNÛ: EKÛLMAN
AEKLNNO: KALONEN
AEKLNNÔ: KALÔNEN
AEKLNOR: KORALEN
AEKLNOW: KAWOLEN
AEKLNRS: LARENKS
AEKLNSÂ: ALEKSÂN
AEKLORT: ARETKOL
AEKLPYÔ: KÔPAYEL
AEKLSVÂ: VALKÂSE
AEKLSYÂ: AKÂSYEL
AEKLYYÛ: KÛLYEYA
AEKMMNN: KANMENM
AEKMNNW: MWENNKA
AEKMNNÔ: MAKÔNEN
AEKMNOS: KOMANSE
         KOMESAN
AEKMNOT: KOMANTE
AEKMNOW: MAWOKEN
AEKMNPÂ: PAKEMÂN
AEKMNST: SEKTANM
AEKMNSÔ: KÔMANSE
         KÔMESAN
AEKMNSÛ: KÛMANSE
AEKMNTÔ: MEKÔTAN
AEKMOPR: POMERAK
AEKMOTÇ: MAÇOKET
AEKMRSÂ: SAKREMÂ
AEKMSWÊ: AMWÊSKE
AEKNNPT: KAPTENN
AEKNNPÔ: KAPÔNEN
AEKNNTÛ: ENKÛTAN
AEKNOPR: KONPARE
AEKNORT: RAKONTE
AEKNOSY: AKSYONE
AEKNOTW: KAWOTEN
AEKNSYÔ: AKSYÔNE
AEKNWYÂ: ENKWAYÂ
AEKPRTÔ: KÔPARET
AEKPRYÂ: PÂKREYA
AEKRTVÊ: KATREVÊ
         VÊKATRE
AEKRTYÔ: KÔTRAYE
AEKSWYÔ: EKWASYÔ
AELLNNP: LAPLENN
AELLNOS: SOLANEL
AELLOVY: ALVEYOL
AELMMNO: MALOMEN
AELMMNZ: MANMZEL
AELMNOT: ALONTEM
AELMNSW: MALSWEN
AELMNSÛ: SÛLAMEN
AELMNTÂ: LANTEMÂ
         LÂTEMAN
AELMNTÔ: MALÔNET
AELMOYZ: MALOZYE
AELMPTÂ: PALMÂTE
AELMVYÂ: MALVEYÂ
AELNNNP: PLANNEN
AELNNOS: ENSOLAN
AELNNPT: PLANTEN
AELNNTY: LYETNAN
AELNNTÔ: TALÔNEN
AELNOSZ: SALEZON
AELNOTW: LAWONTE
AELNPRÇ: ÇANPREL
AELNPSW: SANPWEL
AELNPSÔ: LAPESÔN
AELNPTÇ: PLANÇET
AELNPWÇ: ÇANPWEL
AELNSTÛ: LATÛSEN
AELNSÇÛ: SÛLEÇAN
AELOPRS: PARESOL
AELOPST: SALOPET
AELOPSY: ESPAYOL
AELOTZÇ: ZEÇALOT
AELPRYÊ: ÊPERYAL
AELPTTÂ: PÂTALET
AELPTZÔ: PLATEZÔ
AELPWYÂ: ÂPLWAYE
AELRSYÔ: RELASYÔ
AELSTWÊ: SÊTELWA
AELSVYÔ: LEVASYÔ
AELSYZÊ: SALEZYÊ
AELVZÂÛ: ALEVÛZÂ
AEMMMNN: MENMMAN
AEMNNSW: ANMWENS
AEMNNSÔ: MASÔNEN
AEMNORT: OTREMAN
AEMNORW: WOMAREN
AEMNORZ: ANMOREZ
AEMNOST: MONASTE
AEMNPST: SEPTANM
AEMNPÂÇ: ANPEÇMÂ
         ÂPEÇMAN
AEMNRSÛ: SÛMAREN
AEMNRTT: TRETMAN
AEMNRZÛ: ANMÛREZ
AEMNSSÊ: SÊSEMAN
AEMNSTY: SANTYEM
AEMNSTÊ: ESTAMÊN
AEMNSYÂ: ANSEYMÂ
         ÂSEYMAN
AEMNTTÛ: TÛMANTE
AEMNTVÛ: ÛVETMAN
AEMORTY: MATERYO
AEMORTZ: ZAMORET
AEMSTTÂ: TESTAMÂ
AEMSZÂÔ: ASEZÔMÂ
AEMTWYZ: TWAZYEM
AENNNOT: ANTONEN
         TAONNEN
AENNNPW: NANPWEN
AENNNÇÊ: ANÇÊNEN
         ANÇENNÊ
AENNOPT: ENPOTAN
AENNPPÂ: ANPENPÂ
         ÂPENPAN
AENNPRR: REPRANN
AENNPRT: ANPRENT
         PRENTAN
         PRETANN
AENNRTT: TRANTEN
AENNRTÛ: ANTRENÛ
AENNSVÔ: SAVÔNEN
AENNSYZ: ZANSYEN
AENNTTÔ: TATÔNEN
AENORSY: SENARYO
AENORTZ: RATEZON
AENOSTT: TETANOS
AENOTTY: ANTOTYE
AENPRSZ: PREZANS
AENPSYÂ: ENPASYÂ
AENPSYÔ: PESÔNAY
AENPZÇÊ: ÇÊPANZE
AENRSTV: VANTRES
AENRTTÂ: ANTRETÂ
         ÂTRETAN
AENSWYY: SWENYAY
AENSZÊÔ: ASEZÔNÊ
AENVYZÔ: ENVAZYÔ
AEOOPWY: AYEWOPO
AEOSWWY: YEWOSWA
AEPRTZÂ: PARÂTEZ
AEPSSYÔ: ASPESYÔ
AEPSTYÂ: SAPÂTYE
AEPTYÂÇ: ÇAPÂTYE
AERVWYÂ: RÂVWAYE
AESSTYÔ: ESTASYÔ
AESTTYÛ: SATÛYET
AETTYZÛ: ZATÛYET
AETTYÇÛ: ÇATÛYET
AETTÇÇÛ: ÇATÇÛTE
AETVVYÊ: VATEVYÊ
AFGIIRT: GRAFITI
AFGILLÂ: FILALÂG
AFGMORÂ: GRÂFOMA
AFGOORT: OTOGRAF
AFGRYÊÛ: GRAFÛYÊ
AFIIKPS: PASIFIK
AFIILMN: MALFINI
AFIJKNÛ: KAFÛNJI
AFIKNOS: OFISKAN
AFIKNRS: FRANSIK
AFIKNTÂ: FÂNATIK
AFIKORT: FAKTORI
AFIKRYÊ: ÊFRAYIK
AFILLPÔ: FILAPLÔ
AFILMNÂ: FINALMÂ
AFILNOT: LAFOTIN
AFIMNOS: FONMASI
AFINNTÂ: ÂFANTIN
         ANFÂTIN
AFINRTÊ: ÊFANTRI
AFIRYZÊ: FARIZYÊ
AFISYYÂ: FIYÂSAY
AFJMNOW: FWONMAJ
AFKNNOY: KONFYAN
AFKNOSY: FAKSYON
AFKNSYÔ: KÔFYANS
AFKRSYÔ: FRAKSYÔ
AFLMOPT: PLATFOM
AFLNOTÂ: LAFONTÂ
AFLNPÊÔ: PLAFÔNÊ
AFLSYÊÔ: ÊFLASYÔ
AFMNOTW: FWOTMAN
AFMNRÂÇ: FRÂÇMAN
         FRANÇMÂ
AFMOSYÔ: FOMASYÔ
AFMRSÂÔ: FRÂMASÔ
AFMTWÂÔ: AFWÔTMÂ
AFNNSÂÂ: ÂNÂFANS
         ÂNANFÂS
         ANNÂFÂS
AFNRSSÛ: SÛFRANS
AFOPTYÛ: FÛYAPOT
AFOSTTÛ: ATÛTFOS
AGGLOOT: GOLGOTA
AGGNNRÊ: GANGRÊN
AGIIMNR: IMIGRAN
AGIIMRS: SIMAGRI
AGIIRST: GITARIS
AGIKLNÂ: ÂGLIKAN
         ANGLIKÂ
AGIKLOR: AGRIKOL
AGILMNS: GLISMAN
AGILMOP: POLIGAM
AGILNNP: PLANING
AGILNOZ: GAZOLIN
AGILNTÛ: ANGLÛTI
AGILOPT: GALIPOT
AGILRTÂ: GALÂTRI
AGILTÂÇ: LÂGIÇAT
AGINNOT: ANTIGON
AGINNOZ: GANIZON
AGINOST: TIGASON
AGINOSW: ANGWOSI
AGINRTY: TRIYANG
AGIRTÂÇ: GÂTRIÇA
AGKNOOT: OKTAGON
AGKNWÛÛ: KANGÛWÛ
AGLNNOÊ: GALONNÊ
AGMMNÊÔ: MANGÔMÊ
AGMNNRÛ: GRANMÛN
AGMNOOW: AGWONOM
AGMNPWÛ: GWÛPMAN
AGMNYÂÛ: MÂGÛYAN
         MANGÛYÂ
AGMOPRW: PWOGRAM
AGMOYZÂ: ZOMÂGAY
AGMRTÂÊ: GRÂMATÊ
AGMRWÊÊ: MARÊGWÊ
AGNNNOO: NONAGON
AGNNOTY: TYOGANN
AGNOPTÊ: PÊTAGON
AGNOTVW: GWOVANT
AGNRYÊÔ: GARYÔNÊ
AGPRRÂÂ: GRÂPARÂ
AIIJLNV: VIJILAN
AIIKKLR: AKRILIK
AIIKLLT: LAKILTI
AIIKLMS: SIMILAK
AIIKLNZ: LAKIZIN
AIIKLPT: PATIKIL
AIIKLSV: AKSIVIL
AIIKMTY: KAYIMIT
AIIKNPS: ISPANIK
         KAPISIN
AIIKRTÇ: ÇAKITRI
         RAÇITIK
AIIKSTT: ATISTIK
AIIKSTV: AKTIVIS
AIILMNV: MALVINI
AIILMNY: IMILYAN
AIILNSS: LASISIN
AIILNSY: INISYAL
AIILSSY: ALSIYIS
AIILSVÂ: AVILISÂ
AIIMNNR: RIMINAN
AIIMNST: AMNISTI
AIIMNTV: VITAMIN
AIIMRST: RIMATIS
AIINPRS: ASPIRIN
AIIPRST: PATISRI
         TIPARIS
AIJLNOS: LAJONIS
AIJLNSÛ: JÛNALIS
AIJMNTÂ: JANTIMÂ
         JÂTIMAN
AIJMSYÊ: MAJISYÊ
AIJNSSW: JWISANS
AIJORSV: SOVAJRI
AIKKLLO: ALKOLIK
AIKKLOT: KATOLIK
AIKKNOT: NAKOTIK
AIKKNOY: KOKAYIN
AIKKNRÔ: KÔKIRAN
AIKKRYÊ: KÊKAYRI
AIKLMOZ: KAMIZOL
AIKLMSÊ: MASKILÊ
AIKLNOP: AKONPLI
AIKLNOV: VILOKAN
AIKLNOW: KAWOLIN
AIKLNOZ: ANKILOZ
AIKLNRT: TRANKIL
AIKLOTW: KILOWAT
AIKLPST: PLASTIK
AIKLRST: KRISTAL
AIKLTTÂ: ATLÂTIK
         TÂTAKIL
AIKMNOW: AKWONIM
AIKMOYZ: MOZAYIK
AIKNNOV: KANNIVO
AIKNNRÊ: RIKANNÊ
AIKNNTÔ: KÔTINAN
AIKNOPY: KONPAYI
AIKNORY: KARIYON
AIKNOTT: OTANTIK
AIKNOTÇ: ANTIÇOK
AIKNPTÊ: KAPITÊN
AIKNSTÔ: KÔSANTI
AIKORSW: KAWOSRI
AIKPPSÛ: PASPÛKI
AIKPRTÂ: PRATIKÂ
AIKTWZÛ: KÛTWAZI
AILLOPS: LAPOLIS
AILLOPT: LOPITAL
AILMNOR: LANMORI
AILMNOZ: IZOLMAN
AILMNTÂ: LÂMITAN
         LANMITÂ
AILMNVÊ: ANVLIMÊ
AILMRZÎ: MARILÎZ
AILNNOY: NAYILON
AILNNTW: LANNWIT
AILNOVY: ALIVYON
AILNOYZ: ALIZYON
AILNVWÔ: LAVIWÔN
AILOPPS: POPILAS
AILOPRS: SALOPRI
AILRTVY: TRIVYAL
AILRTYÂ: LÂTIRAY
AIMMNNO: MONIMAN
AIMMNTÛ: TIMAMÛN
AIMNNOT: ANTONIM
AIMNNOZ: ZANNIMO
AIMNPSÊ: MASPINÊ
AIMNRSÛ: SÛMARIN
AIMSTYÔ: MITASYÔ
AIMTYZÂ: ZÂMITAY
AINNNTW: NANNWIT
AINNORY: INYORAN
AINNOSS: INOSANS
AINNOST: INOSANT
AINNOVW: ANVIWON
AINNPRS: SIPRANN
AINNPSS: SISPANN
AINNRSÛ: NÛRISAN
AINOPPY: PAPIYON
AINOPST: SIPOTAN
AINORSY: IYORANS
AINPRTW: PWATRIN
AINPSSW: PWISANS
AINPYÇÔ: ÇANPIYÔ
AINRSÂÊ: ÂRASINÊ
AINSSSÛ: SANSÛSI
AINSSTY: SYANTIS
AINSSÂÊ: ÂSASINÊ
AINSSÊÊ: ÊSASINÊ
AINSTVÛ: TÛNAVIS
AINTTYÊ: TITANYÊ
AINTTÂÇ: ÇITATÂN
AINVWZÊ: VWAZINÊ
AINVWZÔ: ZANVIWÔ
AIOOSSW: ASOWOSI
AIOPSTY: SAPOTIY
AIRVWYÊ: IVWARYÊ
AISSSTÂ: ASISTÂS
AISSTYÔ: SITASYÔ
AISTWYÊ: SITWAYÊ
AJLLOWÛ: LAWÛJOL
AJLMSÂÛ: SÛLAJMÂ
AJLRTÂÛ: LÂTÛRAJ
AJPSTÂÛ: PÛSÂTAJ
AKKLNSÔ: KLAKSÔN
AKKLRÂÛ: KARÂKLÛ
AKKNNÂÊ: KÂKANNÊ
         KANKÂNÊ
AKKOORT: KOKORAT
AKLMOSY: KALSYOM
AKLNNOÊ: KALONNÊ
AKLNOOÇ: LAKOÇON
AKLNOWZ: KLWAZON
AKLNVÂÊ: VALKÂNÊ
AKLOOTV: OTOKLAV
AKLOSTW: KASTWOL
AKLPTÂÛ: KÂTALÛP
AKMMNOÂ: KOMÂMAN
         KOMANMÂ
AKMMNÂÛ: KÛMÂMAN
         KÛMANMÂ
AKMNNOÊ: MAKONNÊ
AKNNNÂÂ: KÂNÂNAN
         KÂNANNÂ
         KANNÂNÂ
AKNNOPR: KRANPON
AKNNOPT: PANNKOT
AKNNOPY: KONPANY
AKNNOPÊ: KAPONNÊ
AKNNORT: RANKONT
AKNNOST: KONSTAN
AKNNPRÔ: KÔPRANN
AKNOOYZ: OKAZYON
AKNOPYÔ: KONPAYÔ
         KÔPAYON
AKNOPZÔ: KÔPOZAN
AKNPRÊÔ: KRAPÔNÊ
AKNRWYÂ: KWARYÂN
AKNRYÊÔ: KARYÔNÊ
AKNSYÊÔ: ÊKÔSYAN
AKOSVYÔ: VOKASYÔ
AKOTWÇÛ: KAWOTÇÛ
AKSTWÂÊ: AKWÊTÂS
AKSTYÂÛ: SÂKÛTYA
AKSTÂÇÛ: SÂKÛTÇA
ALLOTZÊ: LÊZALOT
ALMMNÊÊ: MALMÊNÊ
ALMMTÔÛ: MALMÛTÔ
ALMMWÂÂ: MÂMÂLWA
ALMNNYÂ: LÂMYANN
         LANMYÂN
ALMNOOS: SALOMON
ALMNOYÊ: NOMALYÊ
ALMOOPT: OMOPLAT
ALMOPPW: MALPWOP
ALMPSÂÂ: ÂPLASMÂ
ALMPTWÊ: TÊMPLAW
ALNNOTÊ: TALONNÊ
ALNOOTZ: ZOTOLAN
ALNOPTÂ: PÂTALON
ALNOSSÊ: ÊSOLANS
ALNOSVY: VYOLANS
ALORTYÂ: ORYÂTAL
ALOTZÂÛ: OZALÂTÛ
ALPWWÛÛ: WÛLAWÛP
ALRTYÂÛ: LÂTÛRAY
AMMNOOY: AMONYOM
AMMNSÂÂ: SÂMÂMAN
         SÂMANMÂ
         SANMÂMÂ
AMMNÂÇÇ: ÇÂMÇANM
         ÇANMÇÂM
AMNNOSÊ: MASONNÊ
AMNOPTÂ: ANPOTMÂ
         ÂPOTMAN
AMNRTÂÊ: ANTRÊMÂ
         ÂTRÊMAN
AMNTWÂÇ: WATÇMÂN
AMNZÛÛÛ: AZÛMÛNÛ
AMOOPTY: MAPOTYO
AMOOPTÇ: MAPOTÇO
AMOPPWÛ: AMÛPWOP
AMPTWÂÊ: APWÊTMÂ
ANNNWYÛ: NYÛWANN
ANNOOPR: RANPONO
ANNOPRÂ: RANPÂNO
         RÂPANNO
ANNOPSY: PANSYON
ANNOPYÇ: ÇANPYON
ANNORYÂ: ÂRANYON
ANNOSTW: SANWONT
ANNOSTY: TANSYON
ANNOSVÊ: SAVONNÊ
ANNOTTÊ: TATONNÊ
ANNPTÊÔ: TANPÔNÊ
ANNRTÂÂ: ÂNANTRÂ
         ÂNÂTRAN
         ANNÂTRÂ
ANNSSVÛ: SÛVNANS
ANNTÇÊÔ: ÇANTÔNÊ
ANOPSTÊ: ÊPOTANS
ANOSSYÂ: ASÂSYON
ANOSTYÂ: ATÂSYON
ANOTTTÛ: TÛTOTAN
ANOVYZÊ: ÊVAZYON
ANPTTÇÊ: ANÇTPÊT
ANPWZÊÔ: PWAZÔNÊ
ANPYÂÇÔ: ÇÂPYÔNA
ANRRTYÊ: RÊNRAYT
ANSTYÊÔ: ÊTANSYÔ
ANSTZÂÂ: SÂZATÂN
ANSVYÊÔ: ÊVANSYÔ
ANTTZÂÂ: TANZÂTÂ
         TÂZANTÂ
         TÂZÂTAN
AOPSTTW: PWOSTAT
AOSSTWÂ: OSTÂSWA
AOSTVYÔ: VOTASYÔ
AOSTWYÔ: WOTASYÔ
APRSVÎÛ: RAPÛSÎV
APRSYÂÔ: SARÂPYÔ
APSSYÂÊ: ÊPASYÂS
APSTWÇÛ: PWATSÛÇ
ASSSYÂÔ: SÂSASYÔ
BBDEEEK: BEBEDEK
BBDEILO: BEBIDOL
BBEFLÔÔ: BÔBÔFLE
BBEINNO: BOBINEN
BBEKLOÂ: BEKÂBOL
BBELLNÊ: BLÊBLEN
         BLENBLÊ
BBINOÂÊ: ÂBOBINÊ
BBNOYÊÔ: BÔBONYÊ
BDDEEEJ: DJEBEDE
BDDEEIR: DEBRIDE
BDDEELÛ: DEDÛBLE
BDDEEOY: DEBODYE
BDDEIOS: DEBODIS
BDDEMOÂ: DEBODMÂ
BDEEELY: DEBLEYE
BDEEERY: DEBREYE
BDEEFIV: FIBDEVE
BDEEGOT: BODEGET
BDEEGOY: DEGOBYE
BDEEILS: DESIBEL
BDEEKLO: DEBLOKE
BDEEMRÂ: DEMÂBRE
BDEERÂÇ: DEBRÂÇE
BDEEWYÛ: DEBWÛYE
BDEGIRÂ: BRIGÂDE
BDEGLOÊ: GOLDÊBE
BDEIMOT: DEMIBOT
BDEINOR: REBONDI
BDEJNRÊ: BREDJÊN
BDELOZÛ: BÛLDOZE
BDELYÂÛ: BÂDÛLYE
BDEMRYÛ: DÛMBREY
BDEMWYÔ: DÔMBWEY
BDEMWYÛ: DÛMBWEY
BDENNÂÔ: BÂDÔNEN
BDENNÔÛ: BÛDÔNEN
BDEOTÇÊ: ÇOTDEBÊ
BDGIILN: BILDING
BDGIOTÛ: BÛTDIGO
BDIIIVZ: DIVIZIB
BDIILMÂ: MÂDIBIL
BDIILVÔ: BIDÔVIL
BDISYÂÔ: BÂDISYÔ
BDMNÂÔÛ: BÛDÔNMÂ
BDNNOÂÊ: BÂDONNÊ
BDNNOÊÛ: BÛDONNÊ
BEEEJNR: BEREJEN
BEEEKLN: KELENBE
BEEEKRT: KREBETE
BEEELRS: SELEBRE
BEEERTV: VETEBRE
BEEFINS: BENEFIS
BEEFNNÇ: BEFÇENN
BEEFTYÊ: BYÊFETE
BEEIKLN: KILENBE
BEEILLO: IBOLELE
BEEILNS: ENBESIL
BEEINRÇ: ÇERIBEN
BEEINTY: BENITYE
BEEIOTZ: OBEZITE
BEEKLMÊ: KELÊMBE
BEELMNN: BLENMEN
BEELRYÔ: REBELYÔ
BEELSVÛ: BÛLVESE
BEENNTY: BYENNET
BEENNTÔ: BETÔNEN
BEENRYÊ: BYÊNERE
BEERTYÛ: BÛRETYE
BEFIOSY: BIYOSFE
BEFIYZÔ: ZÔBIFYE
BEFKLOÛ: FÛKBOLE
BEFLOTÛ: FÛTBOLE
BEFLSÛÛ: BÛSÛFLE
BEFMNÂÛ: MÂFÛBEN
BEGGITÊ: GITÊBEG
BEGNNÔÛ: BÛGÔNEN
BEGNRZÊ: BRENZÊG
         BRÊZENG
BEIIKLT: KILBITE
BEIILPY: PIBLIYE
BEIILRR: LIBRERI
BEIINVZ: ENVIZIB
BEIJTYÛ: BIJÛTYE
BEIKLOR: BRIKOLE
BEIKLSÛ: BÛSKILE
BEINOPS: ENPOSIB
BEINOTW: WOBINET
BEINSSÂ: ENSÂSIB
BEINSTÂ: BISÂTNE
BEINVYÊ: BYÊVENI
BEIOPWY: PWOYIBE
BEIOSYÂ: OBEYISÂ
BEIPRST: PRESBIT
BEISYZÂ: ÂBISYEZ
BEITYZÛ: BÛZIYET
BEJNNÔÛ: BÛJÔNEN
BEKLNÂÔ: KÔBELÂN
BEKNNOY: KONBYEN
BEKNNÂÛ: BÛKÂNEN
BEKNORÂ: ÂKONBRE
BEKOOTY: BOYKOTE
BELLOOV: VOLEBOL
BELMOPW: PWOBLEM
BELNNÔÛ: BÛLÔNEN
BELNOPY: PLONBYE
BENNOTÊ: BETONNÊ
BENNTÔÛ: BÛTÔNEN
BENOSYZ: SENBYOZ
BENRSÇÛ: RENSBÛÇ
BENTYÔÛ: BÛTÔNYE
BEOORTZ: ZOTOBRE
BGGRRÂÊ: GRÂBRÊG
BGNNOÊÛ: BÛGONNÊ
BGNORWÊ: GWOBRÊN
BGNRRÂÊ: GRÂBRÊN
BIIIKSS: IBISKIS
BIIIKST: KIBITIS
BIIJRTÛ: BIJÛTRI
BIIKOTY: BIYOTIK
BIIRSTÛ: BISTÛRI
BIKLNOR: LONBRIK
BIKLOOW: BWOKOLI
BILNORT: LONBRIT
BILOVYÊ: BOLIVYÊ
BIMNOOR: MORIBON
BINNORT: NONBRIT
BINORYÂ: ÂBRIYON
BINOSYÂ: ÂBISYON
BINOTWÇ: BWONÇIT
BINOTYÛ: TÛBIYON
BJNNOÊÛ: BÛJONNÊ
BKLOOOS: KOLBOSO
BKLOYÊÔ: KOLÔBYÊ
BKNNOWÂ: KÂBWONN
BLLNÂÂÇ: BLÂÇLÂN
BLLOSÊÛ: BÛLSÊLO
BLNNOÊÛ: BÛLONNÊ
BLOOOTÇ: ÇOBOLOT
BLTÇÛÛÛ: ÇÛBÛLÛT
BMNNNOO: BONNONM
BNNOTÊÛ: BÛTONNÊ
BNOOTWÂ: TOWOBÂN
BNOTYÛÛ: TÛBÛYON
DDEEGNÛ: DEGÛDEN
DDEEIMY: DEMIDEY
DDEENOY: DYEDONE
DDEINNO: DODINEN
DDEIRVÂ: VÂDREDI
DDENSÊÊ: SÊDÊDEN
         SÊDENDÊ
         SENDÊDÊ
DDEPÂÂÊ: ÊDEPÂDÂ
DDESSÂÂ: DESÂDÂS
DDIIIVÊ: ÊDIVIDI
DDIIKOS: DIOKSID
DDIINOZ: DIZONDI
DDIINVÂ: DIVIDÂN
DDIKTÂÂ: DIKDÂTÂ
DDJJNOÔ: DJÔDJON
         DJONDJÔ
DDNOYYÔ: DYÔDYON
         DYONDYÔ
DEEEGLN: GENDELE
DEEEGLR: DEREGLE
DEEEGRS: DEGRESE
DEEEIRT: EREDITE
DEEEKRT: DEKRETE
DEEEKTT: DETEKTE
DEEELMP: DEMEPLE
DEEELPP: DEPEPLE
DEEEPRT: DEPETRE
DEEEPSY: ESPEDYE
DEEERST: DETRESE
DEEERVZ: DEZEVRE
DEEESTT: DETESTE
DEEFGLÔ: DEGÔFLE
DEEFILN: ENFIDEL
DEEFIMR: DEMIFRE
DEEFIPR: DEFRIPE
DEEFIRT: FREDITE
DEEFIRÇ: DEÇIFRE
         DEFRIÇE
DEEFKNO: FEKONDE
DEEFKOR: DEKOFRE
DEEFKOT: KOTDEFE
DEEFKOW: DEFWOKE
DEEFLZÂ: DEZÂFLE
DEEFMOT: FETDEMO
DEEFMYÂ: DEMEFYÂ
DEEFNNÛ: DEFÛNEN
DEEFNOR: EFONDRE
         FREDONE
DEEFNOS: DEFONSE
DEEGILV: DEVILGE
DEEGINR: DENIGRE
DEEGLOP: DEPLOGE
DEEGLSÂ: DESÂGLE
DEEGNOS: SEGONDE
DEEIIMP: EPIDEMI
DEEIJNS: ENDIJES
DEEIKLN: DEKLINE
DEEIKMR: MEKREDI
DEEIKMS: DEMISEK
DEEIKRT: DIREKTE
DEEIKTZ: DEZETIK
DEEILLN: LELENDI
DEEILMZ: DEZILME
DEEILPS: DEPLISE
DEEILPZ: DEPLEZI
DEEILRV: DELIVRE
DEEIMPR: DEPRIME
DEEIMPY: PEDIYEM
DEEIMST: DESIMET
DEEINRS: DERISEN
DEEINST: DESTINE
DEEINTV: DEVINET
DEEINVZ: DEVINEZ
DEEIPRT: DETRIPE
DEEIPSS: DISPESE
DEEISSV: DESEVIS
DEEISTZ: DEZISTE
DEEJKOS: KESEDJO
DEEJRÂÇ: DEREÇÂJ
DEEJTWÊ: DEJWÊTE
DEEKKLO: DEKLOKE
DEEKKOW: DEKWOKE
DEEKLNS: LENDEKS
DEEKLNÂ: DELENKÂ
DEEKLOT: DEKOLTE
DEEKLRÛ: DEKLÛRE
DEEKLWÛ: DEKLÛWE
DEEKLÂÇ: DEKLÂÇE
DEEKNTÔ: DEKÔNET
DEEKOTW: DEKWOTE
DEEKOTÇ: DEKOÇTE
DEEKTVÛ: DEKÛVET
DEELMNÂ: LÂDEMEN
DEELMTÂ: DEMÂTLE
DEELOPV: DEVLOPE
DEELOPY: DEPLOYE
DEELYÂÇ: ÇÂDELYE
DEEMNNÂ: NÂDEMEN
DEEMNOT: DEMONTE
DEEMOPT: POMDETE
DEEMRTÔ: DEMÔTRE
DEENNOS: DENONSE
DEENNOZ: DEZONNE
DEENNPÂ: DEPÂNEN
DEENNSÛ: DESÛNEN
DEENNTÛ: DETÛNEN
DEENNÇÊ: DEÇÊNEN
         DEÇENNÊ
DEENOTW: DETWONE
DEENOTÂ: ETÂDONE
DEENSSÂ: ENDESÂS
DEEOPSW: PWOSEDE
DEEOTTY: DETOTYE
DEEOWYZ: DEWOZYE
DEEPTWÊ: DEPWÊTE
DEEPTWÔ: DETWÔPE
DEERSWÔ: DEWÔSRE
DEERTVÂ: DEVÂTRE
DEERVZÂ: REVÂDEZ
DEFIIJR: FRIJIDE
DEFIIRT: DIFTERI
DEFIISZ: DESIZIF
DEFIOSW: IDWOSFE
DEFIRSÂ: DIFERÂS
DEFIRÂÊ: ÊDIFERÂ
DEFNORÂ: ÂFONDRE
DEFNRÊÔ: FREDÔNÊ
DEFOPWÔ: PWOFÔDE
DEGIIJR: DEGRIJI
DEGIILV: DIVILGE
DEGILNO: LIGONDE
DEGIOSW: DEGWOSI
DEGIRZÂ: GRÂDIZE
DEGISTÊ: DISTÊGE
DEGLNOO: GONDOLE
DEGNNNO: DENGONN
DEGNNOÔ: GODÔNEN
DEGNOTÇ: DETÇONG
DEGNRÊÊ: DEGRÊNÊ
DEGRYÂÊ: ÊGREDYÂ
DEGSTÂÛ: DEGÛTÂS
DEIIIMT: IMIDITE
DEIIKST: DISKITE
DEIILST: DESILIT
         DISTILE
DEIIMNY: DIMINYE
DEIINVZ: DIVINEZ
DEIIPST: DISPITE
         ESTIPID
DEIITTÂ: IDÂTITE
DEIITYÊ: ÊDIYITE
DEIJLSÂ: DELIJÂS
DEIJLWÔ: JIWÔDEL
DEIJMNÂ: DEMIJÂN
DEIJNOW: IDWOJEN
DEIJNSÂ: ENDIJÂS
DEIJSVÂ: DIVEJÂS
DEIJSYÔ: DIJESYÔ
DEIKKTÔ: KÔDIKTE
DEIKLOS: DISLOKE
DEIKLRÊ: ÊKREDIL
DEIKLVÔ: DEKÔVIL
DEIKMNO: KONMEDI
DEIKOWÇ: DEKWOÇI
DEIKRSÊ: ÊDISKRE
DEIKRTÔ: KÔTREDI
DEIKRVÛ: DEKÛVRI
DEIKSTÂ: TÂDISKE
DEIKSWÔ: DESKIWÔ
DEILMOZ: DOZILME
DEILMPÊ: DEPLIMÊ
DEILMÂÇ: LEDIMÂÇ
DEILWZÔ: ZIWÔDEL
DEIMNNÔ: MIDÔNEN
DEIMORS: DORISME
DEIMOST: METODIS
         MODESTI
DEIMOTW: IDWOMET
DEIMSYÊ: MEDSIYÊ
DEIMSYÔ: DEMISYÔ
DEINOSY: EDISYON
DEINPRÂ: ENPRIDÂ
DEINRYÔ: ÔDIRYEN
DEINYZÔ: DEZINYÔ
DEIOOPT: OTOPEDI
DEIOPSW: PWOSEDI
DEIOPSZ: DISPOZE
DEIOWYZ: DIWOZYE
DEIPRYÛ: PÛDRIYE
DEIPRZÂ: PREZIDÂ
DEIPSSÂ: DISPÂSE
DEIPSYÔ: PEDISYÔ
DEIRSYÂ: SÂDRIYE
DEISYZÔ: DESIZYÔ
DEJNOOR: DOJERON
DEKLSÂÊ: DELÊKÂS
DEKMNOÂ: KONMÂDE
DEKMOOW: DEKOWOM
DEKMOOÊ: ÊKOMODE
DEKMOYÊ: KOMEDYÊ
DEKMRÊÊ: DEKRÊMÊ
DEKMYÊÔ: KÔMEDYÊ
DEKNOSÂ: KONDÂSE
DEKNOYÔ: KODÔNYE
DEKNTÎÔ: ENKÔDÎT
DEKNWÊÊ: DEKWÊNÊ
DELMWÂÛ: DEWÛLMÂ
DELOSYÂ: DOLEYÂS
         LODYÂSE
DEMNNOÂ: ÂDENMON
DEMNTÂÛ: DETÛNMÂ
DEMPYÂÛ: DEPÛYMÂ
DENOSTÔ: ÔDONSTE
         ONDÔSTE
DENOSTÜ: ÜDONSTE
DENSTÔÛ: ÛNDÔSTE
DEOOPTW: WODPOTE
DEOPRWÎ: REPWODÎ
DEOPTVÂ: DEVÂPOT
DEOSVYÔ: DEVOSYÔ
DEOSYZÊ: DYOSEZÊ
DEPRSÛÛ: SÛPÛDRE
DESTWÔÔ: WÔDÔSTE
DESTYÂÔ: DETÂSYÔ
DFIIILS: DIFISIL
DFIIOTY: TIFOYID
DFIIYZÔ: DIFIZYÔ
DFIKNOÂ: KONFIDÂ
DFIKSÂÔ: KÔFIDÂS
DGIIIRT: TIGRIDI
DGIKOOW: GWODIKO
DGIMZÂÛ: GÛMÂDIZ
DGLOZÊÊ: ZÊGLÊDO
DGNNOOÊ: GODONNÊ
DGNWÊÔÛ: GÛDWÔNÊ
DGORYZÂ: GRÂDYOZ
DIIJLSÂ: DILIJÂS
DIIJLTÔ: LÔJITID
DIIKLOW: IDWOLIK
DIIKMNO: DOMINIK
DIILPTÂ: ÂPLITID
DIIOTWY: TIWOYID
DIIRSTÂ: DISÂTRI
DIIRSTÊ: ÊDISTRI
DIIRTVÂ: VIDIRÂT
DIIVYZÔ: DIVIZYÔ
DIJLTÂÛ: TIJÛDLÂ
DIJMNÂÂ: DÂMIJÂN
DIJOOPP: DJIPOPO
DIKKLOO: KOKODIL
DIKNORT: DOKTRIN
DIKNORÂ: ÂDOKRIN
DIKNOSY: DIKSYON
DIKSYÔÔ: KÔDISYÔ
DILMNOP: DONPLIM
DILMNOÂ: LÂMIDON
DILOSVÊ: DOSÊVIL
DILOTZÂ: ZÂDOLIT
DIMNNOÊ: MIDONNÊ
DIMNOSÂ: DOMINÂS
DIMNRÂÊ: MÂDRINÊ
DIMSTÂÛ: TÛDISMÂ
DIMSYÂÔ: DIMÂSYÔ
DINORYÊ: ONDIRYÊ
DIPRSÂÊ: ÊPRIDÂS
DIRSYÂÔ: SÂDRIYÔ
DISTYÂÔ: DÂTISYÔ
DJLLOOO: DJOLOLO
DJLOOST: DJOLSOT
DKLTÊÎÔ: LÊKÔDÎT
DKMMOÂÂ: KOMÂDMÂ
DKMNOÂÂ: KONMÂDÂ
DKMNOÂÛ: DÛKOMÂN
DKNOTÊÎ: ÊKONDÎT
DKNOÇÊÔ: KOÇÔDÊN
DKOOPSÂ: ÂDOSKOP
DLMNÂÂÊ: NÂLÂDMÊ
DMNOOWÔ: WÔDOMON
         WONDOMÔ
DMNOWÔÔ: WÔDÔMON
         WÔDONMÔ
         WONDÔMÔ
DPSTÂÂÂ: PÂDÂSTÂ
EEEFKNT: ENFEKTE
EEEFLRT: REFLETE
EEEFNRY: ENFERYE
EEEFPRR: PREFERE
EEEGLRT: LEGETER
EEEINTT: ETENITE
EEEJLNS: SENLEJE
EEEJNNY: ENJENYE
EEEKLST: ESKELET
EEEKLYZ: EZEKYEL
EEEKMPS: PESMEKE
EEEKNTY: ENKYETE
EEEKPST: EKSEPTE
EEEKRST: SEKRETE
EEELLNT: LETENEL
EEELMTÂ: ELEMÂTE
EEELNST: ETENSEL
EEELPPR: REPEPLE
EEELRSZ: RESELEZ
EEELSVY: VESELYE
EEENNST: ESTENEN
EEENNTT: ENTENET
EEENPRT: PENETRE
EEENSTY: ESTENYE
EEEPPST: PESEPTE
EEEPRVZ: PREZEVE
EEEPTTT: PETETET
EEERRTT: RETRETE
EEERSTÊ: ÊTERESE
EEFFIKT: EFEKTIF
EEFGLNT: FLENGET
EEFIKLR: FRELIKE
EEFILRÇ: REFLEÇI
EEFIMNN: FEMINEN
EEFIMNY: ENFIMYE
EEFIRSS: RESESIF
EEFIRVY: FEVRIYE
EEFKLRS: REFLEKS
EEFKNOS: KONFESE
EEFKRTÂ: FREKÂTE
EEFLMNO: ENFOMEL
EEFLNOT: TELEFON
EEFLSTÛ: SÛFLETE
EEFMNNO: FENOMEN
EEFNNNR: FRENNEN
EEFNNNW: FWENNEN
EEFOPSW: PWOFESE
EEFRYZÊ: ÊFERYEZ
EEGGLNO: GENGOLE
EEGGNNN: GENGENN
EEGIJLN: NEGLIJE
EEGIMRS: GREMESI
EEGINRY: NEGRIYE
EEGISSZ: EGZESIS
EEGISTZ: EGZISTE
EEGLMRÂ: REGLEMÂ
EEGLNNZ: ZENGLEN
EEGLOTT: OLTEGET
EEGNNNR: GRENNEN
EEGNNPW: PENGWEN
EEGNNPÇ: PENÇENG
EEGNNVÛ: GÛVENEN
EEGNOSY: NEGOSYE
EEIILMN: ELIMINE
EEIJJPR: PREJIJE
EEIJKNT: JENETIK
EEIJLRY: RELIJYE
EEIKLPR: REPLIKE
EEIKLPS: ESPLIKE
EEIKLRS: RESIKLE
EEIKLTT: LETIKET
EEIKMNR: MERIKEN
EEIKNRV: EKRIVEN
EEIKOPT: IPOTEKE
EEIKPRS: EKSPIRE
EEIKRSY: RESKIYE
EEIKSSZ: EKZESIS
EEILMST: METELIS
EEILNST: ENSILTE
EEILPRZ: PLEREZI
EEILSTÑ: ESTELIÑ
EEILSVY: LESIVYE
EEIMNPR: ENPRIME
EEIMPRT: PERIMET
EEIMPRZ: MEPRIZE
EEIMPSÂ: EMÂSIPE
EEIMTZÇ: ÇEMIZET
EEINNTV: ENTEVNI
EEINPPY: PEPINYE
EEINPRT: PENTIRE
EEINPTY: PYETINE
EEINRYZ: REZIYEN
EEINSST: ENSISTE
EEINSTV: ENVESTI
EEIPRRS: RESPIRE
EEIPRSY: SIPERYE
EEIPSST: PESISTE
EEIRRST: RETRESI
EEIRSTZ: REZISTE
EEIRSYZ: SERIZYE
EEIRTVÂ: ÂVERITE
EEIRTYZ: ZETRIYE
EEJLRTÂ: LETRÂJE
EEJMOTW: JEWOMET
EEJMOTY: JEYOMET
EEJMRYÊ: JEREMYÊ
EEJNNYÊ: ÊJENNYE
         ENJÊNYE
EEJNORS: JERENOS
EEJNOSY: JESYONE
EEJNRSÂ: ENJERÂS
EEJNRSÔ: JERENÔS
EEJOPTW: PWOTEJE
EEJRTYÊ: JERETYÊ
EEKKLOT: KOLEKTE
EEKKNTÔ: KÔNEKTE
EEKLORT: REKOLTE
EEKLRTÔ: LEKÔTRE
EEKLRZÛ: ZEKÛREL
EEKLSSÂ: EKSELÂS
EEKLSYÔ: ELEKSYÔ
EEKLTWÔ: ELEKTWÔ
EEKMNSY: SENKYEM
EEKMNYZ: KENZYEM
EEKMRST: EKSTREM
EEKNNPS: KEPENNS
EEKNORT: REKONET
EEKNORY: KOREYEN
EEKNOSV: KONSEVE
EEKNOSY: KESYONE
         KONSEYE
EEKNRTY: KRETYEN
EEKNSTÛ: ESTEKÛN
EEKOPTW: PEWOKET
EEKPRST: PRETEKS
EEKPRSÔ: KÔPRESE
EEKPSTÊ: ÊSPEKTE
EEKSTYÂ: ÂKSYETE
EEKTVZÛ: KEVÛZET
EELMPWY: PWELYEM
EELMRYÂ: REYELMÂ
EELNNPY: PLENYEN
EELNOPS: PESONEL
EELNRVÛ: RENÛVLE
EELOPTW: PWOLETE
EELOPTZ: ZEPOLET
EELORTV: REVOLTE
EELORVV: REVOLVE
EELORYÇ: REÇOLYE
EELOVYZ: VOLEYEZ
EELPTTÊ: PELÊTET
EELPTZÂ: PLEZÂTE
EELSSTÊ: SELESTÊ
EELSSYÂ: ESÂSYEL
EEMMOTT: TEMOMET
EEMNNNS: SENMENN
EEMNNRÔ: RENÔMEN
EEMNORT: REMONTE
EEMNOSY: MONSEYE
EEMNSSÂ: SENSEMÂ
EEMNSTÛ: ESTENÛM
EEMNTVY: VENTYEM
EEMORTY: TEYOREM
EEMRTYZ: TREZYEM
EEMSTÂÇ: MEÇÂSTE
EENNNRT: TRENNEN
EENNNÂÇ: ÂÇENNEN
EENNORS: RENONSE
EENNPPP: PENPENP
EENNRTZ: ZETRENN
EENNRTÛ: RETÛNEN
EENNSZÔ: SEZÔNEN
EENOPSY: ESPYONE
EENOPTW: PENETWO
EENOSYZ: SEZONYE
EENPRSS: PRENSES
EENPRVY: PREVYEN
EENPZÂÇ: ÇENPÂZE
EENRSTÛ: SÛTEREN
EENSTTÊ: ENTESTÊ
         ÊTESTEN
EEOPPRZ: PREPOZE
EEOPRWÇ: REPWOÇE
EEOPWYÊ: EWOPEYÊ
EEORRST: RESTORE
EEOSSTY: SOSYETE
EEPRSSÂ: ESPERÂS
EEPRTZÂ: PREZÂTE
EEPSTWÛ: WÛSPETE
EEPSTYÂ: SEPÂTYE
EERSTWÛ: RETWÛSE
EERSTÂÊ: ÊTERESÂ
EFFIOTY: FOTIFYE
EFGLMÂÔ: GÔFLEMÂ
EFGNNÔÛ: FÛGÔNEN
EFIIMNR: ENFIMRI
EFIIMNS: FEMINIS
EFIIMTÊ: ÊFIMITE
EFIIPRY: PIRIFYE
EFIJLNO: FILOJEN
EFIJRWÂ: JWIFERÂ
EFIKKSÔ: KÔFISKE
EFIKLOS: FOKSELI
EFIKMNO: KONFIME
EFIKMNÔ: KÔFIMEN
EFIKNOT: FONETIK
EFIKRRÔ: KÔFRERI
EFILMYÛ: FÛMILYE
EFILOST: LITOSFE
EFILOSY: OFISYEL
EFILRTÊ: ÊFILTRE
EFIMOTY: MOTIFYE
EFINNÇÔ: ÇIFÔNEN
EFINRTÂ: ENFÂTRI
EFIOPSW: PWOFESI
EFIOPTW: PWOFITE
EFIRRST: FRISTRE
EFIRSZÂ: FRÂSIZE
EFKMNOO: KONFOME
EFKNOOT: KONFOTE
EFKNOSÂ: KÂSONFE
EFKSYÊÔ: ÊFEKSYÔ
EFKSYÔÔ: KÔFESYÔ
EFKTWÔÔ: KÔFWÔTE
EFNNNOT: FONTENN
EFNNTÛÛ: TÛFÛNEN
EFNOSSÊ: SÊNESOF
EFNOTWY: FWONTYE
EFOOTWZ: ZEWOFOT
EGGLNOÊ: GÊNGOLE
EGGLORÊ: GRÊGOLE
EGGNNRÂ: GÂGRENN
EGGOYZÂ: GÂGOZYE
EGIINOR: INOGIRE
EGIJKNO: KONJIGE
EGIJLNÂ: NEGLIJÂ
EGIJSZÂ: EGZIJÂS
EGIKLOP: GOLKIPE
EGILMYÂ: MÂGLIYE
EGILOPT: EPIGLOT
EGILORY: LEGRIYO
EGIMNTÂ: MÂNIGET
EGIMRSÂ: GRÂMESI
EGINNYÔ: GIYÔNEN
EGINORZ: GERIZON
EGINOST: OGISTEN
EGIOPTZ: POTIGEZ
EGIRRÂÇ: GRÂÇIRE
EGJLOOY: JEYOLOG
EGJMRÂÂ: GRÂMÂJE
EGJNOÂÇ: ÇENÂGOJ
EGKLOTÂ: KOLÂGET
EGKLTÂÛ: KÛLÂGET
EGKSTZÂ: GÂKSTEZ
EGLNOOT: ETNOLOG
EGMMNÂÔ: MÂGÔMEN
EGMMNÔÔ: MÔGÔMEN
EGMMTÂÂ: GETMÂMÂ
EGMNVÂÛ: GÛVENMÂ
EGNNNOY: GYONNEN
EGNOSYÂ: NEGOSYÂ
EGNTVÂÛ: GÛVENÂT
EIIILMT: IMILITE
EIIILTT: ITILITE
EIIILTZ: ITILIZE
EIIIMNT: IMINITE
EIIIMNZ: IMINIZE
EIIINVV: INIVIVE
EIIJKNY: IJYENIK
EIIJKRZ: JEZIKRI
EIIJLMT: LEJITIM
EIIKKNT: KINETIK
EIIKKRT: KRITIKE
EIIKLMS: MISKILE
EIIKLOR: ORIKILE
EIIKMRÇ: ÇIMERIK
EIIKNYZ: KIZINYE
EIIKNZZ: KIZINEZ
EIIKPTZ: KIPIZET
EIIKTTÂ: ÂTIKITE
EIILMMT: MILIMET
EIILMNN: LIMINEN
EIILMNÊ: ELIMINÊ
EIILNNS: ENSILIN
EIILRST: ILISTRE
EIILRTT: TITIREL
EIIMNST: MINISTE
EIIMOPT: IPOTEMI
EIIMPRS: SIPRIME
EIIMPSS: PESIMIS
EIIMRST: SIMETRI
EIIMSTY: SIMITYE
EIINOWZ: IWONIZE
EIINRTT: TRINITE
EIIRSTZ: SITIREZ
EIIRTVY: VITRIYE
EIJKLOO: EKOLOJI
EIJKNOS: OKSIJEN
EIJLLSÂ: LÂJELIS
EIJLLVÂ: LEVÂJIL
EIJLOTV: VOLTIJE
EIJLRYÔ: RELIJYÔ
EIJLTÂÊ: ÊTELIJÂ
EIJMSTÂ: JISTEMÂ
EIJNRYÊ: NIJERYÊ
EIJPRST: PRESTIJ
EIJPSYÊ: EJIPSYÊ
EIJSTYÂ: JÂTIYES
EIKKLPÔ: KÔPLIKE
EIKKMSÊ: MEKSIKÊ
EIKKNOR: KONKERI
EIKKOPP: POKEPIK
EIKLLMO: MOLEKIL
EIKLMOP: POLEMIK
EIKLMOT: KILOMET
EIKLNOR: KOLERIN
EIKLORS: SIKRELO
EIKLOZÂ: ÂKILOZE
EIKLPSÂ: EKLÂPSI
EIKLRVÛ: KÛVRELI
EIKLSTÔ: KÔSILTE
EIKMNOO: EKONOMI
EIKMNOT: KONMITE
EIKMOST: KOSTIME
EIKMPRÔ: KÔPRIME
EIKMSTÂ: SEMÂTIK
EIKMSTÛ: MÛSTIKE
EIKNNRÂ: RIKÂNEN
EIKNOTV: KONVETI
EIKNOWZ: KEWOZIN
EIKNRYÂ: RÂKINYE
EIKNSTÂ: KÂNISTE
EIKNTYÔ: KÔTINYE
EIKNYZÎ: KÎZINYE
EIKOPRW: PWOKIRE
EIKORRT: RETORIK
EIKORTT: TRIKOTE
EIKORTY: KRIYOTE
EIKPRRS: PRESKRI
EIKPSTÔ: KÔSTIPE
EIKRTYÛ: KÛTIRYE
         KÛTRIYE
EILLNOT: TILENOL
EILMNTÛ: TÛLIMEN
EILMNVÂ: ÂVLIMEN
EILMOPS: POLEMIS
EILMOSW: WOMELIS
EILMPSÂ: SIPLEMÂ
EILMSTÂ: SITELMÂ
EILNNPÔ: PILÔNEN
EILNORS: LERISON
EILNSVÛ: NÛVELIS
EILNSYÛ: SÛLIYEN
EILOPPÊ: ÊPOPILE
EILOPST: PISTOLE
         POLITES
EILOPSY: POLISYE
EILORSY: RESIYOL
EILOTVY: VITYELO
EILPSVÛ: SIVÛPLE
EILRVZÔ: LIVREZÔ
EILSTYÔ: LEYÔTIS
EIMNNYÔ: MIYÔNEN
EIMNOSY: MISYONE
         MONSIYE
EIMPSYÔ: PEMISYÔ
EIMSSZÂ: SEZISMÂ
EIMSTTÂ: SÂTIMET
EIMSTYÊ: METSIYÊ
EINNOVW: VIWONEN
EINNVWÔ: VIWÔNEN
EINPPRS: PRENSIP
EINPSTÂ: PENITÂS
EINRYYÔ: REYINYÔ
EINSTWÔ: SENTIWÔ
EIOORTT: OTORITE
EIOORTZ: OTORIZE
EIOPRTT: TRIPOTE
EIOTTYÂ: ÂTOTIYE
EIPRSYÂ: REPIYÂS
EIPRVYÊ: PERIVYÊ
EIPSSTÂ: PESISTÂ
EIPTWYÊ: PWÊTIYE
EIRSSTT: TRISTES
EIRSSTÂ: RETISÂS
EITYÂÇÔ: EÇÂTIYÔ
EJLMNÂÛ: JÛNELMÂ
EJLOPWÔ: PWOLÔJE
EJNVVYÊ: JÊNVYEV
EKKKLNO: KELKONK
EKKLMOR: KOLKREM
EKKNNÂÂ: KÂKÂNEN
EKKNOOT: KOKONET
EKKNOOV: KONVOKE
EKKNORÂ: KONKERÂ
EKKNOSV: KONVEKS
EKKNOSY: KEKSYON
EKKNOSÂ: KONSEKÂ
EKKNTÔÔ: KÔKÔNET
EKKSSÂÔ: KÔSEKÂS
EKKSÂÊÔ: ÊKÔSEKÂ
EKLLNOO: KOLONEL
EKLMPÂÔ: KÔPLEMÂ
EKLNOOS: KONSOLE
EKLOPTÔ: KÔPLOTE
EKLOTWÔ: KÔTWOLE
EKLPTYÔ: PÔKTYEL
EKLPTÊÔ: ÊKÔPLET
EKMMTÂÂ: KETMÂMÂ
EKMNOPT: PONMKET
EKMNOPÔ: MÔKONPE
         MONKÔPE
EKMNOSÂ: KONMÂSE
         KONMESÂ
EKMNOTÂ: MEKONTÂ
EKMNSÔÔ: KÔSÔMEN
EKNOOPT: KONPOTE
EKNOOPZ: KONPOZE
EKNOORT: OKONTRE
EKNOPRS: KONPRES
EKNOSSY: SEKSYON
EKNOSSÂ: KONESÂS
EKNSSÂÔ: KÔNESÂS
EKNSYÂÔ: ENKÔSYÂ
EKNSYÊÔ: KESYÔNÊ
EKNTÇÛÛ: ÇÛKÛNET
EKOOPTW: PEKTOWO
EKOOPVW: PWOVOKE
EKOPSYÔ: ESKOPYÔ
EKOPSZÂ: EKSPOZÂ
EKPRSÂÔ: REKÔPÂS
EKPTYÔÛ: KÔPYÛTE
EKPTÂÊÔ: ÊKÔPETÂ
EKRRTÂÔ: RÂKÔTRE
EKRSTÂÔ: KÔSÂTRE
EKVYÂÊÔ: ÊKÔVEYÂ
ELMPSÂÊ: SÊPLEMÂ
ELMSVÂÛ: SÛLEVMÂ
ELNOOPZ: POLONEZ
ELNOOTV: VOLONTE
ELNOSSÂ: ENSOLÂS
ELORSTÂ: TOLERÂS
EMMTVÂÛ: MÛVMÂTE
EMNNORÊ: RENONMÊ
EMNNOTY: TYEMONN
EMNNPWÔ: PWÔMNEN
EMNOOPZ: MENOPOZ
EMNOOSY: EMOSYON
EMNOPSW: PWONMES
EMNOPTW: PWONMET
EMNRTÂÂ: ÂTRENMÂ
EMNRZÂÔ: REZÔNMÂ
EMOSTZÔ: MOTSEZÔ
EMOSWYÂ: WOMÂSYE
EMPRSÂÂ: ÂPRESMÂ
EMRSSÂÂ: RESÂSMÂ
EMRSYÂÂ: RÂSEYMÂ
EMRTTYÂ: TRÂTYEM
ENNNOPY: PYONNEN
ENNOPSW: PWENSON
ENNOPWW: WONPWEN
ENNOSZÊ: SEZONNÊ
ENNOTÇÔ: TOÇÔNEN
ENNPPÊÊ: PENPÊNÊ
         PÊPÊNEN
         PÊPENNÊ
ENNPTÂÔ: TÂPÔNEN
ENNTÂÇÔ: ÇÂTÔNEN
ENOOWYZ: EWOZYON
ENOPRSY: PRESYON
ENOPSTÂ: ENPOTÂS
ENOPSVW: PWOVENS
ENOPSYÂ: PÂSYONE
ENOPTTW: TWONPET
ENORSZÂ: REZONÂS
ENPRSVÂ: PREVNÂS
ENPTTÂÇ: ÂÇTPENT
ENRRSTÊ: RESTRÊN
ENSTYÂÔ: ENTÂSYÔ
ENSVYÂÔ: ENVÂSYÔ
ENTTÇÇÊ: TÇENTÇÊ
         TÇÊTÇEN
ENVVYYÊ: VYENVYÊ
         VYÊVYEN
EOOPPWZ: PWOPOZE
EOPRSYÔ: OPRESYÔ
EOPSSYÔ: POSESYÔ
EOPSTTÂ: POTESTÂ
EOPTYYÊ: ETYOPYÊ
EORRSTÂ: RESTORÂ
EPRSSTÂ: PRESTÂS
EPRSYÊÔ: ÊPRESYÔ
FFILOOZ: FILOZOF
FFIOTYÂ: FOTIFYÂ
FGINNOR: GRIFONN
FGINRÊÔ: GRIFÔNÊ
FGLNOOÂ: ÂGLOFON
FGNNOÊÛ: FÛGONNÊ
FIIIKRS: KRISIFI
FIIILSS: SIFILIS
FIIKNOT: KONFITI
FIIMNSÂ: FINISMÂ
FIIOPTZ: POZITIF
FIISYZÊ: FIZISYÊ
FIKLMOO: KOMILFO
FIKMNOÊ: KONFIMÊ
FIKORST: KRISTOF
FIKRSYÔ: FRIKSYÔ
FIKYZÔÔ: KÔFIZYÔ
FILNOOZ: ZILOFON
FILSYÂÊ: ÊFLIYÂS
FIMNSÂÂ: FINÂSMÂ
FINNOÇÊ: ÇIFONNÊ
FINRSÊÔ: FRISÔNÊ
FIRSYÂÔ: FRÂSIYÔ
FKLNOOY: KONFYOL
FKLOOYÔ: KÔFYOLO
FKNNNOO: KONFONN
FKNOSYÂ: KONFYÂS
FKNOSYÔ: FÔKSYON
         FONKSYÔ
GGILYÂÔ: GÂGLIYÔ
GGLNOOO: GONGOLO
GGMNOWÂ: GWOGMÂN
GGNOPÔÔ: PÔGÔGON
         PÔGONGÔ
         PONGÔGÔ
GGNRÂÊÊ: GÂGRÊNÊ
GIINOTY: GIYOTIN
GIKKNOO: KIKONGO
GIKLOOR: KORIGOL
GIKLOTÂ: KOLÂGIT
GILNOOP: POLIGON
GILNSÂÔ: LÔGÂNIS
GINNOYÊ: GIYONNÊ
GINORZÊ: GRIZONÊ
GINOTYÂ: TIYOGÂN
GINRZÊÔ: GRIZÔNÊ
GKKNOOO: GONOKOK
GKLNOOO: KONGOLO
GKNNOTÛ: KONNGÛT
GKNOTTÛ: KONTGÛT
GMMNOÂÊ: MÂGONMÊ
GMMNOÊÔ: MÔGONMÊ
         MONGÔMÊ
GOOOPPW: GWOPOPO
IIIJKLT: LITIJIK
IIIJMNP: MINIJIP
IIIKPRS: PIKIRIS
IIIKRTÇ: ÇIKRITI
IIILLMT: MILILIT
IIINSTZ: SINIZIT
IIIPPRT: PIPIRIT
IIIPRTÇ: ÇIRIPIT
IIIPTTT: TIPITIT
IIIRTZZ: ZIZIRIT
IIJLSVÂ: VIJILÂS
IIJRYÇÊ: ÇIRIJYÊ
IIJSSTÊ: ÊJISTIS
IIKLOPT: POLITIK
IIKNNOT: NIKOTIN
IIKNOSS: SIKONSI
IIKNPSÂ: PÂNISIK
IIKOPRT: IPOKRIT
IIKORST: ISTORIK
IILLOTT: TILOLIT
IILMMZÂ: MIZILMÂ
IILMNOT: MILITON
IILMSYÊ: MILISYÊ
IILNOSW: SIWOLIN
IILNOYZ: ILIZYON
IILOPPS: POPILIS
IILPPSÔ: PÔPILIS
IILSTTÂ: SÂTILIT
IIMNNOS: SINONIM
IIMNSYÔ: MINISYÔ
IIMOPST: OPTIMIS
IIMPRRÊ: ÊPRIMRI
IIMSYZÊ: MIZISYÊ
IINPSTÂ: PISÂNIT
IINPSYÔ: PINISYÔ
IINRSTÛ: TINÛRIS
IINRTYÂ: NITRIYÂ
IIRSSTÂ: SITIRÂS
IIRSTTÛ: TISÛRIT
IKKNORÂ: KONKIRÂ
IKKRSÂÔ: KÔKIRÂS
IKLMOZÂ: KÂMIZOL
IKLMPÂÔ: KÔPLIMÂ
IKLNOOR: KOLORIN
IKLOYZÔ: KOLIZYÔ
IKLTTÛÛ: TIKÛLÛT
IKMNOYÊ: KOMINYÊ
IKMNOYÔ: KOMINYÔ
IKMNYÔÔ: KÔMINYÔ
IKMOPTÂ: PIKOTMÂ
IKMOSYÔ: KOMISYÔ
IKMOTWÂ: WOMÂTIK
IKNNOTÂ: KONTINÂ
IKNOOPW: KOWONPI
IKNOOTZ: KOTIZON
IKNOPTÊ: NÊPOTKI
IKNOSTW: KONSTWI
IKNOSTÂ: KONSÂTI
IKNPÂÇÊ: PIÇKÂNÊ
IKOOPRT: POTORIK
ILMNOOP: POLINOM
ILNNOPÊ: PILONNÊ
ILOOSWY: WOSIYOL
ILOPSYÔ: POLISYÔ
ILORSYÂ: LIYORÂS
ILOSSYÔ: SOLISYÔ
IMMOSVÂ: VOMISMÂ
IMMSVÂÔ: VÔMISMÂ
IMNNOYÊ: MIYONNÊ
IMNOOOT: OTONOMI
IMRSTÂÊ: ÊSTRIMÂ
INNOOPY: OPINYON
INNOSTV: TONNVIS
INNOVWÊ: VIWONNÊ
INOOPSZ: SIPOZON
INOOSSS: SOSISON
INOPRTW: TWONPRI
INOPYÂÇ: ÇÂPIYON
INORSYÂ: INYORÂS
INOSTWÊ: SÊTIWON
INOVWZÂ: ZÂVIWON
IOPSYZÔ: POZISYÔ
IORSTYÊ: ISTORYÊ
IORSVÇÛ: ÇOVSÛRI
IORTYÇÊ: OTRIÇYÊ
IOVWZÂÔ: OZÂVIWÔ
IPSYZÂÛ: PÂZÛYIS
KKLOOSW: KLOWOKS
KKLOOTÊ: KOLOKÊT
KKMNNOO: KONKONM
KKMOOOY: KOMOKOY
KLMOOOY: MOLOKOY
KLNOOTW: KONTWOL
KLOOOSW: KOWOSOL
KLOOOWÇ: KOLOWOÇ
KMMNOÔÔ: MÔKÔMON
         MÔKONMÔ
         MONKÔMÔ
KMMOSÂÂ: KOMÂSMÂ
KMNNNOO: MONNONK
KMNOSÊÔ: KONSÔMÊ
         KÔSONMÊ
KMOOOYY: MOYOKOY
KMOPTÂÔ: KÔPOTMÂ
KMSTÂÂÔ: KÔSÂTMÂ
KMTTÂÂÔ: KÔTÂTMÂ
KNNOPRÂ: KONPRÂN
KNOOPZÂ: KONPOZÂ
KNOPWYÛ: KWÛPYON
KNOSYÂÊ: ÊKONSYÂ
KOOOPSW: OWOSKOP
KOOWYZÔ: KOWOZYÔ
KSSYÂÊÔ: ÊKÔSYÂS
LLOOOWY: WOLOLOY
LNOPTÊÔ: PLOTÔNÊ
MMNOTTÔ: TÔMTONM
         TONMTÔM
MNNOOPP: PONPONM
MNNOPWÊ: PWONMNÊ
MNOPWÊÊ: PWOMÊNÊ
MNPWÊÊÔ: PWÔMÊNÊ
MNTVÂÊÊ: VÂTMÊNÊ
NNOOTÇÊ: TOÇONNÊ
NNOPTÂÊ: TÂPONNÊ
NNOTÂÇÊ: ÇÂTONNÊ
NOSTYÂÊ: ÊTÂSYON
NOSVYÂÊ: ÊVÂSYON
NYZZÊÔÔ: ZÔZÔNYÊ
