AAABDENS: ANBASADE
AAABDKRÛ: BARAKÛDA
AAABDLMN: DANMBALA
AAABDNRS: ANBRASAD
AAABEKLR: KARABELA
AAABEKRÇ: KARABAÇE
AAABENRS: ANBARASE
AAABJLNS: ASANBLAJ
AAABKLLÂ: ÂBALAKAL
AAABKMNN: ANBAKMAN
AAABKNNR: KARABANN
AAABLNSW: BALANSWA
AAABMMNY: MAYANMBA
AAABNNTV: ANBAVANT
AAABNRSÂ: ÂBARASAN
          ANBARASÂ
AAADGLNV: LAVANGAD
AAADGLPW: LAGWADAP
AAADKLMN: MAKANDAL
AAADKMNR: KANMARAD
AAADKMRS: MASKARAD
AAADLMTW: MALADWAT
AAAEJNTV: AVANTAJE
AAAEKRVÇ: KARAVAÇE
AAAELMWY: AMWALAYE
AAAGJMNN: ANGAJMAN
AAAGKKLS: KAKAGLAS
AAAGLNPY: GALAPYAN
AAAGMNNN: ANGANMAN
AAAGNPPR: GRANPAPA
AAAIKNTW: ANAKAWIT
AAAIKNTY: ANAKAYIT
AAAILNTZ: ATIZANAL
AAAILPPS: PASIPALA
AAAIMMZZ: MAZIMAZA
AAAIMNRW: MARIWANA
AAAINSSY: ASASINAY
AAAIPPTT: PATIPATA
AAAJKKKO: KAKAJAKO
AAAJMNNR: ARANJMAN
AAAKLPST: KATAPLAS
AAAKLSSS: LASKASAS
AAALNNRT: ALANTRAN
AAALNOTT: ALATATON
AAALNPRS: LAPARANS
AAALNPRT: ALATRANP
AAALNPST: PLASANTA
AAALOPPT: ALAPAPOT
AAAMMNNN: AMANNMAN
AAAMNNSV: AVANSMAN
AAAMOPPR: PAPARAMO
AAANNNNP: ANPANNAN
AAANNNNZ: ZANNANNA
AAANNNSV: ANNAVANS
AAANNPTZ: ZAPATANN
AAANOPRY: PARANOYA
AAANRTVY: TRAVAYAN
AABBDIOY: BOBADIYA
AABBDMNÔ: BÔBADMAN
AABBILNY: BANBILAY
AABBIMNO: ABOMINAB
AABBKSTÛ: BÛSTABAK
AABDDEEK: DEBAKADE
AABDDEFN: DEFANDAB
AABDDENY: DEBANDAY
AABDEERS: DEBARASE
AABDEGRÂ: ÂDEGRABA
AABDEKLN: KANDELAB
AABDEKMN: DEBAKMAN
AABDELNY: ANDYABLE
AABDEMNT: DEBATMAN
AABDENNO: ABANDONE
AABDIKNS: ANBISKAD
AABDILSY: ALSIBYAD
AABDNNOS: ABONDANS
AABDNNOÊ: ABANDONÊ
AABDNOSW: BWOSADAN
AABEEKRR: KAREBARE
AABEGLWY: GWAYABEL
AABEIKRT: KABIRATE
AABEILNR: BALERINA
AABEJKSÛ: BAJÛKASE
AABEJMTÂ: TABAMÂJE
AABEJNRY: ANBREYAJ
AABEKNWY: ENKWAYAB
AABEKPST: AKSEPTAB
AABELLNN: LABALENN
AABELNRS: RASANBLE
AABEMNOÇ: ABONMAÇE
AABEPRSY: APRESYAB
AABFNRWZ: FRANBWAZ
AABGHNNR: BRANHANG
AABIJNST: JANBATIS
AABIKKLS: KALBASIK
AABIKNRY: KRABINAY
AABIKRRÂ: ARÂBARIK
AABILNNS: ANBILANS
          BALANSIN
AABILRTV: BATRAVIL
AABIMNST: BATISMAN
AABISTYÔ: ABITASYÔ
AABKLNTÂ: BATÂKLAN
          BATANKLÂ
AABKLOSW: KWABOSAL
AABKLTWÛ: BLAKAWÛT
AABKNOOW: KAWONABO
AABKNTYÛ: BÛKANTAY
AABLMNNÔ: BALÔNMAN
AABLNNPT: PLATBANN
AABMNNZÂ: BANZÂMAN
          BANZANMÂ
          BÂZANMAN
AABMNPYÛ: MAPYANBÛ
AABMRSÂÂ: ÂBARASMÂ
AABNNNWÊ: BWANANNÊ
AABNNOWY: BAYAWONN
AABRSTYÊ: BATRASYÊ
AADDEETW: ETADEDWA
AADDEGNR: DEGRADAN
AADDEKNS: DEKADANS
AADDJJNN: DJANDJAN
AADDNNRR: DRANDRAN
AADDNNYY: DYANDYAN
AADEEJKK: KADEJAKE
AADEEJPT: DEPATAJE
AADEFIMT: DIFAMATE
AADEGJMN: GADMANJE
AADEGMNN: ANMEGDAN
AADEGNRY: GRENADYA
AADEIKKM: AKADEMIK
AADEIKNP: ANDIKAPE
AADEIMRT: ADMIRATE
AADEJNNR: ANJANDRE
AADEJNPT: DJETAPAN
AADEKLNS: ESKANDAL
AADEKLNV: VALKANDE
AADEKLRT: KATEDRAL
AADEKNNY: KANADYEN
AADELMNN: LADEMANN
          MANNDELA
AADELNOS: ADOLESAN
AADELNST: LADESANT
AADEMNPT: DEPATMAN
AADENTYZ: ANTDEZAY
AADFMNNÂ: FÂDANMAN
          FANDÂMAN
          FANDANMÂ
AADGINTV: DATIGNAV
AADGLNOY: DYAGONAL
AADIJKNÔ: ADJANIKÔ
AADIJMNN: DANMIJAN
AADIJMNR: JANDAMRI
AADIKNYÔ: ADYANIKÔ
AADIMNNR: MANDARIN
AADIMNPR: RAPIDMAN
AADIMNPT: PIMANTAD
AADIMNZÇ: MAÇANDIZ
AADINNRS: ANDIRANS
AADINNRT: DIRANTAN
AADINPPY: DAPIYANP
AADINSTV: ADVANTIS
AADINSWZ: SWADIZAN
AADJMMNO: DOMAJMAN
AADJMNNZ: DJAZMANN
AADKMNNO: KOMANDAN
AADKMNNÔ: KÔMANDAN
AADKOPRS: PARADOKS
AADLMNRÊ: MALANDRÊ
AADMNNOS: DASOMANN
AADMNNSÔ: ADANMSÔN
AADNNTÂÂ: ÂNATÂDAN
          ÂNATANDÂ
          ANNATÂDÂ
AADNRSYÎ: RANDÎSAY
AADOPRSY: DYASPORA
AADORSYÔ: ADORASYÔ
AAEEFNRY: ARYENAFE
AAEEKLSZ: ALKASEZE
AAEELNTT: ALTENATE
AAEELNTW: ANETWALE
AAEFKNNN: ANFANNKE
AAEFLMNZ: MALFEZAN
AAEFLNNT: NAFTALEN
AAEFMNPT: PAFETMAN
AAEFMNSY: FAMASYEN
AAEFNNNT: ANFANTEN
AAEFNRYÛ: ANFÛRAYE
AAEGGNNN: GAGANNEN
AAEGINTV: NAVIGATE
AAEGJNNR: ANGRENAJ
AAEGKLOT: KATALOGE
AAEGLLRT: LAGRATEL
AAEGNTWZ: WANGATEZ
AAEIJRST: ATERISAJ
AAEIKLNV: EKIVALAN
AAEIKPST: KAPASITE
AAEILMNT: ALIMANTE
AAEILPRV: PALAVIRE
AAEILPRZ: PARALEZI
          PARALIZE
AAEILRTÇ: LAÇARITE
AAEIMNYZ: MAYIZENA
AAEINNTY: ANEYANTI
AAEINPST: APETISAN
AAEINRTV: AVANTIRE
AAEIPRST: ASPIRATE
AAEIRSTY: ATERISAY
AAEJKLSV: ESKLAVAJ
AAEJKNRÛ: ANKÛRAJE
AAEJLMSÂ: SALAMÂJE
AAEKLNNS: ALEKSANN
AAEKLNOS: ALEKONSA
AAEKLNSV: VALKANSE
AAEKLNSY: AKANSYEL
AAEKLSVY: ESKLAVAY
AAEKMNNP: PAKEMANN
AAEKMNRS: SAKREMAN
AAEKNNWY: ENKWAYAN
AAEKNOPY: AKONPAYE
AAEKNPRY: PANKREYA
AAELMNNT: LANTEMAN
AAELMNPT: PALMANTE
AAELMNVY: MALVEYAN
AAELMSTY: MATLASYE
AAELNNTY: LATANYEN
AAELNPST: PLASENTA
AAELNPTT: PANTALET
AAELNPWY: ANPLWAYE
AAELNVZÛ: ALEVÛZAN
AAELPSTW: PATASWEL
AAELRTTY: TEYATRAL
AAEMNNPS: PEMANANS
AAEMNNPT: PEMANANT
AAEMNNPÇ: ANPEÇMAN
AAEMNNSY: ANSEYMAN
AAEMNPYÊ: PANAMEYÊ
AAEMNSTT: TESTAMAN
AAEMNSZÔ: ASEZÔMAN
AAEMTWYY: TEMWAYAY
AAENNNPP: ANPENPAN
AAENNPSY: ENPASYAN
AAENNRTT: ANTRETAN
AAENOSYZ: ASEZONAY
AAENPRTZ: PARANTEZ
AAENPSTY: SAPANTYE
AAENPTYÇ: ÇAPANTYE
AAENRVWY: RANVWAYE
AAFFIIMT: AFIMATIF
AAFGILLN: FILALANG
AAFGMNOR: GRANFOMA
AAFIKLST: LAKSATIF
AAFIKNNT: FANNATIK
AAFILLMY: FAMILYAL
AAFILMNN: FINALMAN
AAFIMSYÔ: AFIMASYÔ
AAFINNNT: ANFANTIN
AAFINSYY: FIYANSAY
AAFKLMYÛ: KAMÛFLAY
AAFLNNOT: LAFONTAN
AAFMNNRÇ: FRANÇMAN
AAFMNRSÔ: FRANMASÔ
AAFMNTWÔ: AFWÔTMAN
AAFNNNSÂ: ÂNANFANS
          ANNÂFANS
          ANNANFÂS
AAFNRTYÊ: FARÊNAYT
AAGIJPRY: GRAPIYAJ
AAGIJPSY: GASPIYAJ
AAGIKLNN: ANGLIKAN
AAGIKLPS: PIKAGLAS
AAGIKNOT: KITANAGO
AAGILNRT: GALANTRI
AAGILNTÇ: LANGIÇAT
AAGILPSW: LASIGWAP
AAGIMNOW: MAWOGANI
AAGINRTÇ: GANTRIÇA
AAGIPSYY: GASPIYAY
AAGKRSVÂ: AKSÂGRAV
AAGLMTYÔ: MALATYÔG
AAGMNNYÛ: MANGÛYAN
AAGMNOYZ: ZOMANGAY
AAGMNRTÊ: GRANMATÊ
AAGNPRRÂ: GRANPARÂ
          GRÂPARAN
AAIILNSV: AVILISAN
AAIJKMYÊ: JAMAYIKÊ
AAIJMNNT: JANTIMAN
AAIJMNPS: MASPINAJ
AAIJMRST: MAJISTRA
AAIJNVWZ: VWAZINAJ
AAIJSTYÔ: AJITASYÔ
AAIKKMST: KASKAMIT
AAIKLLSÇ: ÇALKALIS
AAIKLMMÂ: AMIKALMÂ
AAIKLNTT: ATLANTIK
          TANTAKIL
AAIKLOPT: KATAPOLI
AAIKLTVW: LAVIKTWA
AAIKNPRT: PRATIKAN
AAIKSYZÔ: AKIZASYÔ
AAILMNNT: LANMITAN
AAILNRTY: LANTIRAY
AAIMNSYÔ: ANIMASYÔ
AAIMNTYZ: ZANMITAY
AAINNRSÊ: ANRASINÊ
AAINNSSÊ: ANSASINÊ
AAINNTTÇ: ÇITATANN
AAINSSST: ASISTANS
AAINVWYZ: VWAZINAY
AAIPRSYÔ: APARISYÔ
AAISSYYÔ: ASIYASYÔ
AAISVYYÔ: AVIYASYÔ
AAJKNNOP: KAPONNAJ
AAJKNPRÔ: KRAPÔNAJ
AAJLMNSÛ: SÛLAJMAN
AAJLNRTÛ: LANTÛRAJ
AAJNPSTÛ: PÛSANTAJ
AAKKLNRÛ: KARANKLÛ
AAKKLORY: KLOKARYA
AAKKNNNÊ: KANKANNÊ
AAKLMNOS: KALMASON
AAKLNNVÊ: VALKANNÊ
AAKLNPTÛ: KANTALÛP
AAKLNTYÊ: ALYÊNKAT
AAKMMNNO: KOMANMAN
AAKMMNNÛ: KÛMANMAN
AAKMORWY: AKWARYOM
AAKNNNNÂ: KÂNANNAN
          KANNÂNAN
          KANNANNÂ
AAKNNOPY: KAPONNAY
AAKNNRWY: KWARYANN
AAKNPRYÔ: KRAPÔNAY
AAKNSTWÊ: AKWÊTANS
AAKNSTYÛ: SANKÛTYA
AAKNSTÇÛ: SANKÛTÇA
AAKNSYÊÔ: ÊKANASYÔ
AAKRSTYÔ: ATRAKSYÔ
AALMMNWÂ: MÂMANLWA
          MANMÂLWA
AALMNNNY: LANMYANN
AALMNPSÂ: ANPLASMÂ
          ÂPLASMAN
AALMOTYÑ: MALATYOÑ
AALNNOPT: PANTALON
AALNNOSY: NASYONAL
AALNOPTW: PATWONAL
AALNORTY: ORYANTAL
AALNOTZÛ: OZALANTÛ
AALNRTYÛ: LANTÛRAY
AALOOPST: APOSTOLA
AAMMNNSÂ: SÂMANMAN
          SANMÂMAN
          SANMANMÂ
AAMMNNÇÇ: ÇANMÇANM
AAMNNOPT: ANPOTMAN
AAMNNRTÊ: ANTRÊMAN
AAMNNTWÇ: WATÇMANN
AAMNPTWÊ: APWÊTMAN
AAMPRSSY: PRAYSMAS
AANNNOPR: RANPANNO
AANNNORY: ANRANYON
AANNNRTÂ: ÂNANTRAN
          ANNANTRÂ
          ANNÂTRAN
AANNOSSY: ASANSYON
AANNOSTY: ATANSYON
AANNPYÇÔ: ÇANPYÔNA
AANNSTZÂ: SANZATÂN
          SÂZATANN
AANNTTZÂ: TANZANTÂ
          TANZÂTAN
          TÂZANTAN
AANOSSTW: OSTANSWA
AANPRSYÔ: SARANPYÔ
AANPSSYÊ: ÊPASYANS
AANSSSYÔ: SANSASYÔ
ABBDEEYÛ: DEBABÛYE
ABBDENOY: BONBADYE
ABBDMNOÂ: BONBADMÂ
ABBEKLNO: BEKANBOL
ABBEKLOZ: ZABELBOK
ABBINNOÊ: ANBOBINÊ
ABDDEMNO: DEBODMAN
ABDEEIYZ: DEZABIYE
ABDEELNS: SALDEBEN
ABDEELNW: ABDENWEL
ABDEEMNR: DEMANBRE
ABDEENRÇ: DEBRANÇE
ABDEEPSS: DESPABES
ABDEESTT: DETESTAB
ABDEGINR: BRIGANDE
ABDEGIRY: BRIGADYE
ABDEGIRÂ: ÂBRIGADE
ABDEIIST: ABSIDITE
ABDEIKTY: DYABETIK
ABDEINTW: TABDENWI
ABDEIRZÊ: ÊDEZIRAB
ABDEKLLÊ: KALBLÊDE
ABDELNYÛ: BANDÛLYE
ABDELOYZ: DEBLOZAY
ABDEMOYÊ: MAYODEBÊ
ABDEMWZÂ: DEBWAZMÂ
ABDENNNÔ: BANDÔNEN
ABDENNOÂ: ABÂDONEN
ABDEOTWÂ: DEWOTÂBA
ABDGINYÊ: GADYÊNBI
ABDGIRYÂ: BRIGÂDAY
ABDIILMN: MANDIBIL
ABDIJNWÔ: BIDJAWÔN
ABDIJNÊÔ: BADIJÔNÊ
ABDIKLOY: DYABOLIK
ABDILMSÛ: BÛLDIMAS
ABDINSYÔ: BANDISYÔ
ABDIPSWÊ: PWÊDISAB
ABDMNNÔÛ: BÛDÔNMAN
ABDNNNOÊ: BANDONNÊ
ABDOOOYZ: AZOBODOY
ABEEFPRR: PREFERAB
ABEEIKNT: ENKIBATE
ABEEILST: SELIBATE
ABEEKSTZ: BASKETEZ
ABEEKTWY: KABWETYE
ABEELSZÂ: ÂBAZESEL
ABEEMPYÊ: ÊPEMEYAB
ABEFLMSÊ: BLASFEMÊ
ABEFMNNÛ: MANFÛBEN
ABEGLMNO: LAGONMBE
ABEGNOSY: NEGOSYAB
ABEGNRRÑ: GRANBREÑ
ABEIKLOV: VOKABILE
ABEIKNNR: KRABINEN
ABEIKOWY: AYEWOBIK
ABEILNST: SIBALTEN
ABEINNSS: ENSANSIB
ABEINNST: BISANTNE
ABEINOSY: OBEYISAN
ABEINSYZ: ANBISYEZ
ABEINSYÔ: IBENASYÔ
ABEKLNNÔ: KÔBELANN
ABEKMNTÂ: BATMÂNKE
ABEKNNNÛ: BÛKANNEN
ABEKNNOR: ANKONBRE
ABEKNORY: BAKONYER
ABEKRSSÔ: RESKÔSAB
ABELLTÂÇ: LABLÂÇET
ABELMMZÛ: MAZÛMBEL
ABELMNOZ: MAZONBEL
ABELNNNO: BALONNEN
ABELNRVÛ: RENÛVLAB
ABENNTWÇ: BWATÇENN
ABENOSWY: BWASONYE
ABENSTYÂ: ESTÂNBAY
ABEORSSW: BRASEWOS
ABEPRSSÔ: RESPÔSAB
ABEPRTZÂ: PREZÂTAB
ABETYYÂÛ: ÂBÛTEYAY
ABFIILST: FISTIBAL
ABFIOPTW: PWOFITAB
ABFKNOOT: KONFOTAB
ABFLWYÂÂ: FLÂBWAYÂ
ABGGNRRÊ: GRANBRÊG
ABGLLMOÂ: GLOBALMÂ
ABGNNRRÊ: GRANBRÊN
ABIIKLLT: LAKILBIT
ABIIKLST: BALISTIK
ABIIKOTY: ABIYOTIK
ABIILNRT: TRIBINAL
ABIKORTW: BIWOKRAT
ABILMNÂÛ: MÂNIBÛLA
ABILMOSÂ: ABSOLIMÂ
ABILOSYÔ: ABOLISYÔ
ABILSYÂÇ: BLÂÇISAY
ABIMSTÂÛ: ABÛTISMÂ
ABINNORY: ANBRIYON
ABINNOSY: ANBISYON
ABINOSTY: BITASYON
ABIOPSTÊ: ÊSIPOTAB
ABIRSVYÔ: VIBRASYÔ
ABITTVÂÂ: ÂBATIVÂT
ABKLOSÊÔ: ÊKÔSOLAB
ABKLSTÂÊ: SALTÊBÂK
ABKNNNOW: KANBWONN
ABKOOTYY: BOYKOTAY
ABLLNNÂÇ: BLÂÇLANN
          BLANÇLÂN
ABLMNNOÂ: BALONNMÂ
ABLOOOTÇ: ABOLOTÇO
ABNNOOTW: TOWOBANN
ABNOOOTÇ: ABONOTÇO
ADDEEJMO: DEDOMAJE
ADDEIILP: DILAPIDE
ADDEINPR: DEPRADIN
ADDEINRV: VANDREDI
ADDEJMOO: JAMEDODO
ADDEMOOY: DODOMEYA
ADDENPÂÊ: ÊDEPÂDAN
          ÊDEPANDÂ
ADDENSSÂ: DESÂDANS
          DESANDÂS
ADDERTWÂ: DWADÂTRE
ADDIIKKT: DIDAKTIK
ADDIINNV: DIVIDANN
ADDIKNTÂ: DIKDANTÂ
          DIKDÂTAN
ADEEELPR: REPEDALE
ADEEFIMP: PEDEFAMI
ADEEFLNZ: DEZANFLE
ADEEFMNY: DEMEFYAN
ADEEFMZÔ: MEZÔDAFE
ADEEGLMO: MODELAGE
ADEEGLNS: DESANGLE
ADEEIKMY: DEMAKIYE
ADEEIKNT: ENDIKATE
ADEEIKPT: DEKAPITE
ADEEIKRT: AKREDITE
ADEEIKTY: DEKATIYE
ADEEILVZ: DEVALIZE
ADEEINRS: DERASINE
ADEEINST: DESINATE
ADEEIPYZ: DEZAPIYE
ADEEISTV: ADVESITE
ADEEJKRÛ: DEKÛRAJE
ADEEJNRÇ: DEREÇANJ
ADEEKLNN: DELENKAN
ADEEKLNÇ: DEKLANÇE
ADEEKLSÂ: ESKÂDALE
ADEELMNN: LANDEMEN
ADEELMNT: DEMANTLE
ADEELMWZ: DEMWAZEL
ADEELNNY: LADENNYE
ADEELNYÇ: ÇANDELYE
ADEEMMSY: MESYEDAM
ADEEMMZÂ: DEZAMEMÂ
ADEEMNNN: NANDEMEN
ADEEMORT: MODERATE
ADEEMTWY: DEMWATYE
ADEENNNP: DEPANNEN
ADEENNOT: ETANDONE
ADEENNSS: ENDESANS
ADEENRTV: DEVANTRE
ADEENRVZ: REVANDEZ
ADEENVYÂ: AVÂDENYE
ADEEPRZÂ: DEZÂPARE
ADEEPSWZ: DEZESPWA
ADEFIIKT: EDIKATIF
ADEFIINP: DEPAFINI
ADEFIJKT: ADJEKTIF
ADEFIMRÂ: DIFERAMÂ
ADEFINRS: DIFERANS
ADEFINRÊ: ÊDIFERAN
ADEFLOSV: VOLDEFAS
ADEFNNOR: ANFONDRE
ADEFWYÂÛ: ÂFÛDWAYE
ADEGGMTÂ: GADMÂTEG
ADEGGNÂÊ: DEGAGÂNÊ
ADEGIJMO: DEMAGOJI
ADEGIJOP: PEDAGOJI
ADEGINNR: GRENADIN
ADEGINRZ: GRANDIZE
ADEGNRYÊ: ÊGREDYAN
ADEGNSTÛ: DEGÛTANS
ADEGOTWÇ: DWATEGOÇ
ADEGTTWÛ: TWADEGÛT
ADEIILPR: EPIDIRAL
ADEIIMPR: APREMIDI
ADEIINTT: IDANTITE
ADEIIPRT: RAPIDITE
ADEIJLNS: DELIJANS
ADEIJMNN: DEMIJANN
ADEIJNNS: ENDIJANS
ADEIJNSV: DIVEJANS
ADEIKKLS: KILDESAK
ADEIKLMO: LAKOMEDI
ADEIKMMÂ: MEDIKAMÂ
ADEIKMNS: MISKADEN
ADEIKNST: TANDISKE
ADEIKSTÂ: AKSIDÂTE
ADEIKSYÔ: EDIKASYÔ
ADEILMNÇ: LEDIMANÇ
ADEILMPP: PALMIPED
ADEILPTW: PIDETWAL
ADEIMNNÔ: AMIDÔNEN
ADEINNPR: ENPRIDAN
ADEINOSY: ADISYONE
ADEINPRZ: PREZIDAN
ADEINPSS: DISPANSE
ADEINRSY: SANDRIYE
ADEIPRST: DISPARET
ADEIPRTY: PEDYATRI
ADEIRVYZ: DRIVAYEZ
ADEJLOPV: DJOLPAVE
ADEKLNSÊ: DELÊKANS
ADEKMNNO: KONMANDE
ADEKMNOÊ: DEMAKONÊ
ADEKMORT: DEMOKRAT
ADEKMRÂÂ: ÂKADREMÂ
ADEKNNOS: KONDANSE
ADEKNOOY: AKODEYON
ADEKNOSY: DYAKONES
ADELMNRÂ: MALÂDREN
ADELMNWÛ: DEWÛLMAN
ADELMPSÂ: DEPLASMÂ
ADELNOPY: PLENYADO
ADELNOSY: DOLEYANS
          LODYANSE
ADELOPYZ: DEPLOZAY
ADELOSSÂ: ADOLESÂS
ADEMNNNO: ANDENMON
ADEMNNTÛ: DETÛNMAN
ADEMNPYÛ: DEPÛYMAN
ADEMORTY: RADYOMET
ADEMRYÊÊ: AMERÊDYÊ
ADENNNOP: PADONNEN
ADENNTTÊ: TENTÊNAD
          TÊTENNAD
ADENOPTV: DEVANPOT
ADENSTYÔ: DETANSYÔ
ADFIIKTÊ: ÊDIKATIF
ADFIKNNO: KONFIDAN
ADFIKNSÔ: KÔFIDANS
ADFIOPWÔ: APWOFÔDI
ADFLMÂÂÂ: ÂMALDÂFÂ
ADFNOSYÔ: FÔDASYON
          FONDASYÔ
ADGIMNZÛ: GÛMANDIZ
ADGINNRÊ: GRÊNADIN
ADGIRSTÂ: SÂTIGRAD
ADGNORYZ: GRANDYOZ
ADIIJLNS: DILIJANS
ADIILNPT: ANPLITID
ADIILORT: IDOLATRI
ADIINRST: DISANTRI
ADIINRTV: VIDIRANT
ADIIPSTÊ: APÊDISIT
ADIJLNTÛ: TIJÛDLAN
ADIJMNNÂ: DÂMIJANN
          DANMIJÂN
ADIKMOOZ: KAZIMODO
ADIKNNOR: ANDOKRIN
ADIKPPYÂ: DAPPIYÂK
ADIKSYÊÔ: ÊDIKASYÔ
ADIKSYÔÔ: AKÔDISYÔ
ADILMNNO: LANMIDON
          LIMONNAD
ADILMOPT: DIPLOMAT
ADILNOTZ: ZANDOLIT
ADIMNNOS: DOMINANS
ADIMNNOÊ: AMIDONNÊ
ADIMNNRÊ: MANDRINÊ
ADIMNOSY: ADMISYON
ADIMNSTÛ: TÛDISMAN
ADIMNSYÔ: DIMANSYÔ
ADIMNÇÊÔ: MADIÇÔNÊ
ADIMSWÂÔ: AWÔDISMÂ
ADINORVY: IDRAVYON
ADINOSTW: SITWONAD
ADINPRSÊ: ÊPRIDANS
ADINRSYÔ: SANDRIYÔ
ADINSTYÔ: DANTISYÔ
ADINSYÔÔ: INÔDASYÔ
ADIPPPYÂ: DAPPIYÂP
ADISYYÊÔ: ÊDIYASYÔ
ADKKTYÛÛ: DYAKÛKÛT
ADKMMNOÂ: KOMÂDMAN
          KOMANDMÂ
ADKMNNOÂ: KONMÂDAN
          KONMANDÂ
ADKMNNOÛ: DÛKOMANN
ADKNOOPS: ANDOSKOP
ADLMNNÂÊ: NÂLANDMÊ
          NANLÂDMÊ
ADLMOPWÊ: PALÊDWOM
ADMNNOSÂ: ADÂMSONN
ADNNOOSY: DONASYON
ADNOOPSY: ADOPSYON
ADNPSTÂÂ: PÂDANSTÂ
          PÂDÂSTAN
          PANDÂSTÂ
AEEEGLNS: SENEGALE
AEEEJKRZ: EKZAJERE
AEEEJNRT: JENERATE
AEEEKLRS: AKSELERE
AEEEKRST: EKSETERA
AEEEKTYZ: EKZEYATE
AEEELMNT: ELEMANTE
AEEELNRT: ALENTERE
AEEESSTZ: ASETSEZE
AEEFIRST: AFRESITE
AEEFKKLW: KELKEFWA
AEEFKLMT: MALFEKTE
AEEFKNRT: FREKANTE
AEEFKRRT: REFRAKTE
AEEFLNRT: FRATENEL
AEEFMNOT: ENFOMATE
AEEFOPRT: PEFORATE
AEEGIPST: ESPAGETI
AEEGLMNR: REGLEMAN
AEEGLMRT: TELEGRAM
AEEIKLPS: ESKAPILE
AEEIKMNR: AMERIKEN
AEEILNPT: PENALITE
AEEILRTV: LAVERITE
AEEILRTY: ELATRIYE
          REYALITE
AEEILRYZ: REYALIZE
AEEIMMTT: EMATIMET
AEEIMNPS: EMANSIPE
AEEIMNRT: NIMERATE
AEEIMNTT: MATENITE
AEEINRTV: ANVERITE
AEEINSTZ: ANESTEZI
AEEJKLTÔ: KÔJELATE
AEEJLNRT: LETRANJE
AEEJLNRY: ALJERYEN
AEEJLNRÂ: ÂJENERAL
AEEJLRTÂ: ALETRÂJE
AEEJNNRS: ENJERANS
AEEKKLSW: KELKESWA
AEEKKPST: ESPEKTAK
AEEKLNSS: EKSELANS
AEEKLORT: ELEKTORA
AEEKMNSW: AMWENSKE
AEEKMOST: ESKAMOTE
          ESTOMAKE
AEEKMSTÔ: ESTÔMAKE
AEEKNRTV: KATREVEN
          VENKATRE
AEEKNSTY: ANKSYETE
AEEKRSTV: RESTAVEK
AEELMNRY: REYELMAN
AEELMORY: AMELYORE
AEELMRTT: MALTRETE
AEELNPRY: ENPERYAL
AEELNPTZ: PLEZANTE
AEELNSSY: ESANSYEL
AEELNSTW: SENTELWA
AEELNSYZ: SALEZYEN
AEELPSSY: ESPESYAL
AEELRTYÊ: ALÊTERYE
AEELSVYÔ: ELEVASYÔ
AEEMMNOT: ANEMOMET
AEEMNNSS: SENSEMAN
AEEMNNST: ESTAMENN
AEEMNSTÇ: MEÇANSTE
AEENNNNÇ: ANÇENNEN
AEENNPZÇ: ÇENPANZE
AEENNRYZ: ZARENYEN
AEENNSZÔ: ASEZÔNEN
AEENPRSS: ESPERANS
AEENPRTZ: PREZANTE
AEENPSTY: SEPANTYE
AEENRSTÊ: ÊTERESAN
AEENTVVY: VATEVYEN
AEFGJORY: JEYOGRAF
AEFGLMNÔ: GÔFLEMAN
AEFGNRYÛ: GRAFÛYEN
AEFIIKST: SETIFIKA
AEFIILST: FASILITE
AEFIIPRT: APERITIF
AEFIJNRW: JWIFERAN
AEFIKLSY: KLASIFYE
AEFIKNRY: ENFRAYIK
AEFIKRRT: FRAKTIRE
AEFIKRSY: SAKRIFYE
AEFILMOT: FOMALITE
AEFILNPY: PLANIFYE
AEFILSTV: FESTIVAL
AEFINNRT: ENFANTRI
AEFINRSZ: FRANSIZE
AEFINRYZ: FARIZYEN
AEFIORVZ: FAVORIZE
AEFJLLMO: FLAJELOM
AEFKNNOS: KANSONFE
AEFKNOSY: AFEKSYON
AEFLNNPÔ: PLAFÔNEN
AEFLNSYÔ: ENFLASYÔ
AEFLOSTV: VOLTEFAS
AEFLTWYÔ: LAFWÔTYE
AEFPTWWÛ: WATEPWÛF
AEGGNNNR: GANGRENN
AEGGNOYZ: GANGOZYE
AEGIJLNN: NEGLIJAN
AEGIJNSZ: EGZIJANS
AEGIKORT: KATEGORI
AEGIKSTÂ: AKSÂTEGI
AEGILLMÂ: ILEGALMÂ
AEGILMNY: MANGLIYE
AEGIMNNT: MANNIGET
AEGIMNRS: GRANMESI
AEGIMNZÊ: EGZAMINÊ
AEGIMRSY: GRIMASYE
AEGINRRÇ: GRANÇIRE
AEGJMNRÂ: GRÂMANJE
          GRANMÂJE
AEGJNNOÇ: ÇENANGOJ
AEGKLNOT: KOLANGET
AEGKLNTÛ: KÛLANGET
AEGKNSTZ: GANKSTEZ
AEGLNNNO: GALONNEN
AEGMMNNÔ: MANGÔMEN
AEGMMNTÂ: GETMÂMAN
          GETMANMÂ
AEGMNNVÛ: GÛVENMAN
AEGMNRTÂ: GRÂMATEN
AEGMNRWÊ: MARÊGWEN
          MARENGWÊ
AEGMOPRW: PWOGRAME
AEGMRRYÊ: GRAMERYÊ
AEGNNOPT: PENTAGON
AEGNNOSY: NEGOSYAN
AEGNNRYÔ: GARYÔNEN
AEGNNTVÛ: GÛVENANT
AEGNORSY: AGRESYON
AEIIKLPT: KAPITILE
AEIIKMNT: MATINIKE
AEIIKNTT: ANTIKITE
AEIIKRST: EKARISTI
AEIIKTTV: AKTIVITE
AEIIKTTÇ: AÇITEKTI
AEIILMNP: MANIPILE
AEIILRTT: LITERATI
AEIIMRTT: MATIRITE
AEIIMRTZ: MATIRIZE
AEIIPPST: PATISIPE
AEIJKKSS: JISKASKE
AEIJKLRS: RESIKLAJ
          SAKRILEJ
AEIJKPRS: KREPISAJ
AEIJLLNS: LANJELIS
AEIJLLNV: LEVANJIL
AEIJLNTÊ: ÊTELIJAN
AEIJMNST: JISTEMAN
AEIJMNSY: MAJISYEN
AEIJMORT: MAJORITE
AEIJMSTÂ: AJISTEMÂ
AEIJNSTY: JANTIYES
AEIJRRTY: JERYATRI
AEIKKLLY: KILAKYEL
AEIKKNRY: KENKAYRI
AEIKKORY: RAKOKIYE
AEIKKSTW: KISAKWET
AEIKLLOT: LOKALITE
AEIKLLOZ: LOKALIZE
AEIKLMNS: MASKILEN
AEIKLNOZ: ANKILOZE
AEIKLNPS: EKLANPSI
AEIKLNRT: KLARINET
AEIKLOTW: KILOWATE
AEIKMNST: SEMANTIK
AEIKMNTÔ: KÔTAMINE
AEIKMNZÊ: EKZAMINÊ
AEIKMRST: MASKRETI
AEIKMRTY: KATRIYEM
AEIKNNNR: RIKANNEN
AEIKNNPT: KAPITENN
AEIKNNRT: NEKTARIN
AEIKNNRY: RANKINYE
AEIKNNST: KANNISTE
AEIKPRSY: KAPRISYE
          KREPISAY
AEIKRSST: KRISTASE
AEILMNNV: ANVLIMEN
AEILMNPS: SIPLEMAN
AEILMNST: SITELMAN
AEILMORT: MORALITE
AEILMORZ: MORALIZE
AEILMOTT: MOTALITE
AEILMRST: MILATRES
AEILNPSS: LESPINAS
AEIMNNPS: MASPINEN
AEIMNSSZ: SEZISMAN
AEIMNSTT: SANTIMET
AEIMOSTY: SIYAMETO
AEIMRTTY: MITRAYET
AEIMRTYZ: MITRAYEZ
AEIMSTVÂ: AVETISMÂ
AEINNPST: PENITANS
AEINNRSÂ: ÂRASINEN
AEINNSSÂ: ÂSASINEN
AEINNSSÊ: ENSASINÊ
          ÊSASINEN
AEINNTTY: TITANYEN
AEINNVWZ: VWAZINEN
AEINOTTY: ANTOTIYE
AEINPRSY: REPIYANS
AEINPRTW: PWATRINE
AEINPSST: PESISTAN
AEINRSST: RETISANS
AEINRVWY: IVWARYEN
AEINSTWY: SITWAYEN
AEINTYÇÔ: EÇANTIYÔ
AEIOPRVZ: VAPORIZE
AEIORSTV: VORASITE
AEIOSTTW: ATWOSITE
AEIPRTTÂ: TÂPERATI
AEIPRVWY: PWAVRIYE
AEIRTVWY: TWARIVYE
AEIRTVYÂ: AVÂTIRYE
AEISTYZÔ: EZITASYÔ
AEJKKSSÛ: JÛSKASKE
AEJKLMYÊ: JAKMELYÊ
AEJLMNNÛ: JÛNELMAN
AEJMNORY: JERANYOM
AEJNNOPS: PESONNAJ
AEJNOPSY: ESPYONAJ
AEJSSTYÔ: JESTASYÔ
AEKKNNNÂ: KÂKANNEN
          KANKÂNEN
AEKKNNOR: KONKERAN
AEKKNNOS: KONSEKAN
AEKKNSSÔ: KÔSEKANS
AEKKNSÊÔ: ÊKÔSEKAN
AEKLLSYÂ: LAKÂSYEL
AEKLMNPÔ: KÔPLEMAN
AEKLMOPW: PWOKLAME
AEKLMOST: LESTOMAK
AEKLMTYÂ: AKTYELMÂ
AEKLNNNO: KALONNEN
AEKLNNVÂ: VALKÂNEN
AEKLNOPY: KONPAYEL
AEKMMNTÂ: KETMÂMAN
          KETMANMÂ
AEKMNNNO: MAKONNEN
AEKMNNOS: KONMANSE
          KONMESAN
AEKMNNOT: MEKONTAN
AEKMNOTY: KAMYONET
AEKMOTYZ: KATOZYEM
AEKMRTYÂ: KARÂTYEM
AEKNNNOP: KAPONNEN
AEKNNOSS: KONESANS
AEKNNOSY: AKSYONNE
AEKNNPRÔ: KRAPÔNEN
AEKNNRYÔ: KARYÔNEN
AEKNNSSÔ: KÔNESANS
AEKNNSYÔ: ENKÔSYAN
AEKNOPRT: KONPARET
AEKNOPSZ: EKSPOZAN
AEKNORTY: KONTRAYE
AEKNOSWY: EKWASYON
AEKNOSYZ: AKSYONEZ
AEKNPRSÔ: REKÔPANS
AEKNPTÊÔ: ÊKÔPETAN
AEKNRRTÔ: RANKÔTRE
AEKNRSTÔ: KÔSANTRE
AEKNRTVÊ: VÊNKATRE
AEKNSTWÂ: AKWENTÂS
AEKNVYÊÔ: ÊKÔVEYAN
AEKRRTYÔ: KÔTRARYE
AELLNOTZ: LENZALOT
AELMMNNÊ: MALMÊNEN
          MALMENNÊ
AELMNNOT: MALONNET
AELMNNOY: NOMALYEN
AELMNPSÊ: SÊPLEMAN
AELMNPTW: TENMPLAW
AELMNSVÛ: SÛLEVMAN
AELNNNOT: TALONNEN
AELNNOPS: LAPESONN
AELNNOSS: ENSOLANS
AELNOPTZ: PLATEZON
AELNORST: TOLERANS
AELNORSY: RELASYON
AELNOSVY: LEVASYON
AELNRZÊÔ: LAREZÔNÊ
AELNSSTÊ: LASÊTSEN
AEMMNTVÛ: MÛVMANTE
AEMNNNOS: MASONNEN
AEMNNRTÂ: ANTRENMÂ
          ÂTRENMAN
AEMNNRZÔ: REZÔNMAN
AEMNOSWY: WOMANSYE
AEMNOSZÂ: ASEZONMÂ
AEMNPRSÂ: ANPRESMÂ
          ÂPRESMAN
AEMNPTWÂ: APWENTMÂ
AEMNRSSÂ: RESANSMÂ
          RESÂSMAN
AEMNRSYÂ: RANSEYMÂ
          RÂSEYMAN
AEMNRTTY: TRANTYEM
AEMOSTWY: MAYESTWO
AEMPRTÂÂ: TÂPERAMÂ
AENNNOSV: SAVONNEN
AENNNOTT: TATONNEN
AENNNPTÔ: TANPÔNEN
AENNNTÇÔ: ÇANTÔNEN
AENNOPST: ENPOTANS
AENNOPSY: PANSYONE
          PESONNAY
AENNORSZ: REZONANS
AENNOSZÊ: ASEZONNÊ
AENNOVYZ: ENVAZYON
AENNPRSV: PREVNANS
AENNPTTÇ: ANÇTPENT
AENNPWZÔ: PWAZÔNEN
AENNRRTY: RENNRAYT
AENNSTYÔ: ENTANSYÔ
AENNSVYÔ: ENVANSYÔ
AENOPSSY: ASPESYON
AENOPSTT: POTESTAN
AENORRST: RESTORAN
AENOSSTY: ESTASYON
AENPRSST: PRESTANS
AENPSSYÂ: ENPASYÂS
AEOOPTYZ: APOTEYOZ
AEOPRSYÔ: OPERASYÔ
AEPRVWYÂ: PREVWAYÂ
AFFGNOOR: FONOGRAF
AFFGOORT: FOTOGRAF
AFFINOTY: FOTIFYAN
AFGLNNOO: ANGLOFON
AFIIKRSS: SAKRIFIS
AFIIMNNS: FINISMAN
AFIKKNOO: KAKOFONI
AFIKMOTÊ: ÊFOMATIK
AFIKMTÊÔ: ÊFÔMATIK
AFILLNOP: FILAPLON
AFILNSYÊ: ÊFLIYANS
AFIMNNSÂ: FINANSMÂ
          FINÂSMAN
AFINRSYÔ: FRANSIYÔ
AFITYYÂÂ: ÂFÂTIYAY
AFKNNOSY: KONFYANS
AFKNOOSS: SAKSOFON
AFKNORSY: FRAKSYON
AFKORSYÛ: FOSKÛRAY
AFKRSYÊÔ: ÊFRAKSYÔ
AFLNNOPÊ: PLAFONNÊ
AFLNOSYÊ: ÊFLASYON
AFMNOOSY: FOMASYON
AFMNORSÂ: FRÂMASON
AFMNOTWÂ: AFWONTMÂ
AFMOSYÊÔ: ÊFOMASYÔ
AFOOPSTW: APOSTWOF
AGGILNYÔ: GANGLIYÔ
AGGMNNOW: GWOGMANN
AGGNNRÊÊ: GANGRÊNÊ
AGIIKNNO: INOGANIK
AGIILMMR: MILIGRAM
AGIIRSYÔ: IRIGASYÔ
AGIKLMOR: KILOGRAM
AGIKLNOT: KOLANGIT
AGILLTÂÇ: LÂGLIÇAT
AGILNNSÔ: LÔGANNIS
AGIMNOOW: AGWONOMI
AGIMRSYÔ: MIGRASYÔ
AGINNOTY: TIYOGANN
AGKLTÛÛÛ: GALÛKÛTÛ
AGLOOSTW: ASTWOLOG
AGMMNNOÊ: MANGONMÊ
AGNNORYÊ: GARYONNÊ
AGNOPPWÂ: PWOPAGÂN
AGNOSVVÊ: VOSVAGÊN
AIIIKMNT: KATIMINI
AIIJLNSV: VIJILANS
AIIJLSST: LAJISTIS
AIIKKLLV: KLAVIKIL
AIIKMRST: MASKRITI
AIIKNNPS: PANNISIK
AIIKRSST: SAKRISTI
          SIKATRIS
AIIKRSTY: SIKYATRI
AIILMMNZ: MIZILMAN
AIILMSVÂ: AVILISMÂ
AIILNRTÛ: LANÛRITI
AIILNSTT: SANTILIT
AIIMSTYÔ: IMITASYÔ
AIINNPST: PISANNIT
AIINNRTY: NITRIYAN
AIINRSST: SITIRANS
AIIRSTYÔ: IRITASYÔ
AIJOPRTT: TRIPOTAJ
AIKKLNOV: VOLKANIK
AIKKLORZ: KRIZOKAL
AIKKNNOR: KONKIRAN
AIKKNRSÔ: KÔKIRANS
AIKLLNOO: LAKOLONI
AIKLMNOZ: KANMIZOL
AIKLMNPÔ: KÔPLIMAN
AIKLOPTW: TWOPIKAL
AIKLRSTÊ: KRISTALÊ
AIKMNOPT: PIKOTMAN
AIKMNOTW: WOMANTIK
AIKMOOTT: OTOMATIK
AIKMPRTÂ: PRATIKMÂ
AIKMPTÂÔ: KÔPATIMÂ
AIKNNNOT: KONTINAN
AIKNNOST: KONSANTI
AIKNNPÇÊ: PIÇKANNÊ
AIKOPSYÔ: OKIPASYÔ
AIKRSSTÊ: SAKRISTÊ
AILLOOTT: TOLALITO
AILNNOVW: LAVIWONN
AILNORSY: LIYORANS
AILOPSST: SITOPLAS
AILORTZÔ: ORIZÔTAL
AILOSVYÔ: OVILASYÔ
AILOSYZÔ: IZOLASYÔ
AILPPRSÊ: PRÊSIPAL
AIMMNOSV: VOMISMAN
AIMMNSVÔ: VÔMISMAN
AIMMOSTÂ: AMOTISMÂ
AIMNOSTY: MITASYON
AIMNRSTÊ: ÊSTRIMAN
AIMOOPPT: IPOPOTAM
AIMSVYÂÂ: ÂVAYISMÂ
AINNOPYÇ: ÇANPIYON
AINNORSY: INYORANS
AINNOVWZ: ZANVIWON
AINOSSTY: SITASYON
AINOVWZÔ: OZANVIWÔ
AINPSYZÛ: PANZÛYIS
AIOPPRTÇ: PATRIPOÇ
AIOPRTTY: PATRIYOT
          TRIPOTAY
AIOPVWWZ: PWOVIZWA
AIPSTYÂÔ: ÂPITASYÔ
AISTVYÊÔ: ÊVITASYÔ
AJKLOPTÔ: KÔPLOTAJ
AJKMNTÂÛ: MATJÛKÂN
AJKMRÂÂÛ: ÂKÛRAJMÂ
AKKLLMÛÛ: MAKLÛKLÛ
AKKLNNOS: KLAKSONN
AKKLNSÊÔ: KLAKSÔNÊ
AKKOOTWY: KWATYOKO
AKMMNOSÂ: KOMANSMÂ
          KOMÂSMAN
AKMNOPTÔ: KÔPOTMAN
AKMNSTÂÔ: KÔSANTMÂ
          KÔSÂTMAN
AKMNTTÂÔ: KÔTANTMÂ
          KÔTÂTMAN
AKNNNOPR: KONPRANN
AKNNOOPY: KONPAYON
AKNNOOPZ: KONPOZAN
AKNNOPRÊ: KRAPONNÊ
AKNNORYÊ: KARYONNÊ
AKNNOSYÊ: ÊKONSYAN
AKNOOSVY: VOKASYON
AKNOSSTÔ: SÔTONAKS
AKNSSYÊÔ: ÊKÔSYANS
AKPSTWÂÊ: PWASÊKÂT
ALMMNOTÛ: MALMÛTON
ALOSVYYÔ: VYOLASYÔ
ALPSTYÂÔ: PLÂTASYÔ
AMNNTVÊÊ: VANTMÊNÊ
AMNOOSTW: ASTWONOM
AMOOPSTY: POTASYOM
AMOPVWWÛ: PWOMÛVWA
AMPWZÂÂÔ: ÂPWAZÔMÂ
ANNNOPTÊ: TANPONNÊ
ANNNOTÇÊ: ÇANTONNÊ
ANNOPWZÊ: PWAZONNÊ
ANNOPYÂÇ: ÇÂPYONNA
ANNOSTYÊ: ÊTANSYON
ANNOSVYÊ: ÊVANSYON
ANOOSTTW: ASTWONOT
ANOOSTVY: VOTASYON
ANOOSTWY: WOTASYON
ANOPRSYÂ: SARÂPYON
ANOSSSYÂ: SÂSASYON
ANPWZÂÊÔ: ÂPWAZÔNÊ
APRRSTÂÂ: TRÂSPARÂ
BBBDEILO: BBEBIDOL
BBDEEINO: DEBOBINE
BBDEINOÊ: DEBOBINÊ
BBEELLNN: BLENBLEN
BBEFLNOÔ: BÔBONFLE
          BONBÔFLE
BBEINNOÂ: ÂBOBINEN
BBENNOYÔ: BÔBONYEN
BBNNOOYÊ: BONBONYÊ
BDEEGLNO: GOLDENBE
BDEEILNW: BELDENWI
BDEEIOYZ: DEZOBEYI
BDEEJNNR: BREDJENN
BDEENOTÇ: ÇOTDEBEN
BDEFIKÂÛ: BÛKÂDIFE
BDEIIOST: ESTIBIDO
BDEIIRSY: DIBREYIS
BDEIJLNO: BIDJONEL
BDEIJLNÔ: BIDJÔNEL
BDEILNÊÛ: DEBÛLINÊ
BDELOSYÂ: LOBEDYÂS
BDEMNOWY: DONMBWEY
BDEMOWÂÇ: WOBDEÇÂM
BDENNNOÂ: BÂDONNEN
BDENNNOÛ: BÛDONNEN
BDENTÊÔÛ: DEBÛTÔNÊ
BDIILNOV: BIDONVIL
BDIINOPS: DISPONIB
BDIKRSÛÛ: BRIDSÛKÛ
BDINOSYÂ: BÂDISYON
BDISYÂÂÔ: ÂBÂDISYÔ
BDMNNOÂÛ: BÛDONNMÂ
BEEEFNTY: BYENFETE
BEEEKLMN: KELENMBE
BEEELNWZ: BENEZWEL
BEEENNRY: BYENNERE
BEEERTVÊ: ÊVETEBRE
BEEFLTYÂ: FEBLÂTYE
BEEGGINT: GITENBEG
BEEGNNRZ: BRENZENG
BEEIIKLR: EKILIBRE
BEEIJLRÂ: BELIJERÂ
BEEINNVY: BYENVENI
BEEIPRST: PRESBITE
BEEIPRTZ: PREZBITE
BEELNORY: REBELYON
BEELNVYÊ: BYÊNELVE
BEEMORSW: SEREBWOM
BEENNNOT: BETONNEN
BEFIJKOT: OBJEKTIF
BEFINOYZ: ZONBIFYE
BEFLOTZÛ: FÛTBOLEZ
BEFSYZÂÊ: BYÊFEZÂS
BEGGNRRÂ: GRÂBRENG
BEGNNNOÛ: BÛGONNEN
BEGNNORW: GWOBRENN
BEGNNRRÂ: GRÂBRENN
BEIIKLPR: REPIBLIK
BEIIKLST: BISEKTIL
          BISIKLET
BEIILPST: PLEBISIT
BEIKLRVÊ: VILBREKÊ
BEIKMRSÂ: BRISKEMÂ
BEIKNZÔÔ: KÔBINEZÔ
BEIKRSTÔ: ESKÔBRIT
BEILMSÂÂ: ÂBELISMÂ
BEILNOVY: BOLIVYEN
BEILRYZÊ: BREZILYÊ
BEJJLOÂÎ: LÎJÂBOJE
BEJJRTÂÂ: JÂJÂBRET
BEJJRTÂÊ: JÊJÂBRET
BEJNNNOÛ: BÛJONNEN
BEKLNNOÂ: KONBELÂN
BEKLNOYÔ: KOLÔBYEN
BEKMOORS: KOSMOBER
BEKMRÂÂÔ: ÂKÔBREMÂ
BELLNOSÛ: BÛLSENLO
BELMSVÂÛ: BÛLVESMÂ
BELNNNOÛ: BÛLONNEN
BENNNOTÛ: BÛTONNEN
BENNOTYÛ: BÛTONNYE
BESSYYÂÊ: BYÊSEYÂS
BIIIMOYÇ: BIYOÇIMI
BIIJLOOY: BIYOLOJI
BIILRSÂÇ: BLÂÇISRI
BIIMNSZÂ: BIZNISMÂ
BIKKSWÂÊ: BISKÂKWÊ
BIKRSTÛÛ: BRITSÛKÛ
BILMOOOT: OTOMOBIL
BISSVYÂÔ: SIBVÂSYÔ
BKKOSTÂÊ: SÊKÂTKOB
BKLMOTÛÛ: BLÛKOTÛM
BKLNOOYÊ: KOLONBYÊ
DDEEEGVÔ: DEVEGÔDE
DDEEEOPS: DEPOSEDE
DDEEKMOÂ: DEKOMÂDE
DDEENNSÊ: SÊDENDEN
          SENDÊDEN
          SENDENDÊ
DDEENOOZ: DEZODONE
DDEENPÂÂ: ENDEPÂDÂ
DDEIIINV: ENDIVIDI
DDEOORYÂ: DEYODORÂ
DDEOORZÂ: DEZODORÂ
DDEPSÂÂÊ: ÊDEPÂDÂS
DDFIOORY: FRIDODOY
DDFIOOWY: FWIDODOY
DDGGÛÛÛÛ: GÛDÛGÛDÛ
DDJJNNOO: DJONDJON
DDMMYYÂÂ: DYÂMDYÂM
DDNNOOYY: DYONDYON
DEEEEJNR: DEJENERE
DEEEFGKL: FLEGEDEK
DEEEFGLP: FLEGEDEP
DEEEFIRZ: DEREFIZE
DEEEIMNT: DETEMINE
DEEEIPYZ: DEPEYIZE
DEEEIPYÇ: DEÇEPIYE
DEEEJNTW: DEJWENTE
DEEEKPSY: EKSPEDYE
DEEELMPR: DEMEPLER
DEEENNNÇ: DEÇENNEN
DEEENPTW: DEPWENTE
DEEEORTY: TEDOREYE
DEEEPRSY: DEPRESYE
DEEFFILO: DEFOFILE
DEEFGIIR: DEFIGIRE
DEEFGLNO: DEGONFLE
DEEFIILT: FIDELITE
DEEFIKTT: DETEKTIF
DEEFINRÂ: ENDIFERÂ
DEEFNNRÔ: FREDÔNEN
DEEGGLOÊ: DEGÊGOLE
DEEGINST: DISTENGE
DEEGNNRÊ: DEGRÊNEN
          DEGRENNÊ
DEEGNRYÂ: ENGREDYÂ
DEEIINTY: ENDIYITE
DEEIIRSV: RESIDIVE
DEEIISTV: DIVESITE
DEEIKLNR: ENKREDIL
DEEIKNRS: ENDISKRE
DEEIKOPZ: DEZOKIPE
DEEIKRSÔ: KÔSIDERE
DEEIKRVÂ: REVÂDIKE
DEEIKTTY: DYETETIK
DEEILMNP: DEPLIMEN
DEEIMNSY: MEDSIYEN
DEEIMNTÂ: DETEMINÂ
DEEIMSTY: DISETYEM
DEEJMZÂÔ: DEMÂJEZÔ
DEEKLNSÂ: DELENKÂS
DEEKLOOR: DEKOLORE
DEEKMNOO: ENKOMODE
DEEKMNOY: KOMEDYEN
DEEKMNRÊ: DEKRÊMEN
          DEKRENMÊ
DEEKMNYÔ: KÔMEDYEN
DEEKMORÂ: REKOMÂDE
DEEKNNOT: DEKONNET
DEEKNNWÊ: DEKWÊNEN
          DEKWENNÊ
DEEKOPZÔ: DEKÔPOZE
DEELLOTY: TELEDYOL
DEEMMYZÂ: DEZYEMMÂ
DEEMNORT: DEMONTRE
DEENOORZ: DEZONORE
DEENOPTW: DETWONPE
DEENORSW: DEWONSRE
DEENOSYZ: DYOSEZEN
DEENRZÊÔ: DEREZÔNÊ
DEENYZÂÛ: DEZÂNÛYE
DEEPPRYÛ: PYEPÛDRE
DEEPRSYÔ: DEPRESYÔ
DEEPSSYÔ: DESEPSYÔ
DEFFIINT: DEFINITF
DEFIIJST: DIJESTIF
DEFIITYÂ: IDÂTIFYE
DEFINÇÊÔ: DEÇIFÔNÊ
DEFIRSÂÊ: ÊDIFERÂS
DEFNNORÊ: FREDONNÊ
DEFNOOPW: PWOFONDE
DEGLNOZÊ: ZÊGLENDO
          ZENGLÊDO
DEGNNNOO: GODONNEN
DEGNNWÔÛ: GÛDWÔNEN
DEGRYZÂÊ: ZÊGREDYÂ
DEIIINTV: DIVINITE
DEIIJNSÊ: ÊDIJENIS
DEIIKKRÔ: KÔKIDIRE
DEIILOST: DOSILITE
DEIILPVÂ: VILIPÂDE
DEIINRST: ENDISTRI
DEIIPSST: PESTISID
DEIJLNOW: JIWONDEL
DEIJNOSY: DIJESYON
DEIJSYÊÔ: ÊDIJESYÔ
DEIKKNOT: KONDIKTE
DEIKKOST: DISKOTEK
DEIKLNOV: DEKONVIL
DEIKMOST: DOMESTIK
DEIKMOTÂ: DOKIMÂTE
DEIKNORT: KONTREDI
DEIKNOSW: DESKIWON
DEIKNOSY: DIKSYONE
DEIKNSYÔ: DIKSYÔNE
DEIKOPRY: PERYODIK
DEIKOPTW: PWODIKTE
DEIKRSYÔ: DIREKSYÔ
DEIKRTTÔ: TIREDKÔT
DEILNOSV: DOSENVIL
DEILNOWZ: ZIWONDEL
DEILRSVÂ: DELIVRÂS
DEIMNNNO: MIDONNEN
DEIMNNRÂ: MÂDRINEN
DEIMNOSY: DEMISYON
DEIMOOWY: EMOWOYID
DEIMSTÂÛ: ETÛDISMÂ
DEIMTYZÎ: DIZÎTYEM
DEINNOOP: ONONDIPE
DEINNORY: ONDIRYEN
DEINNOYZ: DEZINYON
DEINOOTZ: NODOZITE
DEINOPSY: PEDISYON
DEINOSYZ: DESIZYON
DEINPRSÂ: ENPRIDÂS
DEIOPSZÊ: ÊDISPOZE
DEISYZÊÔ: ÊDESIZYÔ
DEKLMÂÂÇ: DEKLÂÇMÂ
DEKLNTÎÔ: LENKÔDÎT
DEKMNOYÊ: KONMEDYÊ
DEKNNOOY: KODONNYE
DEKNNOTÎ: ENKONDÎT
DEKNNOÇÔ: KOÇÔDENN
DEKNOOOW: KOWODONE
DEKOORST: DOKTORES
DEKRSTÂÔ: KÔTREDÂS
DELMNNÂÂ: NÂLÂDMEN
DELMOPVÂ: DEVLOPMÂ
DENNOOST: ONDONSTE
DENNOSTÛ: ÛNDONSTE
DENOORZÂ: DEZONORÂ
DENOOSVY: DEVOSYON
DENOSTWÔ: WÔDONSTE
          WONDÔSTE
DENOSTYÂ: DETÂSYON
DETTZÂÂÂ: DETÂZÂTÂ
DFIINOYZ: DIFIZYON
DFIKNOSÂ: KONFIDÂS
DGIMSÂÂÛ: ÂGÛDISMÂ
DGNNOWÊÛ: GÛDWONNÊ
DIIILNPS: DISIPLIN
DIIJLNOT: LONJITID
DIIKMNOÊ: DOMINIKÊ
DIIKSSYÔ: DISKISYÔ
DIINOVYZ: DIVIZYON
DIKKLOOW: KWOKODIL
DIKNOSYÔ: KÔDISYON
          KONDISYÔ
DIMNOSYÂ: DIMÂSYON
DINORSYÂ: SÂDRIYON
DINOSTYÂ: DÂTISYON
DIOPSVWÂ: PWOVIDÂS
DIOVYZÂÛ: VODÛYIZÂ
DKLNOTÊÎ: LÊKONDÎT
DKNNOOÇÊ: KOÇONDÊN
DLLLOOOP: DLOLOLOP
DMNNOOWÔ: WÔDONMON
          WONDÔMON
          WONDONMÔ
EEEEKKKL: KELEKEKE
EEEENRST: ENTERESE
EEEEPRSV: PESEVERE
EEEFKLRT: REFLEKTE
EEEFLNOT: TELEFONE
EEEFNRYZ: ENFERYEZ
EEEIKPST: PESEKITE
EEEILNTT: LETENITE
EEEINRTV: VETERINE
EEEINSST: NESESITE
EEEIRSTV: SEVERITE
EEEJMNRY: JEREMYEN
EEEJNNNY: ENJENNYE
EEEJNRTY: JERETYEN
EEEKNPST: ENSPEKTE
EEEKPRST: RESPEKTE
EEEKRSTY: EKSTERYE
EEELMNTÂ: ETENELMÂ
EEELNPTT: PELENTET
EEELNSST: SELESTEN
EEELPPTY: PEPETYEL
EEEMRSTÇ: ÇEMETRES
EEENNSTT: ENTESTEN
EEENOPWY: EWOPEYEN
EEENRSTÂ: ENTERESÂ
EEFIILST: FELISITE
EEFIIMNT: ENFIMITE
EEFIKPRT: PREFEKTI
EEFIKRTY: REKTIFYE
EEFILNRT: ENFILTRE
EEFKNSYÔ: ENFEKSYÔ
EEFKPSYÔ: PEFEKSYÔ
EEFNNOSS: SENNESOF
EEFPRRSÂ: PREFERÂS
EEGGLNNO: GENNGOLE
EEGGLNOR: GRENGOLE
EEGIILRY: IREGILYE
EEGILNST: ESTELING
EEGIOSZZ: EGZOSIZE
EEGISTVÊ: ÊVESTIGE
EEGLPTZÊ: ZEPÊGLET
EEGOPRSW: PWOGRESE
EEGOSTWY: GWOSYETE
EEIIKKMN: EKIMENIK
EEIIKRST: SEKIRITE
EEIILMNN: ELIMINEN
EEIILNSV: INIVESEL
EEIIPPRS: PERIPESI
EEIIPSVZ: SIPEVIZE
EEIIRSST: RESISITE
EEIJKMNÂ: ENEJIKMÂ
EEIJKNOS: OKSIJENE
EEIJLNTÂ: ENTELIJÂ
EEIJMNNT: MENENJIT
EEIJNNRY: NIJERYEN
EEIJNPSY: EJIPSYEN
EEIKKLPS: EKSPLIKE
EEIKKLRT: ELEKTRIK
EEIKKMNS: MEKSIKEN
EEIKLOPT: ELIKOPTE
EEIKPSTZ: EKSPETIZ
EEIKRSYZ: RESKIYEZ
EEILLMMO: MELIMELO
EEILNOPP: ENPOPILE
EEILOSTV: VELOSITE
EEIMNORS: SEREMONI
EEIMNSTY: METSIYEN
EEIMNSTÊ: ESTEMINÊ
EEIMNWYZ: MENWIZYE
EEINPRVY: PERIVYEN
EEINPTWY: PWENTIYE
EEISSTVÊ: ÊVESTISE
EEJKOPTW: PWOJEKTE
EEJNNORS: JERENONS
EEJNNVVY: JENNVYEV
EEJNOSTW: ESTWOJEN
EEKKNNOT: KONNEKTE
EEKKNSWÊ: KESEKWÊN
EEKKNSÂÔ: ENKÔSEKÂ
EEKLNORT: LEKONTRE
EEKLNOSY: ELEKSYON
EEKLNOTW: ELEKTWON
EEKLNPTÔ: ENKÔPLET
EEKLOPST: TELESKOP
EEKLOPSZ: EKSPLOZE
EEKLOSWZ: ESKLEWOZ
EEKMRSÂÛ: REKÛMÂSE
EEKMRTTÔ: KÔTREMET
EEKMSWÂÛ: ÂMWESEKÛ
EEKNNSYÔ: KESYÔNEN
EEKNOPRS: KONPRESE
EEKNPTÂÔ: ENKÔPETÂ
EEKNVYÂÔ: ENKÔVEYÂ
EEKOPTTW: PWOTEKTE
EEKPRSÂÔ: REKÔPÂSE
EEKPSSYÔ: EKSEPSYÔ
EEKRSSYÔ: ESKRESYÔ
EELLOPRV: POLVEREL
EELLSSYÂ: LESÂSYEL
EELMNPSÂ: SENPLEMÂ
EELOPSTY: POLYESTE
EEMMYYZÂ: MYEZÂMYE
EEMNNNOR: RENONMEN
EEMRSYZÂ: SERYEZMÂ
EENNNOSZ: SEZONNEN
EENNNPPÊ: PENPÊNEN
          PENPENNÊ
          PÊPENNEN
EENNRRST: RESTRENN
EENNTTÇÇ: TÇENTÇEN
EENNVVYY: VYENVYEN
EENOPSTW: PWOSTENE
EENOPTYY: ETYOPYEN
EENPRSYÔ: ENPRESYÔ
EEOPPRSW: PWOSPERE
EEOPPRTW: PWOPRETE
EEOPSTTW: PWOTESTE
EEOPSTWY: ESTWOPYE
EEORTTYZ: TETZORYE
EEPRSSYÂ: ESPERYÂS
EEPRSSYÔ: ESPRESYÔ
          RESEPSYÔ
EEPRSTYÂ: PRETÂSYE
EFFKOORR: KOFREFRO
EFGILORY: GLORIFYE
EFGINNRÔ: GRIFÔNEN
EFGLMNOÂ: GONFLEMÂ
EFGNNNOÛ: FÛGONNEN
EFIIIPSS: SIPEFISI
EFIIJSTY: JISTIFYE
EFIIKRSY: KRISIFYE
EFIIMSTY: MISTIFYE
EFIINSYZ: FIZISYEN
EFIKKNOS: KONFISKE
EFIKMNNO: KONFIMEN
EFIKNORR: KONFRERI
EFILMSÂÇ: FLEÇISMÂ
EFILNSYÂ: ENFLIYÂS
EFILPSYÊ: SÊPLIFYE
EFILSYÂÊ: ÊFLIYÂSE
EFINNNOÇ: ÇIFONNEN
EFINNRSÔ: FRISÔNEN
EFIPRTVÂ: PREVÂTIF
EFKKLNOS: KONFLEKS
EFKMMOÂÔ: KÔFOMEMÂ
EFKNOSYÊ: ÊFEKSYON
EFKNOSYÔ: FÔKSYONE
          KÔFESYON
          KONFESYÔ
EFKNOTWÔ: KÔFWONTE
          KONFWÔTE
EFKRTYÂÊ: FRÂKETYÊ
EFOPSWYÔ: PWOFESYÔ
EFPTYÂÛÛ: PÂTÛFÛYE
EGGNNRÂÊ: GÂGRÊNEN
          GÂGRENNÊ
EGGORYZÂ: GRÂGOZYE
EGIILNRS: GLISERIN
EGIJKLNO: GLIKOJEN
EGIJLNSÂ: NEGLIJÂS
EGINNNOY: GIYONNEN
EGINNORZ: GRIZONEN
EGINNRZÔ: GRIZÔNEN
EGISSTZÂ: EGZISTÂS
EGMMNNOÂ: MÂGONMEN
EGMMNNOÔ: MÔGONMEN
          MONGÔMEN
EIIIJLMT: ILEJITIM
EIIIJNTV: VIJINITE
EIIJLPRV: PRIVILEJ
EIIJNRYÇ: ÇIRIJYEN
EIIJNSST: ENJISTIS
EIIKKMNO: KOMINIKE
EIIKLLRT: KILTIREL
EIIKLMNR: KRIMINEL
EIIKLSTT: TESTIKIL
EIIKLTTÂ: LÂTIKITE
EIIKMRST: SIMETRIK
EIIKNWYZ: KWIZINYE
EIILMNSY: MILISYEN
EIILNOPZ: POLINIZE
EIILOSTT: OSTILITE
EIILPRST: PERISTIL
EIILSSSY: SELSIYIS
EIIMNPRR: ENPRIMRI
EIIMNSYZ: MIZISYEN
EIINOPTZ: IPNOTIZE
          IPOTENIZ
EIINRSST: SINISTRE
EIIPRSZÂ: ISIPREZÂ
EIJJLOOY: JEYOLOJI
EIJKKLOO: EKOLOJIK
EIJKLOOS: EKOLOJIS
EIJLLOSY: LOJISYEL
EIJLNOOT: ETNOLOJI
EIJLNORY: RELIJYON
EIJLSTÂÊ: ÊTELIJÂS
EIJNNOTW: NITWOJEN
EIKKLNOP: KONPLIKE
EIKKMNOO: EKONOMIK
EIKLNOST: KONSILTE
EIKLOSTT: LESKOTIT
EIKLOSYÔ: ELOKISYÔ
EIKMNNOY: KOMINYEN
EIKMNOOS: EKONOMIS
EIKMNOOT: KOMINOTE
EIKMNOPR: KONPRIME
EIKNNOPT: NENPOTKI
EIKNNOTY: KONTINYE
EIKNNPÂÇ: PIÇKÂNEN
EIKNOPST: KONSTIPE
EIKNRSTÂ: KÂNISTER
EIKOPRSW: RESIPWOK
EIKRSTTÊ: ÊSTRIKTE
EIKRTYZÛ: KÛTIRYEZ
          KÛTRIYEZ
EILLPSVÛ: SILVÛPLE
EILNNNOP: PILONNEN
EILNORVZ: LIVREZON
EILNOSTW: SITWONEL
EILNOSTY: LEYONTIS
EILOSVYÔ: EVOLISYÔ
EILPRTZÂ: PLEZÂTRI
EIMNNNOY: MIYONNEN
EIMNOPSY: PEMISYON
EIMNRSTÂ: ENSTRIMÂ
EINNNOVW: VIWONNEN
EINNORYY: REYINYON
EINNOSTW: SENTIWON
EINOPRYZ: PRIZONYE
EINOPTWY: PWOTEYIN
EINORSTY: ISTORYEN
EINORTYÇ: OTRIÇYEN
EINOTTTW: TWOTINET
EINOTYÂÇ: EÇÂTIYON
EINPSTÂÂ: ÂPENITÂS
EIOPRTTY: TRIPOTYE
EIOPSSSW: PWOSESIS
EIOPVWZÊ: ÊPWOVIZE
EIPRRTZÂ: ÂTREPRIZ
EIPRSSTÊ: SÊTESPRI
EIPRVYZÔ: PREVIZYÔ
EIPSTTWÔ: TWÔPETIS
EIPSTYÂÔ: IPETÂSYÔ
EIRSSTZÂ: REZISTÂS
EJLNOOPW: PWOLONJE
EJMOPSYÂ: ÂJYOSPEM
EKKLMOOY: KOMOKYEL
EKKLNOOT: KOLOKENT
EKKNNOTÔ: KÔKONNET
          KONKÔNET
EKKNOSSÂ: KONSEKÂS
EKKNOSÂÊ: ÊKONSEKÂ
EKKNSYÊÔ: KEKSYÔNÊ
EKLMNOPÂ: KONPLEMÂ
EKLNOOPT: KONPLOTE
EKLNOOTW: KONTWOLE
EKLNOPTY: PONKTYEL
EKLNOPTÊ: ÊKONPLET
EKMNNOOP: MONKONPE
EKMNNOSÔ: KONSÔMEN
          KÔSONMEN
EKMNOOTW: KWONOMET
EKMOOSTW: ESKWOTOM
EKMSTYÂÊ: SÊKÂTYEM
EKNNOSSÂ: KONNESÂS
EKNNOSYÂ: ENKONSYÂ
EKNNOSYÊ: KESYONNÊ
EKNOOPSY: ESKOPYON
EKNOPRSÂ: REKONPÂS
EKNOPRSÔ: KORESPÔN
EKNOPTYÛ: KONPYÛTE
EKNOPTÂÊ: ÊKONPETÂ
EKNORRTÂ: RÂKONTRE
EKNORSTÂ: KONSÂTRE
EKNOVYÂÊ: ÊKONVEYÂ
EKNSSYÂÔ: ENKÔSYÂS
EKNVYÂÊÔ: ÊKÔVENYÂ
EKOPRSYÔ: PREKOSYÔ
EKPSSYÊÔ: ÊSPEKSYÔ
EKPSSYÔÔ: KÔSEPSYÔ
ELLOSVYÔ: VYOLÔSEL
ELNNOPTÔ: PLOTÔNEN
ELOPSTYÂ: POTÂSYEL
ELPRSYÊÔ: LÊPRESYÔ
EMNNNOPW: PWONMNEN
EMNNOPWÊ: PWOMÊNEN
          PWOMENNÊ
EMNNORZÂ: REZONNMÂ
EMNNPWÊÔ: PWÔMÊNEN
          PWÔMENNÊ
EMNNTVÂÊ: VÂTMÊNEN
          VÂTMENNÊ
EMNOOSTZ: MOTSEZON
EMNOPSTÂ: ESPOTMÂN
EMOSTTYÂ: TÂSYOMET
ENNNOOTÇ: TOÇONNEN
ENNNOPTÂ: TÂPONNEN
ENNNOTÂÇ: ÇÂTONNEN
ENNOOPSW: PWONONSE
ENNOSTYÂ: ENTÂSYON
ENNOSVYÂ: ENVÂSYON
ENNYZZÔÔ: ZÔZÔNYEN
ENOOPRSY: OPRESYON
ENOOPSSY: POSESYON
ENOPRSYÊ: ÊPRESYON
ENPRRTÂÂ: ÂTREPRÂN
EOOTTWYY: TYOTYOWE
EOPSSWYÔ: PWOSESYÔ
EOPSTTWÂ: PWOTESTÂ
EPRSTYÂÔ: PRETÂSYÔ
EPRSVYÂÔ: PREVÂSYÔ
FFIIINTÊ: ÊFINITIF
FFIILOOZ: FILOZOFI
FFKNOORÂ: FRÂKOFON
FGINNORÊ: GRIFONNÊ
FIIIMPRT: PRIMITIF
FIIINRTT: NITRITIF
FIIKSTYÂ: SYÂTIFIK
FIINSYÂÊ: ÊSINIFYÂ
FIIRTTZÂ: TRÂZITIF
FIISYYÂÊ: ÊSIYIFYÂ
FIJLMOOO: MOFOLOJI
FIKLLOOW: KLOWOFIL
FIKNOOOT: OTOFONIK
FIKNORSY: FRIKSYON
FIKNOYZÔ: KÔFIZYON
          KONFIZYÔ
FIKOOOPT: FOTOKOPI
FIKRSSÂÊ: FRÂSISKÊ
FINNORSÊ: FRISONNÊ
FINORSYÂ: FRÂSIYON
FIORSTÇÛ: ÇOFSÛRIT
FKLNOOOY: KONFYOLO
FKNNOOSY: FONKSYON
FLSTÂÇÛÛ: SÛFLÂTÇÛ
GGILNOYÂ: GÂGLIYON
GGNNOOPÔ: PÔGONGON
          PONGÔGON
          PONGONGÔ
GIKLSTÊÎ: LÊGÎSTIK
GILLOOPT: POLIGLOT
GILNNOSÂ: LONGÂNIS
GINNORZÊ: GRIZONNÊ
GMMNNOOÊ: MONGONMÊ
IIIILTTT: TILITITI
IIIKLMNS: MINISKIL
IIIKLOTT: OTIKILTI
IIJKLOOS: SIKOLOJI
IIJLOOST: SITOLOJI
IIJLSSTÊ: LÊJISTIS
IIKKPPRR: KRIPKRIP
IIKLORST: KLITORIS
IIKLRTVÂ: VÂTRIKIL
IIKMNOWÂ: IWONIKMÂ
IIKMNRÊÊ: ÊKRIMINÊ
IIKNPSTÂ: PÂNISTIK
IIKSYZÊÔ: ÊKIZISYÔ
IILLPPPP: PLIPPLIP
IILNOPPS: PONPILIS
IIMNNOSY: MINISYON
IIMNORST: MONITRIS
IINNOPSY: PINISYON
IINRSTYÔ: NITRISYÔ
IJLOOOWZ: ZOWOLOJI
IKKKOOOR: KOKORIKO
IKKLYZÔÔ: KÔKLIZYÔ
IKKNORSÂ: KONKIRÂS
IKLMNOPÂ: KONPLIMÂ
IKLNOOYZ: KOLIZYON
IKMNNOOY: KOMINYON
IKMNNOYÔ: KÔMINYON
          KONMINYÔ
IKMNOOSY: KOMISYON
IKMOORZÂ: ÂKRIMOZO
IKMSTÂÂÔ: KÔSÂTIMÂ
IKSSSTÂÔ: SIKÔSTÂS
ILMPWZÊÛ: PLIZÛMWÊ
ILNOOPSY: POLISYON
ILNOOSSY: SOLISYON
ILNOOSVY: VYOLONIS
IMMNOSVÂ: VONMISMÂ
INOOPSYZ: POZISYON
INOOVWZÂ: OZÂVIWON
INPRZÂÊÔ: ÂPRIZÔNÊ
IOOPSYZÔ: OPOZISYÔ
IOPVWYZÔ: PWOVIZYÔ
JKKSYÔÔÔ: KÔJÔKSYÔ
JLMOPWÂÔ: PWOLÔJMÂ
KLOOOOST: SOLOKOTO
KLOOOPPT: PLOKOTOP
KLOOOPTW: PWOTOKOL
KMMNNOOÔ: MÔKONMON
          MONKÔMON
          MONKONMÔ
KMMOOOWZ: KWOMOZOM
KMNNOOSÊ: KONSONMÊ
KMNOOPTÂ: KONPOTMÂ
KMNOSTÂÂ: KONSÂTMÂ
KMNOTTÂÂ: KONTÂTMÂ
KNOOOWYZ: KOWOZYON
KNOSSYÂÊ: ÊKONSYÂS
LLTTÇÛÛÛ: TÇÛLÛLÛT
LNNOOPTÊ: PLOTONNÊ
MMNNOOTT: TONMTONM
MNNOPWÊÊ: PWONMÊNÊ
MOOPSWYÔ: PWOMOSYÔ
NNNOOWWÊ: WONWONNÊ
NNOYZZÊÔ: ZONZÔNYÊ
          ZÔZONNYÊ
NPSSÂÂÛÛ: SÛSÛPÂNÂ
OOPPSWYÔ: PWOPOSYÔ
TTTYYÂÛÛ: ÂTYÛTYÛT
