Tirages de 7 jetons de AAABBMR à AAANNPT - Page 1/28

AAABBMR:	BAMBARA	AAALNTT:	TALATAN
AAABBNR:	ANBABRA	AAALOnTT:	ALATATOn
AAABChLN:	ANBAChAL	AAALPPW:	PAPALWA
AAABChRY:	ChARABYA	AAAMNPT:	APATMAN
AAABDNS:	ANBASAD	AAAnAnBRS:	AnBARASAn
AAABDPT:	ADAPTAB	AAAnBDES:	AnBASADE
AAABGLN:	BANGALA	AAAnBDLM:	DAnMBALA
AAABGLR:	LAGRABA	AAAnBDRS:	AnBRASAD
AAABJLN:	ANBALAJ	AAAnBERS:	AnBARASE
AAABJNZ:	ANBAZAJ	AAAnBJLS:	ASAnBLAJ
AAABKLN:	BAKANAL	AAAnBKMN:	AnBAKMAN
AAABKLR:	ALBARAK		ANBAKMAn
AAABLMY:	ALAMYAB	AAAnBKNR:	KARABAnN
AAABLNN:	ANBALAN	AAAnBLSW:	BALAnSWA
AAABLTW:	LABATWA	AAAnBMMY:	MAYAnMBA
AAABMNY:	MAYANBA	AAAnBNTV:	AnBAVANT
AAABMRR:	ABRARAM		ANBAVAnT
AAABNRV:	AVANBRA	AAAnDGLV:	LAVAnGAD
AAAChKKT:	KAKAChAT	AAAnDKLM:	MAKAnDAL
AAAChLNT:	ChALATAN	AAAnDKMR:	KAnMARAD
AAAChMNT:	ATAChMAN	AAAnEJTV:	AVAnTAJE
AAADGNV:	AVANGAD	AAAnGJMN:	AnGAJMAN
AAADJKL:	KALADJA		ANGAJMAn
AAADJKT:	DJAKATA	AAAnGLPY:	GALAPYAn
AAADJNN:	AJANNDA	AAAnGMNN:	AnGANMAN
AAADKMR:	KAMARAD		ANGANMAn
AAAFKLT:	KATAFAL		ANGAnMAN
AAAGLMM:	AMALGAM	AAAnGPPR:	GRAnPAPA
AAAGLMN:	MALANGA	AAAnJMNR:	ARAnJMAN
AAAGLMW:	LAMAGWA		ARANJMAn
AAAGMNN:	AGANMAN	AAAnLNRT:	ALANTRAn
AAAGMNZ:	MAZANGA		ALAnTRAN
AAAGNRV:	AGRAVAN	AAAnLPRS:	LAPARAnS
AAAGNWY:	YAGWANA	AAAnLPRT:	ALATRAnP
AAAGRWZ:	ZARAGWA	AAAnLPST:	PLASAnTA
AAAINTZ:	ATIZANA	AAAnMMNN:	AMAnNMAN
AAAJKKN:	JANKAKA		AMANNMAn
AAAJNTV:	AVANTAJ	AAAnMNSV:	AVAnSMAN
AAAKLMN:	ALMANAK		AVANSMAn
AAAKLNV:	KANAVAL	AAAnNNNP:	ANPAnNAN
AAAKLPT:	KAPLATA		ANPANNAn
AAAKNST:	KANTASA		AnPANNAN
AAAKPPZ:	PAPZAKA	AAAnNNNZ:	ZANNAnNA
AAAKPRS:	KARAPAS		ZAnNANNA
AAAKPRT:	KARAPAT	AAANNNP:	ANPANNA
AAAKRTT:	KATARAT	AAAnNNSV:	AnNAVANS
AAAKRTY:	AKARYAT		ANNAVAnS
AAALLPS:	ALAPLAS	AAANNNV:	ANNAVAN
AAALLSV:	LAVALAS	AAANNPS:	ANPASAN
AAALMRY:	MALARYA	AAANNPT:	ANPATAN


Tirages de 7 jetons de AAAnNPTZ à AAChMNTW - Page 2/28

AAAnNPTZ:	ZAPATAnN		KARABIN
AAANPRS:	APARANS	AABIKRY:	KARAYIB
AAANPRT:	ATRAPAN	AABILLS:	LASILAB
AAANPRV:	PARAVAN	AABILYZ:	BALIZAY
AAANPTY:	APANTAY	AABIMMN:	MANIMBA
AAAnRTVY:	TRAVAYAn	AABIMNT:	BATIMAN
AABBDOY:	BABYADO	AABIRSY:	RAYISAB
AABBILS:	LASIBAB	AABJKOT:	KABOTAJ
AABBKNOu:	BABANKOu	AABJLNN:	JANBLAN
AABBLNOu:	BANBOuLA	AABJLOuR:	LABOuRAJ
AABBLNS:	SANBLAB	AABKLNR:	KANBRAL
AABBNOS:	ABSOBAN	AABKLOuS:	KALABOuS
AABChEMOn:	ABOnMAChE	AABKLOuW:	KABOuLAW
AABChILR:	ChALBARI	AABKLOuY:	KABOuLAY
AABChIRT:	ChARITAB	AABKNOO:	KAONABO
AABChNOY:	ANBOChAY	AABKNOV:	VAKABON
AABDEGR:	DEGRABA	AABKNOW:	AKWABON
AABDIKR:	BARIKAD	AABKOTW:	AKWOBAT
AABDIMR:	ADMIRAB	AABKOuYY:	KABOuYAY
AABDINN:	BADINAN	AABLNNS:	SANBLAN
AABDNNO:	ABONDAN	AABLOPR:	PARABOL
AABDNOnS:	ABOnDANS	AABLOSW:	ALABWOS
AABDNOP:	PADONAB	AABMNNO:	ABONMAN
AABDORY:	RABODAY	AABMNNR:	MANBRAN
AABEFLT:	ALFABET	AABNNNN:	BANNANN
AABEGRY:	AGREYAB	AABNNSY:	ANBYANS
AABEKNP:	ENKAPAB	AABNOnWY:	BAYAWOnN
AABELMY:	MALEYAB	AABNOPT:	BONAPAT
AABELNP:	LABAPEN	AAChDEMN:	MAChANDE
AABELNS:	ASANBLE	AAChDEPT:	DEPATChA
	BALANSE	AAChEKNT:	ANKAChET
	SALANBE	AAChELPW:	ChAPELWA
AABELNY:	LABANYE	AAChELWZ:	AChELWAZ
AABELWY:	WAYABEL	AAChENNT:	ANChANTE
AABEnKWY:	EnKWAYAB	AAChFINR:	AFRANChI
AABEnLLN:	LABALEnN	AAChGLMO:	MALAGOCh
AABENNT:	ANBETAN	AAChIKMN:	KAChIMAN
AABENRS:	ANBRASE	AAChIMNP:	PAChIMAN
AABENST:	ABSANTE	AAChIMNT:	ChATIMAN
AABEPST:	ASEPTAB	AAChIPRT:	PARAChIT
AABERVW:	ABREVWA	AAChJKOW:	AKWOChAJ
AABETTY:	TABATYE	AAChJMNN:	ChANJMAN
AABGJOT:	GABOTAJ	AAChKLOS:	ChALOSKA
AABGNOV:	VAGABON	AAChKMNOu:	AKOuChMAN
AABIJRT:	ABITRAJ	AAChKNOuS:	SANKOuChA
AABIJST:	AJISTAB	AAChLLNP:	LAPLANCh
AABIKKS:	KABASIK	AAChLMNS:	MALChANS
AABIKLN:	ALANBIK	AAChMNNS:	ChANNMAS
AABIKLP:	APLIKAB	AAChMNNW:	WAChMANN
AABIKNR:	KABRINA	AAChMNTW:	WATChMAN


Tirages de 7 jetons de AAChNNPT à AAEKMRS - Page 3/28

AAChNNPT:	TChANPAN	AADINOY:	ADONAYI
AADDEJN:	ADJEDAN	AADJNOR:	ORANJAD
AADDENN:	ANDEDAN	AADKOPP:	PAPADOK
AADDIJN:	ADJIDAN	AADLNTW:	LANDWAT
AADDIKN:	KANDIDA	AADMNNR:	RANDMAN
AADEGJN:	DEGAJAN	AADMNNY:	MANDYAN
AADEGNN:	ANNEGAD	AADMNOY:	ADYOMAN
AADEGNR:	REGADAN	AADNNOuR:	ANDOuRAN
AADEGNY:	GADENYA	AADNNST:	TANDANS
AADEIKM:	AKADEMI	AADORTY:	RADOTAY
AADEJKK:	KADEJAK	AAEEJLL:	ALALEJE
AADEJKL:	DEKALAJ	AAEEPRY:	APAREYE
AADEJNN:	ANDANJE	AAEFKRS:	FRAKASE
AADEJPR:	DERAPAJ	AAEFLST:	ASFALTE
AADEKMY:	DEMAKAY	AAEFMNR:	AFREMAN
AADEKNR:	ANKADRE	AAEFMNY:	ANFEMAY
AADEKTY:	DEKATYA	AAEFMTZ:	METAFAZ
AADELNR:	ADRENAL	AAEFNNT:	ANFANTE
AADEMNN:	ANMEDAN	AAEFTTY:	TAFYATE
AADEMNP:	DEPAMAN	AAEGLNV:	AVEGLAN
AADEMNT:	MANDATE	AAEGMNZ:	MAGAZEN
AADEnKNY:	KANADYEn		MAZENGA
AADENST:	ESTANDA	AAEGNPT:	GETAPAN
AADENTT:	ENTATAD	AAEGNSW:	AGWESAN
AADENTY:	ANDETAY	AAEGNTW:	WANGATE
	DETAYAN	AAEIJTT:	AJITATE
AADENYZ:	ANDEZAY	AAEIKTZ:	AKIZATE
AADEORT:	ADORATE	AAEILNZ:	ANALIZE
AADEPTY:	DEPATYA	AAEILVZ:	AVALIZE
AADERTY:	RADYATE	AAEIMNT:	ANIMATE
AADFIIV:	AFIDAVI	AAEINSS:	ASASINE
AADFMRY:	DYAFRAM	AAEITVY:	AVIYATE
AADFNNS:	DANFANS	AAEJNNT:	AJANTEN
AADGILM:	AMIGDAL	AAEJVWY:	VWAYAJE
AADGIMR:	MADIGRA	AAEKKLR:	KAKAREL
AADGINR:	AGRANDI	AAEKKRT:	KARAKTE
AADGNRR:	GRANDRA	AAEKKTW:	KAKATWE
AADIJNY:	JADINAY		KAKAWET
AADIKLM:	MALKADI	AAEKLLN:	ALKALEN
AADIKLN:	KADINAL	AAEKLMR:	KARAMEL
	KALINDA	AAEKLMY:	KAMELYA
AADIKLR:	RADIKAL	AAEKLOnS:	ALEKOnSA
AADIKNP:	ANDIKAP	AAEKLRV:	KARAVEL
AADIKNS:	AKSIDAN	AAEKLRW:	AKWAREL
AADIKNT:	DANTIKA	AAEKLVY:	KAVALYE
AADIKRW:	DIRAKWA	AAEKMMR:	MAKRAME
AADILPS:	PALISAD	AAEKMNN:	AMANNKE
AADILRV:	ALADRIV	AAEKMNR:	KAREMAN
AADILTW:	DILATWA	AAEKMPT:	METAKAP
AADIMNR:	MARINAD	AAEKMRS:	MASAKRE


Tirages de 7 jetons de AAEKMRY à AAIKNPR - Page 4/28

AAEKMRY:	MAREKAY	AAFINRY:	FARINAY
AAEKNRS:	KARESAN	AAFINTT:	ATANTIF
AAEKNYZ:	KAZANYE	AAFINTY:	ANFAYIT
AAEKOnPY:	AKOnPAYE	AAFJMNS:	FANMSAJ
AAEKSSW:	AKSESWA	AAFKOuWZ:	KAFOuWAZ
AAELLOuY:	ALELOuYA	AAFLMNN:	FLANMAN
AAELLPR:	PARALEL	AAFLNOnT:	LAFOnTAN
AAELMRY:	LAMARYE	AAFLNTY:	LAFYANT
AAELMTY:	MALTAYE	AAFMNSY:	FANMSAY
AAELNRS:	ARANSEL	AAFNORW:	FARAWON
AAELNST:	LASANTE	AAFNRSW:	FRANSWA
AAELNTY:	LATANYE	AAGGNNN:	NGANGAN
AAELOPT:	ALAPOTE	AAGGNNS:	GANGANS
AAELPRS:	LAPARES	AAGGOTY:	GAGOTAY
AAELRST:	LATERAS	AAGIILT:	ALIGATI
AAELTTW:	TATAWEL	AAGIKLS:	GALAKSI
AAELVWZ:	VALEWAZ	AAGILMN:	LIGAMAN
AAEMNNP:	PEMANAN	AAGIMNR:	MAGARIN
AAEMNNT:	ANTEMAN	AAGINRT:	GARANTI
AAEMNPZ:	APEZMAN	AAGIPSY:	GASPIYA
AAEMNRS:	RANMASE	AAGJLOuW:	ALAGWOuJ
AAEMNRT:	TAMAREN	AAGJNNR:	GRANJAN
AAEnFMSY:	FAMASYEn	AAGKLOT:	KATALOG
AAEnFNNT:	ANFANTEn	AAGLLSY:	GLASYAL
AAEnGGNN:	GAGANNEn	AAGLOuWY:	ALAGWOuY
AAEnKMSW:	SEnMAKWA	AAGMNOS:	MASOGAN
AAEnKNWY:	EnKWAYAN	AAGMNOuS:	MANGOuSA
AAEnLNTY:	LATANYEn	AAGMNRT:	GRATMAN
AAEnLPST:	PLASEnTA	AAGNOSW:	AWOGANS
AAEnNNPP:	ANPEnPAN	AAGOTWW:	WOGATWA
AAEnNPSY:	EnPASYAN	AAIJKMY:	MAKIYAJ
AAENNRY:	ANNARYE	AAIJLNV:	VAJINAL
AAENNSS:	ANSANSE	AAIJMNS:	AJISMAN
	ANSASEN	AAIJNPT:	PATINAJ
AAENNST:	ANSANTE	AAIJNRT:	AJANTRI
AAENNTW:	ANWETAN	AAIJPRT:	PATIRAJ
AAENRTV:	ANTRAVE	AAIJSTY:	AJISTAY
AAENSTY:	SATANYE	AAIKKMR:	MAKAKRI
AAENSVZ:	SANZAVE	AAIKKRT:	KAKATRI
AAENTVY:	AVANTYE	AAIKKTW:	AKWATIK
	EVANTAY	AAIKLMW:	MAKWALI
AAERTVY:	TRAVAYE		MIKALAW
AAFFNNW:	FANNFWA	AAIKLPT:	KAPITAL
AAFGINT:	FATIGAN	AAIKLTY:	KATILAY
AAFGLNR:	FLAGRAN	AAIKLWZ:	AKILWAZ
AAFIKNT:	FANATIK	AAIKMNO:	AMONIKA
AAFILMN:	LAFANMI	AAIKMNY:	KAYIMAN
AAFIMNN:	ANFANMI	AAIKMST:	ASMATIK
AAFIMNS:	FANMASI	AAIKNNR:	KANNARI
AAFIMNT:	FATIMAN	AAIKNPR:	KAPRINA


Tirages de 7 jetons de AAIKNSW à AAnBDEMT - Page 5/28

AAIKNSW:	SINAKWA	AALMNNT:	LANTMAN
AAIKNTT:	ANTATIK	AALMNOR:	ORALMAN
AAIKTYZ:	AZYATIK	AALMNPS:	PLASMAN
AAILLVY:	ALIVYAL	AALMOTY:	LAMAYOT
AAILMNT:	MATINAL	AALNNOW:	ALAWONN
AAILMNY:	ALIYMAN	AALNOnPT:	PANTALOn
AAILNSS:	SALISAN	AALNOuVY:	YANVALOu
AAILPPR:	PARAPLI	AALNPTV:	PLAVANT
AAILPTW:	PILATWA	AALNSSY:	LASYANS
AAILPTY:	TILAPYA	AALOPRS:	PARASOL
AAILRSV:	LAVARIS	AAMNNNR:	RANNMAN
AAIMMNZ:	AMIZMAN	AAMNNNS:	SANNANM
AAIMNOT:	ANATOMI	AAMNNNZ:	ZANMANN
AAIMNRY:	MARYANI	AAMNNPS:	PANSMAN
AAINNPR:	PANNARI	AAMNOTV:	AVOTMAN
AAINPRS:	ASPIRAN	AAnAnAnDNT:	AnNATAnDAn
AAINPRT:	APRANTI	AAnAnBKLT:	BATAnKLAn
AAINPTY:	PATINAY	AAnAnBMNZ:	BAnZANMAn
AAINPTZ:	PATIZAN		BAnZAnMAN
AAINRSS:	ASIRANS		BANZAnMAn
AAINRST:	ATIRANS	AAnAnDFMN:	FANDAnMAn
AAINSST:	ASISTAN		FAnDAnMAN
AAIOTYY:	ATIYAYO		FAnDANMAn
AAIPRTY:	PATIRAY	AAnAnFNNS:	AnNAnFANS
AAIPRTZ:	PARAZIT		ANNAnFAnS
AAIPSTT:	PATATIS		AnNANFAnS
	PATATSI	AAnAnGPRR:	GRAnPARAn
AAIWYZZ:	ZAYIWAZ	AAnAnKNNN:	KAnNAnNAN
AAJKNOnP:	KAPOnNAJ		KAnNANNAn
AAJKOTW:	KAWOTAJ		KANNAnNAn
AAJMNOW:	MAWONAJ	AAnAnLMMW:	MAnMAnLWA
AAJNOuRT:	ANTOuRAJ	AAnAnLMPS:	AnPLASMAn
AAKKNNY:	KANYANK	AAnAnMMNS:	SAnMANMAn
AAKKORY:	KARYOKA		SAnMAnMAN
AAKLMNS:	KLASMAN		SANMAnMAn
AAKLMOnS:	KALMASOn	AAnAnNNRT:	ANNAnTRAn
AAKLMOuS:	MAKALOuS		AnNANTRAn
AAKLNPR:	LAKRANP		AnNAnTRAN
AAKLOPR:	KAPORAL	AAnAnNSTZ:	SAnZATAnN
AAKLOSW:	LASKAWO	AAnAnNTTZ:	TAnZAnTAN
AAKLOSY:	KASAYOL		TAnZANTAn
AAKMNOuR:	KOuRAMAN		TANZAnTAn
AAKMNOW:	MAKAWON	AAnBBDMOn:	BOnBADMAn
AAKMNOY:	AMONYAK	AAnBBILY:	BAnBILAY
AAKMNWZ:	KWAZMAN	AAnBDDEF:	DEFAnDAB
AAKNOnPY:	KAPOnNAY	AAnBDDEY:	DEBAnDAY
AAKNSSW:	KWASANS	AAnBDEKL:	KAnDELAB
AAKNSWY:	KWAYANS	AAnBDEKM:	DEBAKMAn
AALLMOY:	LAMAYOL	AAnBDELY:	AnDYABLE
AALMMOuV:	MALAVOuM	AAnBDEMT:	DEBATMAn


Tirages de 7 jetons de AAnBDEnNO à AAnEKMRS - Page 6/28

AAnBDEnNO:	ABAnDONEn	AAnDELMN:	LADEMAnN
AAnBDENO:	ABAnDONE		MAnNDELA
AAnBDIKS:	AnBISKAD	AAnDELOS:	ADOLESAn
AAnBDNOS:	ABONDAnS	AAnDELST:	LADESAnT
AAnBDOSW:	BWOSADAn	AAnDEMPT:	DEPATMAn
AAnBEJRY:	AnBREYAJ	AAnDEnLMR:	MALAnDREn
AAnBELRS:	RASAnBLE	AAnDETYZ:	AnTDEZAY
AAnBFRWZ:	FRAnBWAZ	AAnDIJMN:	DANMIJAn
AAnBGHNR:	BRAnHANG		DAnMIJAN
	BRANHAnG	AAnDIJMR:	JAnDAMRI
AAnBIJST:	JAnBATIS	AAnDIMNR:	MAnDARIN
AAnBILNS:	ANBILAnS	AAnDIMPR:	RAPIDMAn
	AnBILANS	AAnDIMPT:	PIMAnTAD
	BALAnSIN	AAnDINRS:	ANDIRAnS
AAnBIMST:	BATISMAn		AnDIRANS
AAnBKOuTY:	BOuKAnTAY	AAnDINRT:	DIRANTAn
AAnBLMNOn:	BALOnNMAn		DIRAnTAN
AAnBLNPT:	PLATBAnN	AAnDIPPY:	DAPIYAnP
AAnBMOuPY:	MAPYAnBOu	AAnDISTV:	ADVAnTIS
AAnChChMMN:	ChAnMChANM	AAnDISWZ:	SWADIZAn
	ChANMChAnM	AAnDJMMO:	DOMAJMAn
AAnChDIMZ:	MAChAnDIZ	AAnDJMNZ:	DJAZMAnN
AAnChEMNP:	ANPEChMAn	AAnDKMNO:	KOMANDAn
	AnPEChMAN		KOMAnDAN
AAnChEPTY:	ChAPAnTYE	AAnDKMNOn:	KOnMANDAn
AAnChFMNR:	FRANChMAn		KOnMAnDAN
	FRAnChMAN	AAnDMNOnS:	ADAnMSOnN
AAnChGILT:	LAnGIChAT	AAnDMNOS:	DASOMAnN
AAnChGIRT:	GAnTRIChA	AAnDRSUiY:	RAnDUiSAY
AAnChINTT:	ChITATAnN	AAnEFKNN:	ANFAnNKE
AAnChKOuST:	SAnKOuTChA		AnFANNKE
AAnChMNTW:	WATChMAnN	AAnEFLMZ:	MALFEZAn
AAnChNOnPY:	ChAnPYOnNA	AAnEFMPT:	PAFETMAn
AAnDDEGR:	DEGRADAn	AAnEFNNT:	ANFAnTEN
AAnDDEKS:	DEKADAnS		AnFANTEN
AAnDDJJN:	DJAnDJAN	AAnEFOuRY:	AnFOuRAYE
	DJANDJAn	AAnEGGNN:	GAGAnNEN
AAnDDNRR:	DRANDRAn	AAnEGJNR:	AnGRENAJ
	DRAnDRAN	AAnEGTWY:	GAnTYEWA
AAnDDNYY:	DYAnDYAN	AAnEGTWZ:	WAnGATEZ
	DYANDYAn	AAnEIKLV:	EKIVALAn
AAnDEGJM:	GADMAnJE	AAnEILMT:	ALIMAnTE
AAnDEGMN:	AnMEGDAN	AAnEIPST:	APETISAn
	ANMEGDAn	AAnEIRTV:	AVAnTIRE
AAnDEIKP:	AnDIKAPE	AAnEJKOuR:	AnKOuRAJE
AAnDEJNR:	ANJAnDRE	AAnEKLNS:	ALEKSAnN
	AnJANDRE	AAnEKLSV:	VALKAnSE
AAnDEJPT:	DJETAPAn	AAnEKLSY:	AKAnSYEL
AAnDEKLS:	ESKAnDAL	AAnEKMNP:	PAKEMAnN
AAnDEKLV:	VALKAnDE	AAnEKMRS:	SAKREMAn


Tirages de 7 jetons de AAnEKNWY à AANOuRTY - Page 7/28

AAnEKNWY:	ENKWAYAn	AAnIJMNT:	JAnTIMAN
AAnEKPRY:	PAnKREYA		JANTIMAn
AAnELLMR:	LAnMERAL	AAnIKLTT:	ATLAnTIK
AAnELMNT:	LAnTEMAN		TAnTAKIL
	LANTEMAn	AAnIKPRT:	PRATIKAn
AAnELMPT:	PALMAnTE	AAnILMNT:	LANMITAn
AAnELMVY:	MALVEYAn		LAnMITAN
AAnELOuVZ:	ALEVOuZAn	AAnILRTY:	LAnTIRAY
AAnELPTT:	PAnTALET	AAnIMTYZ:	ZAnMITAY
AAnELPWY:	AnPLWAYE	AAnISSST:	ASISTAnS
AAnEMNSY:	ANSEYMAn	AAnJLMOuS:	SOuLAJMAn
	AnSEYMAN	AAnJLOuRT:	LAnTOuRAJ
AAnEMOnSZ:	ASEZOnMAn	AAnJOuPST:	POuSAnTAJ
AAnEMSTT:	TESTAMAn	AAnKKLOuR:	KARAnKLOu
AAnEnGMRT:	GRAnMATEn	AAnKLOuPT:	KAnTALOuP
AAnEnINRS:	AnRASINEn	AAnKMMNO:	KOMAnMAN
AAnEnINSS:	AnSASINEn		KOMANMAn
AAnEnKKNN:	KAnKANNEn	AAnKMMNOu:	KOuMANMAn
	KANKAnNEn		KOuMAnMAN
AAnEnKLNV:	VALKAnNEn	AAnKNRWY:	KWARYAnN
AAnEnKSTW:	AKWEnTAnS	AAnKOuSTY:	SAnKOuTYA
AAnEnMNRT:	AnTREnMAN	AAnLMNNY:	LAnMYANN
	ANTREnMAn		LANMYAnN
AAnEnMPTW:	APWEnTMAn	AAnLNOPT:	PAnTALON
AAnENNPP:	ANPENPAn	AAnLOOuTZ:	OZALAnTOu
	AnPENPAN	AAnLORTY:	ORYAnTAL
AAnEnPSSY:	EnPASYAnS	AAnLOuRTY:	LAnTOuRAY
AAnENPSY:	ENPASYAn	AAnMNOPT:	ANPOTMAn
AAnENRTT:	ANTRETAn		AnPOTMAN
	AnTRETAN	AAnNNOPR:	RANPAnNO
AAnEPRTZ:	PARAnTEZ		RAnPANNO
AAnEPSTY:	SAPAnTYE	AAnNNORY:	AnRANYON
AAnERVWY:	RAnVWAYE	AANNNUiY:	ANNUiYAN
AAnFGILL:	FILALAnG	AANNOnRY:	ANRANYOn
AAnFGMOR:	GRAnFOMA	AAnNOSSY:	ASAnSYON
AAnFIKNT:	FAnNATIK	AAnNOSTY:	ATAnSYON
AAnFILMN:	FINALMAn	AANNOTW:	ANTONWA
AAnFINNT:	AnFANTIN	AANNPRT:	ANTRANP
	ANFAnTIN	AANNPTW:	PWATANN
AAnFISYY:	FIYAnSAY	AANNPTY:	TYANPAN
AAnFLNOT:	LAFONTAn	AANNSST:	SANTANS
AAnFMOnRS:	FRAnMASOn	AANNSSW:	SWASANN
AAnFMOnTW:	AFWOnTMAn	AAnOnPRSY:	SARAnPYOn
AAnGIKLN:	ANGLIKAn	AAnOnSSSY:	SAnSASYOn
	AnGLIKAN	AANOnSSY:	ASANSYOn
AAnGILRT:	GALAnTRI	AANOnSTY:	ATANSYOn
AAnGMNOuY:	MANGOuYAn	AANOPSV:	AVANPOS
	MAnGOuYAN	AANOPTT:	POTANTA
AAnGMOYZ:	ZOMAnGAY	AAnOSSTW:	OSTAnSWA
AAnIILSV:	AVILISAn	AANOuRTY:	ANTOuRAY


Tirages de 7 jetons de AANPSSY à ABEnLNNO - Page 8/28

AANPSSY:	PASYANS	ABEEKST:	BASKETE
AANRTYZ:	ZANTRAY		ESTEBAK
AANSSTW:	SWASANT	ABEELOR:	ELABORE
AAOuRTTY:	RATATOuY	ABEEMPY:	PEMEYAB
AAPRTWY:	PWATRAY	ABEEnIKT:	EnKIBATE
ABBChENO:	BANBOChE	ABEENRY:	ANBREYE
ABBDENO:	BONBADE	ABEFLMS:	BLASFEM
ABBDEOnY:	BOnBADYE	ABEFOuWY:	BWAFOuYE
ABBEELZ:	ZEBABLE	ABEGLMOn:	LAGOnMBE
ABBEILN:	BANBILE	ABEGMNN:	BEGMANN
ABBEJOuY:	JOuBABYE	ABEGNOuV:	GOuVENAB
ABBEKOuT:	BABOuKET	ABEHNOZ:	BAHONEZ
ABBEOTZ:	BABOTEZ	ABEIILT:	ABILITE
ABBILNO:	BANBILO	ABEIKLS:	BASKILE
ABBINOY:	BOBINAY	ABEIKNO:	OKABINE
ABBIOOY:	AYIBOBO	ABEIKNS:	ANBISKE
ABBLOOS:	SOLOBAB		BEKASIN
ABBNNOS:	BONBANS	ABEIKRT:	BAKTERI
ABChDENW:	BWADChEN	ABEILRT:	RETABLI
ABChEELY:	BAChELYE	ABEILSY:	SABLIYE
ABChEILN:	LABIChEN	ABEILTY:	TABLIYE
ABChEMNO:	BONMAChE	ABEILWZ:	BIZAWEL
ABChEnNTW:	BWATChEnN	ABEIMRZ:	MIZERAB
ABChENOY:	ChABONYE	ABEINRT:	REBITAN
ABChEOST:	BAChOSET	ABEINSY:	ANBISYE
ABChIKMO:	KAChIMBO	ABEIRTV:	VERITAB
ABChNOOW:	WOChANBO	ABEISTT:	BATISTE
ABDDIIT:	DABITID	ABEJLNOu:	BOuLANJE
ABDEEKS:	DEKABES	ABEKLNY:	NAYKLEB
ABDEELR:	DELABRE	ABEKLOS:	KALBOSE
ABDEEnLS:	SALDEBEn	ABEKNOnR:	ANKOnBRE
ABDEERY:	DEBRAYE	ABEKNOuT:	BOuKANTE
ABDEEWZ:	DEBWAZE		ENKOuTAB
ABDEINN:	BADINEN	ABEKNOuY:	BOuKANYE
ABDEINT:	DEBITAN	ABEKNOY:	BAKONYE
ABDEJLN:	DJANBEL	ABELMNN:	BLANMEN
ABDEJLS:	DJABLES	ABELMNOu:	EBOuLMAN
ABDELSY:	DYABLES	ABELMOnZ:	MAZOnBEL
ABDEMNO:	ABDOMEN	ABELNNOn:	BALOnNEN
ABDEnNNOn:	BANDOnNEn	ABELNNR:	LABRENN
ABDENNW:	BWADENN	ABELNRT:	TRANBLE
ABDEOuYY:	DEBOuYAY	ABELNST:	LABSENT
ABDIIJR:	DIRIJAB	ABELORY:	BOREYAL
ABDIIMS:	ADMISIB		LABORYE
ABDILOY:	BLIYADO	ABEMOTW:	BAWOMET
ABDLNOW:	BANDWOL	ABEnFMNOu:	MANFOuBEn
ABDNNOS:	BONDANS	ABEnIKNR:	KRABINEn
ABEEFNY:	ABYENFE	ABEnINSS:	EnSANSIB
ABEEGMN:	ANMBEGE	ABEnKNNOu:	BOuKANNEn
ABEEKKW:	KEBEKWA	ABEnLNNO:	BALONNEn


Tirages de 7 jetons de ABENNNR à ADEEJNT - Page 9/28

ABENNNR:	BRANNEN	AChEEJPR:	REPEChAJ
ABENORZ:	REZONAB	AChEEKTZ:	KATEChEZ
ABENOTY:	BAYONET	AChEELTV:	ChEVALET
	BETONAY	AChEELVY:	ChEVALYE
ABENOuRS:	RANBOuSE	AChEEnNNN:	ANChEnNEN
ABENOuWY:	ANBWOuYE		ANChENNEn
ABFKOOnT:	KOnFOTAB	AChEEnNPZ:	ChEnPANZE
ABGIKNR:	GRINBAK	AChEENSY:	EChEYANS
ABGINOZ:	BIZANGO	AChEFIRR:	RAFREChI
ABGIOuRR:	RABOuGRI	AChEIKRY:	YERAChIK
ABIIKLZ:	BAZILIK	AChEIKST:	KATEChIS
ABIILMN:	ALBIMIN	AChEIKTY:	ChAKITYE
ABIIRSZ:	RAZIBIS	AChEINNP:	PENChINA
ABIJOuWZ:	BOuJWAZI	AChEJLOT:	JEChALOT
ABIKLNY:	NAYKLIB	AChEKMOT:	MAChOKET
ABIKLOT:	BAKILOT	AChELNOuS:	SOuLEChAN
ABIKNOS:	BOKANSI	AChELNPR:	ChANPREL
ABIKNOT:	BOTANIK	AChELNPT:	PLANChET
ABIKORZ:	ZABRIKO	AChELNPW:	ChANPWEL
ABILNNOu:	ANBOuLIN	AChELOTZ:	ZEChALOT
ABILNOS:	ALBINOS	AChEnNNOnT:	ChANTOnNEn
ABIMNOnW:	MOnBINWA	AChEnNPTT:	ANChTPEnT
ABIMNOW:	MOBINWA	AChEOuTTY:	ChATOuYET
ABIMOSY:	BIYOMAS	AChIIKRT:	ChAKITRI
ABINOnRY:	ANBRIYOn		RAChITIK
ABINOnSY:	ANBISYOn	AChIKNOT:	ANTIChOK
ABINOST:	BOTANIS	AChINOnPY:	ChANPIYOn
ABIOnSTY:	BITASYOn	AChKLNOO:	LAKOChON
ABIOPWW:	BWAPIWO	AChKOOuTW:	KAWOTChOu
ABJLNOR:	LONBRAJ	AChMOOPT:	MAPOTChO
ABJNNNO:	BONNANJ	AChNNOPY:	ChANPYON
ABKLLOP:	PLAKBOL	AChOuPSTW:	PWATSOuCh
ABKMNNOu:	BOuKMANN	ADDEEGR:	DEGRADE
ABKNNOnW:	KANBWOnN	ADDEENW:	DEDWANE
ABKNOOT:	BAKOTON	ADDEIKS:	DEDIKAS
ABLNOOT:	TONBOLA	ADDEKOuY:	DEYAKOuD
ABLNORY:	LONBRAY	ADDENOZ:	ANDEZOD
ABNNOSS:	BONSANS	ADDIILV:	DIVIDAL
ABOuOuOuTZ:	AZOuBOuTOu	ADDIINS:	DISIDAN
AChChEEEV:	AChEVEChE	ADDINOY:	DODINAY
AChChEOuTT:	ChATChOuTE	ADEEFKL:	DEFALKE
AChDEEKT:	DEKAChTE	ADEEFNN:	FENDANE
AChDEEMN:	DEMANChE	ADEEFPY:	PAYDEFE
AChDEINN:	ChIENDAN	ADEEGJZ:	DEGAJEZ
AChDEKOuY:	DEChOuKAY	ADEEGPR:	DEGRAPE
AChDENOY:	ChADONYE	ADEEGYZ:	EGZAYED
AChDIMNO:	MADIChON	ADEEIKT:	EDIKATE
AChDINSW:	SANDWICh	ADEEJNR:	DANJERE
AChEEFLR:	LAFREChE		DERANJE
AChEEFOuW:	EFAWOuChE	ADEEJNT:	DEJANTE


Tirages de 7 jetons de ADEEJNT à ADEMNOuV - Page 10/28

	DETEJAN	ADEIKKR:	KADERIK
ADEEKKL:	DEKALKE	ADEIKLM:	MEDIKAL
ADEEKLR:	DEKLARE	ADEIKNR:	ANDIREK
	DELAKER	ADEIKNS:	SENDIKA
ADEEKLZ:	DELAKEZ	ADEIKOY:	AKODIYE
ADEEKMS:	DEMASKE	ADEIKTT:	DIKTATE
ADEEKMT:	DEKAMET	ADEILMS:	DESIMAL
ADEEKNP:	DEKANPE	ADEILNS:	DESALIN
ADEEKRT:	DEKRETA	ADEILNZ:	ILANDEZ
ADEEKSZ:	DEZAKSE	ADEILST:	SITADEL
ADEEKYY:	DEYEKAY	ADEILVY:	DIVALYE
ADEELNP:	LEPEDAN	ADEIMNS:	SEDIMAN
ADEELPS:	DEPLASE	ADEIMNT:	DEMANTI
ADEEnIKT:	EnDIKATE		DIMATEN
ADEEnKLN:	DELEnKAN	ADEIMNZ:	MEDIZAN
ADEEnLMN:	LANDEMEn	ADEIMRY:	MADRIYE
ADEEnLNY:	LADEnNYE	ADEIMST:	DEMITAS
ADEEnMNN:	NANDEMEn	ADEIMTY:	IMEDYAT
ADEEnNNP:	DEPANNEn	ADEINOT:	ODINATE
ADEENNS:	ENDESAN	ADEINPS:	APENDIS
ADEEnNSS:	EnDESANS	ADEINRY:	ADRIYEN
ADEENNY:	ANDENYE	ADEINST:	DANSITE
ADEENPS:	DEPANSE		DISETAN
ADEENRT:	ANTREDE	ADEINTV:	DEVANTI
ADEENRV:	REVANDE	ADEINTY:	ETIDYAN
ADEENSV:	DESEVAN	ADEIRSY:	RADIYES
	DEVANSE	ADEIRVY:	DEVIRAY
ADEEPRT:	PREDATE		DRIVAYE
ADEEPRV:	DEPRAVE	ADEIRWZ:	DERIZWA
ADEERTV:	DETRAVE	ADEJKLO:	DEKOLAJ
ADEERVY:	DEVARYE	ADEJNOuV:	DEVANJOu
ADEESTV:	DEVASTE	ADEJOuRT:	RETOuDAJ
ADEFIMN:	DEFANMI	ADEKMNO:	KOMANDE
ADEFINR:	DIFERAN		MADOKEN
ADEFIRR:	RAFREDI	ADEKMNOn:	KOnMANDE
ADEFIRW:	REFWADI	ADEKMOO:	AKOMODE
ADEFLOR:	ALFREDO	ADEKNNO:	KONDANE
ADEFNOnR:	ANFOnDRE	ADEKNOnS:	KOnDANSE
ADEGGMO:	DEMAGOG	ADEKNOuR:	KOuRANDE
ADEGGOP:	PEDAGOG	ADEKOOnY:	AKODEYOn
ADEGKNO:	DEKAGON	ADEKOTY:	OKTAYED
ADEGLOY:	DYALOGE	ADELMNN:	LANDMEN
ADEGNNN:	NANDENG	ADELMNP:	PLEDMAN
ADEGNNR:	GRENNAD	ADELMOT:	MOTADEL
ADEGNOuT:	DEGOuTAN	ADELNOZ:	OLANDEZ
ADEIIRT:	ARIDITE	ADELOuTY:	LADOuYET
ADEIIST:	ASIDITE	ADEMNNOn:	ANDENMOn
ADEIJNN:	ENDIJAN	ADEMNOT:	ADMETON
ADEIJNY:	JADINYE	ADEMNOunT:	DETOunMAN
ADEIJTV:	DAVETIJ	ADEMNOuV:	DEVOuMAN


Tirages de 7 jetons de ADEnEnNTT à AEEJLNR - Page 11/28

ADEnEnNTT:	TEnTEnNAD		LIMOnNAD
ADEnIJNS:	EnDIJANS	ADIMNNO:	DOMINAN
ADEnIKMS:	MISKADEn		NANDOMI
ADEnIMNOn:	AMIDOnNEn	ADIMOnSY:	ADMISYOn
ADEnINPR:	EnPRIDAN	ADINNOuS:	ANSOuDIN
ADEnMNNO:	ANDEnMON	ADINOSY:	ADISYON
ADENNNO:	ADONNEN	ADINOTT:	ANTIDOT
ADEnNNOP:	PADONNEn	ADINPSS:	DISPANS
ADENNOnP:	PADOnNEN	ADINRTT:	DANTRIT
ADENNOY:	DANNOYE	ADINRVY:	DRAYVIN
ADENOPY:	PONYADE	ADINSST:	DISTANS
ADENOSY:	ODYANSE	ADIOnRVY:	IDRAVYOn
ADENOTT:	ETANDOT	ADJKKOO:	DJAKOKO
ADENOuRV:	RANDEVOu	ADJKLMO:	MALDJOK
ADENOWZ:	DANWEZO	ADJKLNO:	JANKLOD
ADENOYZ:	ADEZYON	ADJNOuOuV:	DOuVANJOu
	ANDYOZE	ADKKNOO:	KONKODA
ADENRST:	TANDRES	ADKLMOY:	MALDYOK
ADENTTUi:	UiTEDTAN	ADKNNOW:	DAKWONN
ADEOPTW:	DEPOTWA	ADKOORT:	DOKTORA
ADEOuTWZ:	DEZOuTWA	ADLMNOY:	MONDYAL
ADESWWZ:	SWEDWAZ	ADMNOPW:	PWOMNAD
ADFIKNOn:	KOnFIDAN	ADOOnPSY:	ADOPSYOn
ADFIKNOu:	KAFOuNDI	AEEELTV:	ELEVATE
ADFILOR:	FLORIDA	AEEEnLRT:	ALEnTERE
ADFIOPT:	ADOPTIF	AEEFKTY:	KAFETYE
ADFOnOnSY:	FOnDASYOn	AEEFLNN:	ENFENAL
ADGMNOuOu:	MADOuNGOu	AEEFLRY:	LAFERYE
ADGNNOR:	GRANDON	AEEFMNN:	ANFEMEN
ADIIJLN:	DILIJAN	AEEFMNT:	FEMANTE
ADIIJNR:	DIRIJAN	AEEFMWZ:	MAFWEZE
ADIIKMN:	DINAMIK	AEEFNRY:	EFREYAN
ADIIKNT:	IDANTIK	AEEFRTY:	RATYEFE
ADIIKTT:	DIKTATI	AEEGGLO:	EGALEGO
ADIILMT:	DILAMIT	AEEGILT:	EGALITE
ADIILPS:	PALIDIS	AEEGILZ:	EGALIZE
ADIILTT:	ALTITID	AEEGLNW:	EGLENWA
	LATITID	AEEGMNZ:	EGZAMEN
ADIIMNS:	DINAMIS	AEEGNRS:	ANGRESE
ADIIMNT:	DINAMIT	AEEGNTZ:	EGZANTE
ADIIMNV:	MADIVIN	AEEGRSW:	GRESEWA
ADIIMPR:	PIRAMID	AEEGTYZ:	EGZEYAT
ADIIPTT:	APTITID	AEEIJKL:	EJAKILE
ADIIRST:	ARISTID	AEEIKLL:	ALEKILE
ADIIRSY:	RADIYIS	AEEINSV:	ANIVESE
ADIKMNO:	DOKIMAN	AEEIPPY:	EPAPIYE
ADIKORS:	SIKRADO	AEEITTZ:	ETATIZE
ADIKOTW:	KAWOTID	AEEJLMN:	LEJEMAN
ADILMNO:	LIMONAD		MELANJE
ADILMNOn:	LANMIDOn	AEEJLNR:	JENERAL


Tirages de 7 jetons de AEEJNRT à AEFMNOuT - Page 12/28

AEEJNRT:	ETRANJE	AEENPTT:	TANPETE
AEEKKRR:	AKREKRE	AEENPTZ:	PEZANTE
AEEKLMR:	REKLAME	AEENRTV:	EVANTRE
AEEKLMT:	TELEMAK	AEENRYY:	AYERYEN
AEEKLNS:	ANSEKLE	AEEnTVVY:	VATEVYEn
AEEKLSW:	KALEWES	AEENTWY:	NETWAYE
AEEKLSY:	ESKALYE	AEEOPRT:	OPERATE
AEEKMNW:	AMWENKE	AEEOPRV:	EVAPORE
AEEKMNZ:	EKZAMEN	AEEPPRR:	PREPARE
AEEKNPS:	ESKANPE	AEEPRST:	TREPASE
AEEKNRS:	ANSEKRE	AEEPRSY:	APRESYE
AEEKNST:	EKSTENA	AEEPRSZ:	PARESEZ
AEEKPRS:	RESKAPE		REPASEZ
AEEKPST:	AKSEPTE	AEERSTV:	TRAVESE
AEEKPTW:	PATEKWE	AEERSVW:	RESEVWA
AEEKRTZ:	RAKETEZ	AEERSWY:	YERESWA
AEEKSSY:	ASEKSYE	AEERTVY:	VARYETE
AEELMNT:	LEMATEN	AEERTWZ:	RAZWETE
	MATENEL	AEERVWZ:	REZEVWA
AEELMRZ:	MALEREZ	AEFGILN:	FILANGE
AEELNPR:	LANPERE	AEFGINT:	NEGATIF
AEELNST:	ENSTALE	AEFGIRS:	AGRESIF
AEELNTV:	ENTEVAL	AEFIJRS:	JESIFRA
AEELPRZ:	LAPEREZ	AEFIKLM:	MALEFIK
AEELRSY:	SEREYAL	AEFIKLT:	FAKILTE
AEELTTV:	LAVETET	AEFIKNR:	AFRIKEN
AEEMNNV:	EVENMAN	AEFIKNY:	KAFEYIN
AEEMNRZ:	EREZMAN	AEFIKRS:	FRIKASE
AEEMNST:	SEMANTE	AEFIKRY:	EFRAYIK
AEEnFMOT:	EnFOMATE	AEFILMN:	LAFIMEN
AEEnIKMR:	AMERIKEn	AEFILMS:	MALEFIS
AEEnJLRY:	ALJERYEn	AEFIMNZ:	ANFIZEM
AEEnJNRS:	EnJERANS	AEFIMSW:	MASWIFE
AEEnKMSW:	AMWEnSKE	AEFINNR:	FARINEN
AEEnKRTV:	KATREVEn	AEFINNS:	FINANSE
	VEnKATRE	AEFINRY:	FINERAY
AEEnLPRY:	EnPERYAL	AEFINSY:	FIYANSE
AEEnLSTW:	SEnTELWA	AEFINTZ:	FANTEZI
AEEnLSYZ:	SALEZYEn	AEFIPSY:	PASIFYE
AEEnMNSS:	SEnSEMAN	AEFISST:	SATISFE
AEEnMNST:	ESTAMEnN	AEFITVY:	VEYATIF
AEENNNV:	ENNEVAN	AEFKLNO:	KAFENOL
AEEnNOnSZ:	ASEZOnNEn	AEFKNOnS:	KANSOnFE
AEENNRT:	ANTRENE	AEFKNRS:	FARENKS
AEENNRY:	ARENYEN		FREKANS
AEENNTV:	ENVANTE	AEFKOnSY:	AFEKSYOn
AEENPRT:	ANPETRE	AEFLNNN:	FLANNEN
	TANPERE	AEFLNOS:	SELOFAN
AEENPST:	ANPESTE	AEFLOST:	LAFOSET
	ESPANTE	AEFMNOuT:	ETOuFMAN


Tirages de 7 jetons de AEFMOST à AEINNSS - Page 13/28

AEFMOST:	ATMOSFE	AEIKLMT:	KALIMET
AEFNNNOu:	ANFOuNEN		METALIK
AEFNNOS:	ANFONSE	AEIKLNP:	PELIKAN
AEFNOPW:	PWOFANE	AEIKLPY:	LEKIPAY
AEFNOTW:	AFWONTE	AEIKLST:	ELASTIK
AEFNOTY:	FAYETON	AEIKLTV:	VETIKAL
AEFNOuPT:	PAFOuTEN	AEIKMNP:	EKIPMAN
AEFNRSZ:	FRANSEZ	AEIKMRS:	SERAMIK
AEFORTW:	OTREFWA	AEIKMST:	MASTIKE
AEFOTWY:	ATWOFYE	AEIKNNT:	TAKINEN
AEGGIZZ:	ZIGZAGE	AEIKNPT:	KAPITEN
AEGGNOZ:	EGZAGON	AEIKNRT:	RANKITE
AEGIJNZ:	EGZIJAN	AEIKNRY:	ANKRIYE
AEGILSY:	GLASIYE	AEIKNST:	EKSITAN
AEGINNS:	SANGINE		KANISTE
AEGINOZ:	AGONIZE	AEIKNSV:	VAKSINE
	OGANIZE	AEIKNTT:	KANTITE
AEGIPSY:	GASPIYE	AEIKPRT:	PRATIKE
AEGIRST:	SIGARET	AEIKRTY:	KREYATI
AEGIRTV:	GRAVITE	AEIKSSY:	KASEYIS
AEGKNOZ:	EKZAGON	AEIKSTT:	ESTATIK
AEGKNRT:	REKTANG	AEILMNR:	MERILAN
AEGKNST:	GANKSTE		MINERAL
AEGLNNOn:	GALOnNEN	AEILMNT:	TEMINAL
AEGLNRT:	TRANGLE	AEILMNZ:	LANMIZE
AEGMNNO:	MANGONE	AEILMTY:	LAMITYE
AEGMNRT:	GRANMET	AEILMTZ:	ZALIMET
AEGNNSW:	SANGWEN	AEILNRT:	NATIREL
AEGNOuVY:	GOuVENAY	AEILNTY:	ITALYEN
AEGOnRSY:	AGRESYOn	AEILPRS:	ESPIRAL
AEIIJLT:	AJILITE	AEILPRY:	LAPRIYE
AEIIJMN:	IMAJINE	AEILRST:	RESITAL
AEIIKLM:	AKIMILE	AEILRTY:	LATRIYE
	IMAKILE		LERITAY
AEIILNV:	ALEVINI	AEILRTZ:	REZILTA
AEIIMNT:	IMANITE	AEILRVY:	LARIVYE
AEIJKLN:	ANJELIK	AEILSTT:	SATELIT
AEIJLNS:	ANJELIS	AEILWZZ:	AZIZWEL
AEIJLNT:	ANTIJEL	AEIMNNR:	ANRIMEN
	JELATIN		MARINEN
	JENITAL	AEIMNNT:	MATINEN
AEIJLNV:	EVANJIL	AEIMNOZ:	AMONIZE
AEIJMNR:	REJIMAN	AEIMNST:	SIMANTE
AEIJMOR:	EMORAJI	AEIMNTT:	MATINET
AEIJNNT:	ANTIJEN	AEIMNTY:	ANMIYET
AEIJPYZ:	PIYAJEZ	AEIMOTY:	ATEMIYO
AEIKKLL:	KALKILE	AEIMSTY:	MAYETIS
AEIKKMN:	MEKANIK	AEINNPT:	PATINEN
AEIKKSY:	KISKEYA	AEINNPY:	ANNIPYE
AEIKLMS:	MAKSILE	AEINNSS:	SASINEN


Tirages de 7 jetons de AEINPPY à AEMNOuTV - Page 14/28

AEINPPY:	PEPIYAN	AEKMNST:	SEKTANM
AEINPRT:	REPANTI	AEKMOPR:	POMERAK
AEINPRY:	REPIYAN	AEKNNOnP:	KAPOnNEN
AEINPYZ:	PEYIZAN	AEKNNOuT:	ENKOuTAN
AEINRYZ:	ZARIYEN	AEKNNPT:	KAPTENN
AEINSTV:	ANVITES	AEKNOnSY:	AKSYOnNE
AEINSVY:	SIVEYAN	AEKNOPR:	KONPARE
AEINSYY:	AYISYEN	AEKNORT:	RAKONTE
AEINSZZ:	SIZANEZ	AEKNOSY:	AKSYONE
AEIOPSZ:	ASIPOZE	AEKNOTW:	KAWOTEN
AEIPRVY:	PREYAVI	AEKOnPRT:	KOnPARET
AEIRRST:	RATRESI	AEKOnRTY:	KOnTRAYE
AEIRTTW:	TERITWA	AEKOnSWY:	EKWASYOn
AEITTYZ:	ZATIYET	AELLNNP:	LAPLENN
AEJJMNN:	JENJANM	AELLNOS:	SOLANEL
AEJJNNN:	JENNJAN	AELLOVY:	ALVEYOL
AEJLMNO:	MAJOLEN	AELMMNO:	MALOMEN
AEJLNNOu:	LAJOuNEN	AELMMNZ:	MANMZEL
AEJLNOR:	RALONJE	AELMNOnT:	MALOnNET
AEJLNOuY:	JOuNALYE	AELMNOT:	ALONTEM
AEJNOnPS:	PESOnNAJ	AELMNOuS:	SOuLAMEN
AEJNOPS:	PESONAJ	AELMNSW:	MALSWEN
AEJNOPT:	PATOJEN	AELMOYZ:	MALOZYE
AEJNOPZ:	JAPONEZ	AELNNNP:	PLANNEN
AEJOPPW:	PWOPAJE	AELNNOnT:	TALOnNEN
AEKKMNO:	KAMOKEN	AELNNOS:	ENSOLAN
AEKKNOnR:	KOnKERAN	AELNNPT:	PLANTEN
AEKKNOnS:	KOnSEKAN	AELNNTY:	LYETNAN
AEKLLOT:	LAKOLET	AELNOnPS:	LAPESOnN
AEKLMNO:	MAKONEL	AELNOSZ:	SALEZON
AEKLMNOu:	EKOuLMAN	AELNOTW:	LAWONTE
AEKLNNO:	KALONEN	AELNOuST:	LATOuSEN
AEKLNNOn:	KALOnNEN	AELNPSW:	SANPWEL
AEKLNOR:	KORALEN	AELOnPTZ:	PLATEZOn
AEKLNOW:	KAWOLEN	AELOnRSY:	RELASYOn
AEKLNRS:	LARENKS	AELOnSVY:	LEVASYOn
AEKLOnPY:	KOnPAYEL	AELOPRS:	PARESOL
AEKLORT:	ARETKOL	AELOPST:	SALOPET
AEKLOuYY:	KOuLYEYA	AELOPSY:	ESPAYOL
AEKMMNN:	KANMENM	AEMMMNN:	MENMMAN
AEKMNNOn:	MAKOnNEN	AEMNNOnS:	MASOnNEN
AEKMNNW:	MWENNKA	AEMNNSW:	ANMWENS
AEKMNOnS:	KOnMANSE	AEMNORT:	OTREMAN
	KOnMESAN	AEMNORW:	WOMAREN
AEKMNOnT:	MEKOnTAN	AEMNORZ:	ANMOREZ
AEKMNOS:	KOMANSE	AEMNOST:	MONASTE
	KOMESAN	AEMNOuRS:	SOuMAREN
AEKMNOT:	KOMANTE	AEMNOuRZ:	ANMOuREZ
AEKMNOuS:	KOuMANSE	AEMNOuTT:	TOuMANTE
AEKMNOW:	MAWOKEN	AEMNOuTV:	OuVETMAN


Tirages de 7 jetons de AEMNPST à AFKOnRSY - Page 15/28

AEMNPST:	SEPTANM		TAONNEN
AEMNRTT:	TRETMAN	AEnNNOTT:	TATONNEn
AEMNSTY:	SANTYEM	AENNNPW:	NANPWEN
AEMORTY:	MATERYO	AEnNOnPWZ:	PWAZOnNEn
AEMORTZ:	ZAMORET	AEnNOnSTY:	EnTANSYOn
AEMTWYZ:	TWAZYEM	AENNOnSV:	SAVOnNEN
AEnEnFLMZ:	MAZEnFLEn	AEnNOnSVY:	EnVANSYOn
AEnEnGMRW:	MAREnGWEn	AENNOnTT:	TATOnNEN
AEnEnINSS:	EnSASINEn	AEnNOPST:	EnPOTANS
AEnEnLMMN:	MALMEnNEn	AENNOPT:	ENPOTAN
AEnEnLPST:	PLASEnTEn	AENNOuRT:	ANTRENOu
AEnFGOuRY:	GRAFOuYEn	AEnNOVYZ:	EnVAZYON
AEnFIKRY:	EnFRAYIK	AENNPRR:	REPRANN
AEnFINRT:	EnFANTRI	AENNPRT:	ANPRENT
AEnFIRYZ:	FARIZYEn		PRENTAN
AEnFLNOnP:	PLAFOnNEn		PRETANN
AEnFLOnSY:	EnFLASYOn	AEnNRRTY:	REnNRAYT
AEnGGNNR:	GANGREnN	AENNRTT:	TRANTEN
AEnGLNNO:	GALONNEn	AENNSYZ:	ZANSYEN
AEnGMMNOn:	MANGOnMEn	AENOnPSY:	PESOnNAY
AEnGNOnRY:	GARYOnNEn	AENOnVYZ:	ENVAZYOn
AEnGNOPT:	PEnTAGON	AENORSY:	SENARYO
AEnIJMSY:	MAJISYEn	AENORTZ:	RATEZON
AEnIKKRY:	KEnKAYRI	AENOSTT:	TETANOS
AEnIKLMS:	MASKILEn	AENOTTY:	ANTOTYE
AEnIKNNR:	RIKANNEn	AENPRSZ:	PREZANS
AEnIKNPT:	KAPITEnN	AENRSTV:	VANTRES
AEnIKRSY:	KARISYEn	AENSWYY:	SWENYAY
AEnILMNV:	ANVLIMEn	AEOnPSSY:	ASPESYOn
AEnILNSY:	SALINYEn	AEOnSSTY:	ESTASYOn
AEnIMNPS:	MASPINEn	AEOOPWY:	AYEWOPO
AEnINTTY:	TITANYEn	AEOSWWY:	YEWOSWA
AEnINVWZ:	VWAZINEn	AEOuSTTY:	SATOuYET
AEnIRVWY:	IVWARYEn	AEOuTTYZ:	ZATOuYET
AEnISTWY:	SITWAYEn	AFGIIRT:	GRAFITI
AEnKLNNO:	KALONNEn	AFGOORT:	OTOGRAF
AEnKMNNO:	MAKONNEn	AFIIKPS:	PASIFIK
AEnKNNOP:	KAPONNEn	AFIILMN:	MALFINI
AEnKNOnPR:	KRAPOnNEn	AFIJKNOu:	KAFOuNJI
AEnKNOnRY:	KARYOnNEn	AFIKNOS:	OFISKAN
AEnKNOnSY:	EnKOnSYAN	AFIKNRS:	FRANSIK
AEnLLOTZ:	LEnZALOT	AFIKORT:	FAKTORI
AEnLMNOY:	NOMALYEn	AFILLOnP:	FILAPLOn
AEnLMPTW:	TEnMPLAW	AFILNOT:	LAFOTIN
AEnLNNOT:	TALONNEn	AFIMNOS:	FONMASI
AEnLNOSS:	EnSOLANS	AFJMNOW:	FWONMAJ
AEnMNNOS:	MASONNEn	AFKNNOY:	KONFYAN
AEnNNOnPT:	TANPOnNEn	AFKNOnSY:	KOnFYANS
AEnNNOSV:	SAVONNEn	AFKNOSY:	FAKSYON
AENNNOT:	ANTONEN	AFKOnRSY:	FRAKSYOn


Tirages de 7 jetons de AFLMOPT à AIMNNOT - Page 16/28

AFLMOPT:	PLATFOM	AIIMNTV:	VITAMIN
AFMNOTW:	FWOTMAN	AIIMRST:	RIMATIS
AFMOOnSY:	FOMASYOn	AIINPRS:	ASPIRIN
AFNOuRSS:	SOuFRANS	AIIPRST:	PATISRI
AFOOuPTY:	FOuYAPOT		TIPARIS
AFOOuSTT:	ATOuTFOS	AIJLNOS:	LAJONIS
AGGLOOT:	GOLGOTA	AIJLNOuS:	JOuNALIS
AGIIMNR:	IMIGRAN	AIJNSSW:	JWISANS
AGIIMRS:	SIMAGRI	AIJORSV:	SOVAJRI
AGIIRST:	GITARIS	AIKKLLO:	ALKOLIK
AGIKLOR:	AGRIKOL	AIKKLOT:	KATOLIK
AGILMNS:	GLISMAN	AIKKNOnR:	KOnKIRAN
AGILMOP:	POLIGAM	AIKKNOT:	NAKOTIK
AGILNNP:	PLANING	AIKKNOY:	KOKAYIN
AGILNOuT:	ANGLOuTI	AIKLMOZ:	KAMIZOL
AGILNOZ:	GAZOLIN	AIKLNOP:	AKONPLI
AGILOPT:	GALIPOT	AIKLNOV:	VILOKAN
AGINNOT:	ANTIGON	AIKLNOW:	KAWOLIN
AGINNOZ:	GANIZON	AIKLNOZ:	ANKILOZ
AGINOST:	TIGASON	AIKLNRT:	TRANKIL
AGINOSW:	ANGWOSI	AIKLOTW:	KILOWAT
AGINRTY:	TRIYANG	AIKLPST:	PLASTIK
AGKNOOT:	OKTAGON	AIKLRST:	KRISTAL
AGKNOuOuW:	KANGOuWOu	AIKMNOW:	AKWONIM
AGMNNOuR:	GRANMOuN	AIKMOYZ:	MOZAYIK
AGMNOOW:	AGWONOM	AIKNNOnT:	KOnTINAN
AGMNOuPW:	GWOuPMAN	AIKNNOV:	KANNIVO
AGMOPRW:	PWOGRAM	AIKNOnST:	KOnSANTI
AGNNNOO:	NONAGON	AIKNOPY:	KONPAYI
AGNNOTY:	TYOGANN	AIKNORY:	KARIYON
AGNOTVW:	GWOVANT	AIKNOTT:	OTANTIK
AIIJLNV:	VIJILAN	AIKORSW:	KAWOSRI
AIIKKLR:	AKRILIK	AIKOuPPS:	PASPOuKI
AIIKLLT:	LAKILTI	AIKOuTWZ:	KOuTWAZI
AIIKLMS:	SIMILAK	AILLOPS:	LAPOLIS
AIIKLNZ:	LAKIZIN	AILLOPT:	LOPITAL
AIIKLPT:	PATIKIL	AILMNOR:	LANMORI
AIIKLSV:	AKSIVIL	AILMNOZ:	IZOLMAN
AIIKMTY:	KAYIMIT	AILMRUiZ:	MARILUiZ
AIIKNPS:	ISPANIK	AILNNOY:	NAYILON
	KAPISIN	AILNNTW:	LANNWIT
AIIKSTT:	ATISTIK	AILNOnVW:	LAVIWOnN
AIIKSTV:	AKTIVIS	AILNOVY:	ALIVYON
AIILMNV:	MALVINI	AILNOYZ:	ALIZYON
AIILMNY:	IMILYAN	AILOPPS:	POPILAS
AIILNSS:	LASISIN	AILOPRS:	SALOPRI
AIILNSY:	INISYAL	AILRTVY:	TRIVYAL
AIILSSY:	ALSIYIS	AIMMNNO:	MONIMAN
AIIMNNR:	RIMINAN	AIMMNOuT:	TIMAMOuN
AIIMNST:	AMNISTI	AIMNNOT:	ANTONIM


Tirages de 7 jetons de AIMNNOZ à AnBNOOTW - Page 17/28

AIMNNOZ:	ZANNIMO	AMNOuOuOuZ:	AZOuMOuNOu
AIMNORW:	MORINWA	AMOOPTY:	MAPOTYO
AIMNOuRS:	SOuMARIN	AMOOuPPW:	AMOuPWOP
AIMOnSTY:	MITASYOn	AnAnAnDPST:	PAnDAnSTAn
AINNNTW:	NANNWIT	AnAnBChLLN:	BLAnChLAnN
AINNORY:	INYORAN	AnAnDDEEnP:	EnDEPAnDAn
AINNOSS:	INOSANS	AnAnDDESS:	DESAnDAnS
AINNOST:	INOSANT	AnAnDDIKT:	DIKDAnTAn
AINNOuRS:	NOuRISAN	AnAnDEnLMN:	NAnLAnDMEn
AINNOVW:	ANVIWON	AnAnDIJMN:	DAnMIJAnN
AINNPRS:	SIPRANN	AnAnDKMMO:	KOMAnDMAn
AINNPSS:	SISPANN	AnAnDKMNO:	KONMAnDAn
AINOnVWZ:	ZANVIWOn	AnAnEGJMR:	GRAnMAnJE
AINOPPY:	PAPIYON	AnAnEGMMT:	GETMAnMAn
AINOPST:	SIPOTAN	AnAnEKKNN:	KAnKAnNEN
AINORSY:	IYORANS	AnAnEKMMT:	KETMAnMAn
AINOuSSS:	SANSOuSI	AnAnEMNRT:	AnTRENMAn
AINOuSTV:	TOuNAVIS	AnAnEMPRS:	AnPRESMAn
AINPRTW:	PWATRIN	AnAnEMRSS:	RESAnSMAn
AINPSSW:	PWISANS	AnAnEMRSY:	RAnSEYMAn
AINSSTY:	SYANTIS	AnAnFIMNS:	FINAnSMAn
AIOnSSTY:	SITASYOn	AnAnKMMOS:	KOMAnSMAn
AIOOSSW:	ASOWOSI	AnAnKMOnST:	KOnSAnTMAn
AIOPSTY:	SAPOTIY	AnAnKMOnTT:	KOnTAnTMAn
AJLLOOuW:	LAWOuJOL	AnBBEKLO:	BEKAnBOL
AKKLNOnS:	KLAKSOnN	AnBBEnINO:	AnBOBINEn
AKKOORT:	KOKORAT	AnBChDEER:	DEBRAnChE
AKLMOSY:	KALSYOM	AnBDDEMO:	DEBODMAn
AKLNOWZ:	KLWAZON	AnBDEEMR:	DEMAnBRE
AKLOOTV:	OTOKLAV	AnBDEGIR:	BRIGAnDE
AKLOSTW:	KASTWOL	AnBDELOuY:	BAnDOuLYE
AKNNOnPR:	KOnPRANN	AnBDEnNNO:	BAnDONNEn
AKNNOPR:	KRANPON	AnBDENNOn:	BAnDOnNEN
AKNNOPT:	PANNKOT	AnBDIILM:	MAnDIBIL
AKNNOPY:	KONPANY	AnBDIOnSY:	BAnDISYOn
AKNNORT:	RANKONT	AnBDMNOnOu:	BOuDOnNMAn
AKNNOST:	KONSTAN	AnBEFMNOu:	MAnFOuBEN
AKNOOnPY:	KONPAYOn	AnBEINSS:	ENSAnSIB
	KOnPAYON	AnBEINST:	BISAnTNE
AKNOOnPZ:	KOnPOZAN	AnBEIOSY:	OBEYISAn
AKNOOYZ:	OKAZYON	AnBEISYZ:	AnBISYEZ
AKOOnSVY:	VOKASYOn	AnBEKLNOn:	KOnBELAnN
ALMMOnOuT:	MALMOuTOn	AnBEKNNOu:	BOuKAnNEN
ALMNOOS:	SALOMON	AnBEKNOR:	AnKONBRE
ALMOOPT:	OMOPLAT	AnBEnGGRR:	GRAnBREnG
ALMOPPW:	MALPWOP	AnBEnGNRR:	GRAnBREnN
ALNOOTZ:	ZOTOLAN	AnBINORY:	AnBRIYON
ALNOSVY:	VYOLANS	AnBINOSY:	AnBISYON
ALOuOuPWW:	WOuLAWOuP	AnBKNNOW:	KAnBWONN
AMMNOOY:	AMONYOM	AnBNOOTW:	TOWOBAnN


Tirages de 7 jetons de AnChDEEJR à AnEFGLMOn - Page 18/28

AnChDEEJR:	DEREChAnJ		LODYAnSE
AnChDEEKL:	DEKLAnChE	AnDEMNNO:	AnDENMON
AnChDEELY:	ChAnDELYE	AnDEMNOuT:	DETOuNMAn
AnChDEILM:	LEDIMAnCh	AnDEMOuPY:	DEPOuYMAn
AnChEEMST:	MEChAnSTE	AnDEnIMNR:	MAnDRINEn
AnChEENNN:	AnChENNEN	AnDEnIPRS:	EnPRIDAnS
AnChEENPZ:	ChENPAnZE	AnDEOnSTY:	DETAnSYOn
AnChEGIRR:	GRAnChIRE	AnDEOPTV:	DEVAnPOT
AnChEGJNO:	ChENAnGOJ	AnDFIKNO:	KONFIDAn
AnChEIOnTY:	EChAnTIYOn	AnDFIKOnS:	KOnFIDAnS
AnChEnIKNP:	PIChKAnNEn	AnDGIMOuZ:	GOuMAnDIZ
AnChEnNNOT:	ChAnTONNEn	AnDGORYZ:	GRAnDYOZ
AnChENNOnT:	ChAnTOnNEN	AnDIIJLS:	DILIJAnS
AnChENPTT:	AnChTPENT	AnDIILPT:	AnPLITID
AnChINOPY:	ChAnPIYON	AnDIIRST:	DISAnTRI
AnDDEIRV:	VAnDREDI	AnDIIRTV:	VIDIRAnT
AnDDIINV:	DIVIDAnN	AnDIJLOuT:	TIJOuDLAn
AnDEEFLZ:	DEZAnFLE	AnDIKNOR:	AnDOKRIN
AnDEEFMY:	DEMEFYAn	AnDILMNO:	LAnMIDON
AnDEEGLS:	DESAnGLE	AnDILOTZ:	ZAnDOLIT
AnDEEKLN:	DELENKAn	AnDIMNOS:	DOMINAnS
AnDEELMN:	LAnDEMEN	AnDIMOnSY:	DIMAnSYOn
AnDEELMT:	DEMAnTLE	AnDIMOuST:	TOuDISMAn
AnDEEMNN:	NAnDEMEN	AnDIOnRSY:	SAnDRIYOn
AnDEEnFIR:	EnDIFERAn	AnDIOnSTY:	DAnTISYOn
AnDEEnGRY:	EnGREDYAn	AnDKMNOOu:	DOuKOMAnN
AnDEEnKLS:	DELEnKAnS	AnDKOOPS:	AnDOSKOP
AnDEENNP:	DEPAnNEN	AnEEELMT:	ELEMAnTE
AnDEENOT:	ETAnDONE	AnEEEnRST:	EnTERESAn
AnDEENSS:	ENDESAnS	AnEEFKRT:	FREKAnTE
AnDEERTV:	DEVAnTRE	AnEEGLMR:	REGLEMAn
AnDEERVZ:	REVAnDEZ	AnEEIMPS:	EMAnSIPE
AnDEFIRS:	DIFERAnS	AnEEIRTV:	AnVERITE
AnDEFNOR:	AnFONDRE	AnEEJLRT:	LETRAnJE
AnDEGIRZ:	GRAnDIZE	AnEEJNRS:	ENJERAnS
AnDEGOuST:	DEGOuTAnS	AnEEKLSS:	EKSELAnS
AnDEIITT:	IDAnTITE	AnEEKSTY:	AnKSYETE
AnDEIJLS:	DELIJAnS	AnEELMRY:	REYELMAn
AnDEIJMN:	DEMIJAnN	AnEELPTZ:	PLEZAnTE
AnDEIJNS:	ENDIJAnS	AnEELSSY:	ESAnSYEL
AnDEIJSV:	DIVEJAnS	AnEEMNSS:	SENSEMAn
AnDEIKST:	TAnDISKE	AnEEnIJLT:	EnTELIJAn
AnDEINPR:	ENPRIDAn	AnEEnKKOnS:	EnKOnSEKAn
AnDEIPRZ:	PREZIDAn	AnEEnKOnPT:	EnKOnPETAn
AnDEIPSS:	DISPAnSE	AnEEnKOnVY:	EnKOnVEYAn
AnDEIRSY:	SAnDRIYE	AnEEnLMPS:	SEnPLEMAn
AnDEKMNO:	KONMAnDE	AnEEPRSS:	ESPERAnS
AnDEKNOS:	KONDAnSE	AnEEPRTZ:	PREZAnTE
AnDELMOuW:	DEWOuLMAn	AnEEPSTY:	SEPAnTYE
AnDELOSY:	DOLEYAnS	AnEFGLMOn:	GOnFLEMAn


Tirages de 7 jetons de AnEFIJRW à AnIIRSST - Page 19/28

AnEFIJRW:	JWIFERAn	AnEKNOSS:	KONESAnS
AnEFINRT:	ENFAnTRI	AnEKOnPRS:	REKOnPAnS
AnEFIRSZ:	FRAnSIZE	AnEKOnRRT:	RAnKOnTRE
AnEFKNOS:	KAnSONFE	AnEKOnRST:	KOnSAnTRE
AnEGGNNR:	GAnGRENN	AnEKOPSZ:	EKSPOZAn
AnEGGOYZ:	GAnGOZYE	AnELMOuSV:	SOuLEVMAn
AnEGIJLN:	NEGLIJAn	AnELNOSS:	ENSOLAnS
AnEGIJSZ:	EGZIJAnS	AnELORST:	TOLERAnS
AnEGILMY:	MAnGLIYE	AnEMMOuTV:	MOuVMAnTE
AnEGIMNT:	MAnNIGET	AnEMNOnRZ:	REZOnNMAn
AnEGIMRS:	GRAnMESI	AnEMOSWY:	WOMAnSYE
AnEGKLOT:	KOLAnGET	AnEMRTTY:	TRAnTYEM
AnEGKLOuT:	KOuLAnGET	AnEnEnGGNR:	GAnGREnNEn
AnEGKSTZ:	GAnKSTEZ	AnEnEnMNTV:	VAnTMEnNEn
AnEGMMNOn:	MAnGOnMEN	AnEnFILSY:	EnFLIYAnS
AnEGMNOuV:	GOuVENMAn	AnEnGMMNO:	MAnGONMEn
AnEGNOSY:	NEGOSYAn	AnEnIMRST:	EnSTRIMAn
AnEGNOuTV:	GOuVENAnT	AnEnJOuSWY:	AnSWOuJYEn
AnEIIKTT:	AnTIKITE	AnEnKNOSY:	EnKONSYAn
AnEIJLLS:	LAnJELIS	AnEnKOnSSY:	EnKOnSYAnS
AnEIJLLV:	LEVAnJIL	AnEnNNOPT:	TAnPONNEn
AnEIJMST:	JISTEMAn	AnENNOnPT:	TAnPOnNEN
AnEIJSTY:	JAnTIYES	AnEnNOSTY:	EnTAnSYON
AnEIKLOZ:	AnKILOZE	AnEnNOSVY:	EnVAnSYON
AnEIKLPS:	EKLAnPSI	AnENOnSTY:	ENTAnSYOn
AnEIKMST:	SEMAnTIK	AnENOnSVY:	ENVAnSYOn
AnEIKNNR:	RIKAnNEN	AnENOPST:	ENPOTAnS
AnEIKNRY:	RAnKINYE	AnENOPSY:	PAnSYONE
AnEIKNST:	KAnNISTE	AnENORSZ:	REZONAnS
AnEIKRTZ:	RAnKITEZ	AnENPRSV:	PREVNAnS
AnEILMNV:	AnVLIMEN	AnEOPSTT:	POTESTAn
AnEILMPS:	SIPLEMAn	AnEORRST:	RESTORAn
AnEILMST:	SITELMAn	AnEPRSST:	PRESTAnS
AnEIMSSZ:	SEZISMAn	AnFFIOTY:	FOTIFYAn
AnEIMSTT:	SAnTIMET	AnFGLNOO:	AnGLOFON
AnEINPST:	PENITAnS	AnFIIMNS:	FINISMAn
AnEIOTTY:	AnTOTIYE	AnFIOnRSY:	FRAnSIYOn
AnEIPRSY:	REPIYAnS	AnFKNOSY:	KONFYAnS
AnEIPSST:	PESISTAn	AnGGILOnY:	GAnGLIYOn
AnEIRSST:	RETISAnS	AnGGMNOW:	GWOGMAnN
AnEJLMNOu:	JOuNELMAn	AnGIKLOT:	KOLAnGIT
AnEKKNOR:	KONKERAn	AnGILNOnS:	LOnGAnNIS
AnEKKNOS:	KONSEKAn	AnGINOTY:	TIYOGAnN
AnEKKOnSS:	KOnSEKAnS	AnIIJLSV:	VIJILAnS
AnEKLMOnP:	KOnPLEMAn	AnIIKNPS:	PAnNISIK
AnEKMNOS:	KONMAnSE	AnIILMMZ:	MIZILMAn
	KONMESAn	AnIILSTT:	SAnTILIT
AnEKMNOT:	MEKONTAn	AnIINPST:	PISAnNIT
AnEKNOnSS:	KOnNESAnS	AnIINRTY:	NITRIYAn
AnEKNOnSY:	ENKOnSYAn	AnIIRSST:	SITIRAnS


Tirages de 7 jetons de AnIKKNOR à BEFIOSY - Page 20/28

AnIKKNOR:	KONKIRAn	BDEEFIV:	FIBDEVE
AnIKKOnRS:	KOnKIRAnS	BDEEGOT:	BODEGET
AnIKLMOnP:	KOnPLIMAn	BDEEGOY:	DEGOBYE
AnIKLMOZ:	KAnMIZOL	BDEEILS:	DESIBEL
AnIKMOPT:	PIKOTMAn	BDEEKLO:	DEBLOKE
AnIKMOTW:	WOMAnTIK	BDEEnGLO:	GOLDEnBE
AnIKNNOT:	KONTINAn	BDEEnJNR:	BREDJEnN
AnIKNOST:	KONSAnTI	BDEEOuWY:	DEBWOuYE
AnILORSY:	LIYORAnS	BDEIMOT:	DEMIBOT
AnIMMOnSV:	VOnMISMAn	BDEINOR:	REBONDI
AnIMMOSV:	VOMISMAn	BDELOOuZ:	BOuLDOZE
AnINORSY:	INYORAnS	BDEMOnWY:	DOnMBWEY
AnINOVWZ:	ZAnVIWON	BDEMOuRY:	DOuMBREY
AnIOOnVWZ:	OZAnVIWOn	BDEMOuWY:	DOuMBWEY
AnIOuPSYZ:	PAnZOuYIS	BDEnNNOOu:	BOuDONNEn
AnKMOOnPT:	KOnPOTMAn	BDENNOnOu:	BOuDOnNEN
AnKNNOPR:	KONPRAnN	BDGIILN:	BILDING
AnKNOOPZ:	KONPOZAn	BDGIOOuT:	BOuTDIGO
ANNNOuWY:	NYOuWANN	BDIIIVZ:	DIVIZIB
ANNOOPR:	RANPONO	BDIILOnV:	BIDOnVIL
ANNOPSY:	PANSYON	BEEEJNR:	BEREJEN
ANNOSTW:	SANWONT	BEEEKLN:	KELENBE
ANNOSTY:	TANSYON	BEEEKRT:	KREBETE
ANNOuSSV:	SOuVNANS	BEEELRS:	SELEBRE
ANOOuTTT:	TOuTOTAN	BEEEnFTY:	BYEnFETE
AOOnSTVY:	VOTASYOn	BEEEnKLM:	KELEnMBE
AOOnSTWY:	WOTASYOn	BEEEnLNY:	LEnBEYEN
AOPSTTW:	PWOSTAT		LENBEYEn
AOuPRSUiV:	RAPOuSUiV	BEEEnNRY:	BYEnNERE
BBDEEEK:	BEBEDEK	BEEERTV:	VETEBRE
BBDEILO:	BEBIDOL	BEEFINS:	BENEFIS
BBEEnLLN:	BLENBLEn	BEEIKLN:	KILENBE
	BLEnBLEN	BEEILLO:	IBOLELE
BBEFLOnOn:	BOnBOnFLE	BEEILNS:	ENBESIL
BBEINNO:	BOBINEN	BEEINTY:	BENITYE
BBEnNOOnY:	BOnBONYEn	BEEIOTZ:	OBEZITE
BChDEEnOT:	ChOTDEBEn	BEELMNN:	BLENMEN
BChEEFNN:	BEFChENN	BEELNOY:	BONYELE
BChEEINR:	ChERIBEN	BEELOnRY:	REBELYOn
BChENOuRS:	RENSBOuCh	BEELOuSV:	BOuLVESE
BChINOTW:	BWONChIT	BEEnGGIT:	GITEnBEG
BChLOOOT:	ChOBOLOT	BEEnGNRZ:	BRENZEnG
BChLOuOuOuT:	ChOuBOuLOuT		BREnZENG
BDDEEEJ:	DJEBEDE	BEEnINVY:	BYEnVENI
BDDEEIR:	DEBRIDE	BEEnNNOT:	BETONNEn
BDDEELOu:	DEDOuBLE	BEENNOnT:	BETOnNEN
BDDEEOY:	DEBODYE	BEENNTY:	BYENNET
BDDEIOS:	DEBODIS	BEEOuRTY:	BOuRETYE
BDEEELY:	DEBLEYE	BEFIOnYZ:	ZOnBIFYE
BDEEERY:	DEBREYE	BEFIOSY:	BIYOSFE


Tirages de 7 jetons de BEFKLOOu à DEEEKRT - Page 21/28

BEFKLOOu:	FOuKBOLE	ChChEEnNTT:	TChENTChEn
BEFLOOuT:	FOuTBOLE		TChEnTChEN
BEFLOuOuS:	BOuSOuFLE	ChDEEEnNN:	DEChEnNEN
BEGNNOnOu:	BOuGOnNEN		DEChENNEn
BEIIKLT:	KILBITE	ChDEEFIR:	DEChIFRE
BEIILPY:	PIBLIYE		DEFRIChE
BEIILRR:	LIBRERI	ChDEEKOT:	DEKOChTE
BEIINVZ:	ENVIZIB	ChDEGNOT:	DETChONG
BEIJOuTY:	BIJOuTYE	ChDEIKOW:	DEKWOChI
BEIKLOR:	BRIKOLE	ChDEnKNOOn:	KOChOnDEnN
BEIKLOuS:	BOuSKILE	ChEEFILR:	REFLEChI
BEINOPS:	ENPOSIB	ChEEGNNP:	PENChENG
BEINOTW:	WOBINET	ChEEIMTZ:	ChEMIZET
BEIOPWY:	PWOYIBE	ChEELORY:	REChOLYE
BEIOuTYZ:	BOuZIYET	ChEEOPRW:	REPWOChE
BEIPRST:	PRESBIT	ChEFINNOn:	ChIFOnNEN
BEJNNOnOu:	BOuJOnNEN	ChEIIKMR:	ChIMERIK
BEKNNOY:	KONBYEN	ChEKNOuOuT:	ChOuKOuNET
BEKOOTY:	BOYKOTE	ChEnFINNO:	ChIFONNEn
BELLOOV:	VOLEBOL	ChEnIIJRY:	ChIRIJYEn
BELMOPW:	PWOBLEM	ChEnIORTY:	OTRIChYEn
BELNNOnOu:	BOuLOnNEN	ChEnNNOOT:	TOChONNEn
BELNOPY:	PLONBYE	ChENNOOnT:	TOChOnNEN
BEnGNNOOu:	BOuGONNEn	ChIIIKRT:	ChIKRITI
BEnGNORW:	GWOBREnN	ChIIIPRT:	ChIRIPIT
BEnILOVY:	BOLIVYEn	ChIOOuRSV:	ChOVSOuRI
BEnJNNOOu:	BOuJONNEn	ChKLOOOW:	KOLOWOCh
BEnKLOOnY:	KOLOnBYEn	DDEEGNOu:	DEGOuDEN
BEnLLOOuS:	BOuLSEnLO	DDEEIMY:	DEMIDEY
BEnLNNOOu:	BOuLONNEn	DDEEISZ:	DESIDEZ
BEnNNOOuT:	BOuTONNEn	DDEEnEnNS:	SENDEnDEn
BENNOnOuT:	BOuTOnNEN		SEnDENDEn
BENOnOuTY:	BOuTOnNYE		SEnDEnDEN
BENOSYZ:	SENBYOZ	DDEEnINY:	DEDINYEn
BEOORTZ:	ZOTOBRE	DDEENOY:	DYEDONE
BIIIKSS:	IBISKIS	DDEINNO:	DODINEN
BIIIKST:	KIBITIS	DDEnIIIV:	EnDIVIDI
BIIJOuRT:	BIJOuTRI	DDENNOO:	DONDONE
BIIKOST:	TIBIKOS	DDENOOnZ:	DOnDONEZ
BIIKOTY:	BIYOTIK	DDIIKOS:	DIOKSID
BIIOuRST:	BISTOuRI	DDIINOZ:	DIZONDI
BIKLNOR:	LONBRIK	DDJJNOOn:	DJONDJOn
BIKLOOW:	BWOKOLI		DJOnDJON
BILNORT:	LONBRIT	DDNOOnYY:	DYONDYOn
BIMNOOR:	MORIBON		DYOnDYON
BINNORT:	NONBRIT	DEEEGLN:	GENDELE
BINOOuTY:	TOuBIYON	DEEEGLR:	DEREGLE
BKLOOOS:	KOLBOSO	DEEEGRS:	DEGRESE
BMNNNOO:	BONNONM	DEEEIRT:	EREDITE
BNOOuOuTY:	TOuBOuYON	DEEEKRT:	DEKRETE


Tirages de 7 jetons de DEEEKTT à DEGLNOO - Page 22/28

DEEEKTT:	DETEKTE	DEEISTZ:	DEZISTE
DEEELMP:	DEMEPLE	DEEJKOS:	KESEDJO
DEEELPP:	DEPEPLE	DEEKKLO:	DEKLOKE
DEEEnJTW:	DEJWEnTE	DEEKKOW:	DEKWOKE
DEEEnPTW:	DEPWEnTE	DEEKLNS:	LENDEKS
DEEEPRT:	DEPETRE	DEEKLOT:	DEKOLTE
DEEEPSY:	ESPEDYE	DEEKLOuR:	DEKLOuRE
DEEERST:	DETRESE	DEEKLOuW:	DEKLOuWE
DEEERVZ:	DEZEVRE	DEEKNOnT:	DEKOnNET
DEEESTT:	DETESTE	DEEKOTW:	DEKWOTE
DEEFGLOn:	DEGOnFLE	DEEKOuTV:	DEKOuVET
DEEFILN:	ENFIDEL	DEELOPV:	DEVLOPE
DEEFIMR:	DEMIFRE	DEELOPY:	DEPLOYE
DEEFIPR:	DEFRIPE	DEEMNOT:	DEMONTE
DEEFIRT:	FREDITE	DEEMOnRT:	DEMOnTRE
DEEFKNO:	FEKONDE	DEEMOPT:	POMDETE
DEEFKOR:	DEKOFRE	DEEnEnGNR:	DEGREnNEn
DEEFKOT:	KOTDEFE	DEEnEnKMR:	DEKREnMEn
DEEFKOW:	DEFWOKE	DEEnEnKNW:	DEKWEnNEn
DEEFMOT:	FETDEMO	DEEnFNOnR:	FREDOnNEn
DEEFNNOu:	DEFOuNEN	DEEnGIST:	DISTEnGE
DEEFNOR:	EFONDRE	DEEnIITY:	EnDIYITE
	FREDONE	DEEnIKLR:	EnKREDIL
DEEFNOS:	DEFONSE	DEEnIKRS:	EnDISKRE
DEEGILV:	DEVILGE	DEEnILMP:	DEPLIMEn
DEEGINR:	DENIGRE	DEEnIMSY:	MEDSIYEn
DEEGLOP:	DEPLOGE	DEEnKMOnY:	KOnMEDYEn
DEEGNOS:	SEGONDE	DEEnKMOO:	EnKOMODE
DEEIIMP:	EPIDEMI	DEEnKMOY:	KOMEDYEn
DEEIJNS:	ENDIJES	DEENNOS:	DENONSE
DEEIKLN:	DEKLINE	DEENNOuS:	DESOuNEN
DEEIKMR:	MEKREDI	DEENNOuT:	DETOuNEN
DEEIKMS:	DEMISEK	DEENNOZ:	DEZONNE
DEEIKRT:	DIREKTE	DEEnOSYZ:	DYOSEZEn
DEEIKTZ:	DEZETIK	DEENOTW:	DETWONE
DEEILLN:	LELENDI	DEEOnPTW:	DETWOnPE
DEEILMZ:	DEZILME	DEEOnRSW:	DEWOnSRE
DEEILPS:	DEPLISE	DEEOPSW:	PWOSEDE
DEEILPZ:	DEPLEZI	DEEOTTY:	DETOTYE
DEEILRV:	DELIVRE	DEEOWYZ:	DEWOZYE
DEEIMPR:	DEPRIME	DEFIIJR:	FRIJIDE
DEEIMPY:	PEDIYEM	DEFIIRT:	DIFTERI
DEEIMST:	DESIMET	DEFIISZ:	DESIZIF
DEEINRS:	DERISEN	DEFIOSW:	IDWOSFE
DEEINST:	DESTINE	DEFOOnPW:	PWOFOnDE
DEEINTV:	DEVINET	DEGIIJR:	DEGRIJI
DEEINVZ:	DEVINEZ	DEGIILV:	DIVILGE
DEEIPRT:	DETRIPE	DEGILNO:	LIGONDE
DEEIPSS:	DISPESE	DEGIOSW:	DEGWOSI
DEEISSV:	DESEVIS	DEGLNOO:	GONDOLE


Tirages de 7 jetons de DEGNNNO à EEELLNT - Page 23/28

DEGNNNO:	DENGONN	DEnKLOnTUi:	LEnKOnDUiT
DEGNNOOn:	GODOnNEN	DEnKNOTUi:	EnKONDUiT
DEIIIMT:	IMIDITE	DENOnOuST:	OuNDOnSTE
DEIIKST:	DISKITE	DENOOnST:	ONDOnSTE
DEIILST:	DESILIT		OnDONSTE
	DISTILE	DENOOunST:	OunDONSTE
DEIIMNY:	DIMINYE	DEOnOnSTW:	WOnDOnSTE
DEIINVZ:	DIVINEZ	DEOOnSVY:	DEVOSYOn
DEIIPST:	DISPITE	DEOOPTW:	WODPOTE
	ESTIPID	DEOPRUiW:	REPWODUi
DEIJLOnW:	JIWOnDEL	DEOuOuPRS:	SOuPOuDRE
DEIJNOW:	IDWOJEN	DFIIILS:	DIFISIL
DEIJOnSY:	DIJESYOn	DFIIOnYZ:	DIFIZYOn
DEIKKOnT:	KOnDIKTE	DFIIOTY:	TIFOYID
DEIKLOnV:	DEKOnVIL	DGIIIRT:	TIGRIDI
DEIKLOS:	DISLOKE	DGIKOOW:	GWODIKO
DEIKMNO:	KONMEDI	DIIJLOnT:	LOnJITID
DEIKOnRT:	KOnTREDI	DIIKLOW:	IDWOLIK
DEIKOnSW:	DESKIWOn	DIIKMNO:	DOMINIK
DEIKOuRV:	DEKOuVRI	DIIOnVYZ:	DIVIZYOn
DEILMOZ:	DOZILME	DIIOTWY:	TIWOYID
DEILOnWZ:	ZIWOnDEL	DIJOOPP:	DJIPOPO
DEIMNNOn:	MIDOnNEN	DIKKLOO:	KOKODIL
DEIMOnSY:	DEMISYOn	DIKNORT:	DOKTRIN
DEIMORS:	DORISME	DIKNOSY:	DIKSYON
DEIMOST:	METODIS	DIKOnOnSY:	KOnDISYOn
	MODESTI	DILMNOP:	DONPLIM
DEIMOTW:	IDWOMET	DJLLOOO:	DJOLOLO
DEINOnRY:	OnDIRYEN	DJLOOST:	DJOLSOT
DEINOnYZ:	DEZINYOn	DMNOOnOnW:	WOnDOnMON
DEINOSY:	EDISYON		WOnDONMOn
DEIOnPSY:	PEDISYOn		WONDOnMOn
DEIOnSYZ:	DESIZYOn	DMNOOOnW:	WONDOMOn
DEIOOPT:	OTOPEDI		WOnDOMON
DEIOPSW:	PWOSEDI	EEEEnRST:	EnTERESE
DEIOPSZ:	DISPOZE	EEEFKNT:	ENFEKTE
DEIOuPRY:	POuDRIYE	EEEFLRT:	REFLETE
DEIOWYZ:	DIWOZYE	EEEFNRY:	ENFERYE
DEJNOOR:	DOJERON	EEEFPRR:	PREFERE
DEKMOOW:	DEKOWOM	EEEGLRT:	LEGETER
DEKNOnTUi:	ENKOnDUiT	EEEINTT:	ETENITE
DEKNOOnY:	KODOnNYE	EEEJLNS:	SENLEJE
DELOOSZ:	SODOLEZ	EEEJNNY:	ENJENYE
DEnEnGLOZ:	ZEnGLEnDO	EEEKLST:	ESKELET
DEnGNNOO:	GODONNEn	EEEKLYZ:	EZEKYEL
DEnGNOnOuW:	GOuDWOnNEn	EEEKMPS:	PESMEKE
DEnIIRST:	EnDISTRI	EEEKNTY:	ENKYETE
DEnILOSV:	DOSEnVIL	EEEKPST:	EKSEPTE
DEnIMNNO:	MIDONNEn	EEEKRST:	SEKRETE
DEnINORY:	ONDIRYEn	EEELLNT:	LETENEL


Tirages de 7 jetons de EEELNST à EEKLOnRT - Page 24/28

EEELNST:	ETENSEL	EEGNNNR:	GRENNEN
EEELPPR:	REPEPLE	EEGNNOuV:	GOuVENEN
EEELRSZ:	RESELEZ	EEGNNPW:	PENGWEN
EEELSVY:	VESELYE	EEGNOSY:	NEGOSYE
EEEnFRYZ:	EnFERYEZ	EEIILMN:	ELIMINE
EEEnJMRY:	JEREMYEn	EEIJJPR:	PREJIJE
EEEnJNNY:	EnJENNYE	EEIJKNT:	JENETIK
	ENJEnNYE	EEIJLRY:	RELIJYE
EEEnJRTY:	JERETYEn	EEIKLPR:	REPLIKE
EEEnKPST:	EnSPEKTE	EEIKLPS:	ESPLIKE
EEEnLPTT:	PELEnTET	EEIKLRS:	RESIKLE
EEEnLSST:	SELESTEn	EEIKLTT:	LETIKET
EEENNST:	ESTENEN	EEIKMNR:	MERIKEN
EEEnNSTT:	ENTESTEn	EEIKNRV:	EKRIVEN
	EnTESTEN	EEIKOPT:	IPOTEKE
EEENNTT:	ENTENET	EEIKPRS:	EKSPIRE
EEEnOPWY:	EWOPEYEn	EEIKRSY:	RESKIYE
EEENPRT:	PENETRE	EEIKSSZ:	EKZESIS
EEEnRSTY:	ESTERYEn	EEILMST:	METELIS
EEEnRTVY:	VERETYEn	EEILNgST:	ESTELINg
EEENSTY:	ESTENYE	EEILNST:	ENSILTE
EEEPPST:	PESEPTE	EEILPRZ:	PLEREZI
EEEPRVZ:	PREZEVE	EEILSVY:	LESIVYE
EEEPTTT:	PETETET	EEIMNPR:	ENPRIME
EEERRTT:	RETRETE	EEIMPRT:	PERIMET
EEFFIKT:	EFEKTIF	EEIMPRZ:	MEPRIZE
EEFGLNT:	FLENGET	EEINNTV:	ENTEVNI
EEFIKLR:	FRELIKE	EEINPPY:	PEPINYE
EEFIMNN:	FEMINEN	EEINPRT:	PENTIRE
EEFIMNY:	ENFIMYE	EEINPTY:	PYETINE
EEFIRSS:	RESESIF	EEINRYZ:	REZIYEN
EEFIRVY:	FEVRIYE	EEINSST:	ENSISTE
EEFKLRS:	REFLEKS	EEINSTV:	ENVESTI
EEFKNOS:	KONFESE	EEIPRRS:	RESPIRE
EEFLMNO:	ENFOMEL	EEIPRSY:	SIPERYE
EEFLNOT:	TELEFON	EEIPSST:	PESISTE
EEFLOuST:	SOuFLETE	EEIRRST:	RETRESI
EEFMNNO:	FENOMEN	EEIRSTZ:	REZISTE
EEFNNNR:	FRENNEN	EEIRSYZ:	SERIZYE
EEFNNNW:	FWENNEN	EEIRTYZ:	ZETRIYE
EEFOPSW:	PWOFESE	EEISTVZ:	SEVITEZ
EEGGLNO:	GENGOLE	EEJMOTW:	JEWOMET
EEGGNNN:	GENGENN	EEJMOTY:	JEYOMET
EEGIJLN:	NEGLIJE	EEJNOnRS:	JERENOnS
EEGIMRS:	GREMESI	EEJNORS:	JERENOS
EEGINRY:	NEGRIYE	EEJNOSY:	JESYONE
EEGISSZ:	EGZESIS	EEJOPTW:	PWOTEJE
EEGISTZ:	EGZISTE	EEKKLOT:	KOLEKTE
EEGLNNZ:	ZENGLEN	EEKKNOnT:	KOnNEKTE
EEGLOTT:	OLTEGET	EEKLOnRT:	LEKOnTRE


Tirages de 7 jetons de EEKLOnSY à EFIRRST - Page 25/28

EEKLOnSY:	ELEKSYOn	EEnILOPP:	EnPOPILE
EEKLOnTW:	ELEKTWOn	EEnIMSTY:	METSIYEn
EEKLORT:	REKOLTE	EEnIPRVY:	PERIVYEn
EEKLOuRZ:	ZEKOuREL	EEnIPTWY:	PWEnTIYE
EEKMNSY:	SENKYEM	EEnJNVVY:	JEnNVYEV
EEKMNYZ:	KENZYEM	EEnKLOnPT:	EnKOnPLET
EEKMRST:	EKSTREM	EEnKNOnSY:	KESYOnNEn
EEKNNPS:	KEPENNS	EEnMNNOR:	RENONMEn
EEKNORT:	REKONET	EEnNNOSZ:	SEZONNEn
EEKNORY:	KOREYEN	EENNNRT:	TRENNEN
EEKNOSV:	KONSEVE	EENNOnSZ:	SEZOnNEN
EEKNOSY:	KESYONE	EENNORS:	RENONSE
	KONSEYE	EENNOuRT:	RETOuNEN
EEKNOuST:	ESTEKOuN	EENNPPP:	PENPENP
EEKNRTY:	KRETYEN	EEnNRRST:	RESTREnN
EEKOnPRS:	KOnPRESE	EENNRTZ:	ZETRENN
EEKOPTW:	PEWOKET	EEnNVVYY:	VYENVYEn
EEKOuTVZ:	KEVOuZET		VYEnVYEN
EEKPRST:	PRETEKS	EEnOnPRSY:	EnPRESYOn
EELMPWY:	PWELYEM	EENOPSY:	ESPYONE
EELNNPY:	PLENYEN	EENOPTW:	PENETWO
EELNOPS:	PESONEL	EEnOPTYY:	ETYOPYEn
EELNOuRV:	RENOuVLE	EENOSYZ:	SEZONYE
EELOPTW:	PWOLETE	EENOuRST:	SOuTEREN
EELOPTZ:	ZEPOLET	EENPRSS:	PRENSES
EELORTV:	REVOLTE	EENPRVY:	PREVYEN
EELORVV:	REVOLVE	EEOPPRZ:	PREPOZE
EELOVYZ:	VOLEYEZ	EEORRST:	RESTORE
EEMMOTT:	TEMOMET	EEOSSTY:	SOSYETE
EEMNNNS:	SENMENN	EEOuPSTW:	WOuSPETE
EEMNNOnR:	RENOnMEN	EEOuRSTW:	RETWOuSE
EEMNORT:	REMONTE	EFFIOTY:	FOTIFYE
EEMNOSY:	MONSEYE	EFGNNOnOu:	FOuGOnNEN
EEMNOuST:	ESTENOuM	EFIIMNR:	ENFIMRI
EEMNTVY:	VENTYEM	EFIIMNS:	FEMINIS
EEMORTY:	TEYOREM	EFIIPRY:	PIRIFYE
EEMRTYZ:	TREZYEM	EFIJLNO:	FILOJEN
EEnEnNNPP:	PEnPENNEn	EFIKKOnS:	KOnFISKE
	PEnPEnNEN	EFIKLOS:	FOKSELI
	PENPEnNEn	EFIKMNO:	KONFIME
EEnFIIMT:	EnFIMITE	EFIKMNOn:	KOnFIMEN
EEnFILRT:	EnFILTRE	EFIKNOT:	FONETIK
EEnFKOnSY:	EnFEKSYOn	EFIKOnRR:	KOnFRERI
EEnFNOSS:	SEnNESOF	EFILMOuY:	FOuMILYE
EEnGGLNO:	GEnNGOLE	EFILOST:	LITOSFE
EEnGGLOR:	GREnGOLE	EFILOSY:	OFISYEL
EEnIILMN:	ELIMINEn	EFIMOTY:	MOTIFYE
EEnIJNRY:	NIJERYEn	EFIOPSW:	PWOFESI
EEnIJPSY:	EJIPSYEn	EFIOPTW:	PWOFITE
EEnIKKMS:	MEKSIKEn	EFIRRST:	FRISTRE


Tirages de 7 jetons de EFKMNOO à EILOPST - Page 26/28

EFKMNOO:	KONFOME	EIINOWZ:	IWONIZE
EFKNOOT:	KONFOTE	EIINRTT:	TRINITE
EFKOnOnSY:	KOnFESYOn	EIINRTV:	TRIVIEN
EFKOnOnTW:	KOnFWOnTE	EIIRSTZ:	SITIREZ
EFNNNOT:	FONTENN	EIIRTVY:	VITRIYE
EFNNOuOuT:	TOuFOuNEN	EIJKLOO:	EKOLOJI
EFNOTWY:	FWONTYE	EIJKNOS:	OKSIJEN
EFOOTWZ:	ZEWOFOT	EIJLOnRY:	RELIJYOn
EGIINOR:	INOGIRE	EIJLOTV:	VOLTIJE
EGIJKNO:	KONJIGE	EIJPRST:	PRESTIJ
EGIKLOP:	GOLKIPE	EIKKLOnP:	KOnPLIKE
EGILOPT:	EPIGLOT	EIKKNOR:	KONKERI
EGILORY:	LEGRIYO	EIKKOPP:	POKEPIK
EGINNOnY:	GIYOnNEN	EIKLLMO:	MOLEKIL
EGINORZ:	GERIZON	EIKLMOP:	POLEMIK
EGINOST:	OGISTEN	EIKLMOT:	KILOMET
EGIOPTZ:	POTIGEZ	EIKLNOR:	KOLERIN
EGIOTTZ:	TOTIGEZ	EIKLOnST:	KOnSILTE
EGJLOOY:	JEYOLOG	EIKLORS:	SIKRELO
EGLNOOT:	ETNOLOG	EIKLOuRV:	KOuVRELI
EGMMNOnOn:	MOnGOnMEN	EIKMNOO:	EKONOMI
EGMNOOW:	GWOMONE	EIKMNOT:	KONMITE
EGNNNOY:	GYONNEN	EIKMOnPR:	KOnPRIME
EIIILMT:	IMILITE	EIKMOST:	KOSTIME
EIIILTT:	ITILITE	EIKMOuST:	MOuSTIKE
EIIILTZ:	ITILIZE	EIKNOnTY:	KOnTINYE
EIIIMNT:	IMINITE	EIKNOTV:	KONVETI
EIIIMNZ:	IMINIZE	EIKNOWZ:	KEWOZIN
EIIINVV:	INIVIVE	EIKNRSY:	KRISYEN
EIIJKNY:	IJYENIK	EIKNUiYZ:	KUiZINYE
EIIJKRZ:	JEZIKRI	EIKOnPST:	KOnSTIPE
EIIJLMT:	LEJITIM	EIKOPRW:	PWOKIRE
EIIKKNT:	KINETIK	EIKORRT:	RETORIK
EIIKKRT:	KRITIKE	EIKORTT:	TRIKOTE
EIIKLMS:	MISKILE	EIKORTY:	KRIYOTE
EIIKLOR:	ORIKILE	EIKOuRTY:	KOuTIRYE
EIIKNYZ:	KIZINYE		KOuTRIYE
EIIKNZZ:	KIZINEZ	EIKPRRS:	PRESKRI
EIIKPTZ:	KIPIZET	EILLNOT:	TILENOL
EIILMMT:	MILIMET	EILMNOuT:	TOuLIMEN
EIILMNN:	LIMINEN	EILMOPS:	POLEMIS
EIILNNS:	ENSILIN	EILMOSW:	WOMELIS
EIILRST:	ILISTRE	EILNNOnP:	PILOnNEN
EIILRTT:	TITIREL	EILNORS:	LERISON
EIIMNST:	MINISTE	EILNOuSV:	NOuVELIS
EIIMOPT:	IPOTEMI	EILNOuSY:	SOuLIYEN
EIIMPRS:	SIPRIME	EILOnRVZ:	LIVREZOn
EIIMPSS:	PESIMIS	EILOnSTY:	LEYOnTIS
EIIMRST:	SIMETRI	EILOPST:	PISTOLE
EIIMSTY:	SIMITYE		POLITES


Tirages de 7 jetons de EILOPSY à FIKLMOO - Page 27/28

EILOPSY:	POLISYE	EMNOPSW:	PWONMES
EILORSY:	RESIYOL	EMNOPTW:	PWONMET
EILOTVY:	VITYELO	EMOOnSTZ:	MOTSEZOn
EILOuPSV:	SIVOuPLE	EnEnMNOnPW:	PWOnMEnNEn
EIMNNOnY:	MIYOnNEN	EnEnMNOPW:	PWOMEnNEn
EIMNOSY:	MISYONE	EnFGINOnR:	GRIFOnNEn
	MONSIYE	EnFGNNOOu:	FOuGONNEn
EIMOnPSY:	PEMISYOn	EnFIISYZ:	FIZISYEn
EINNOnVW:	VIWOnNEN	EnFIKMNO:	KONFIMEn
EINNOVW:	VIWONEN	EnFINOnRS:	FRISOnNEn
EINOnRYY:	REYINYOn	EnGINNOY:	GIYONNEn
EINOnSTW:	SENTIWOn	EnGINOnRZ:	GRIZOnNEn
EINOPYZ:	PIYONEZ	EnGINORZ:	GRIZONEn
EINPPRS:	PRENSIP	EnGMMNOOn:	MOnGONMEn
EIOORTT:	OTORITE		MONGOnMEn
EIOORTZ:	OTORIZE	EnIIJSST:	EnJISTIS
EIOPRTT:	TRIPOTE	EnIILMSY:	MILISYEn
EIRSSTT:	TRISTES	EnIIMPRR:	EnPRIMRI
EJLOOnPW:	PWOLOnJE	EnIIMSYZ:	MIZISYEn
EKKKLNO:	KELKONK	EnIKMNOY:	KOMINYEn
EKKLMOR:	KOLKREM	EnIKNOPT:	NEnPOTKI
EKKNOnOnT:	KOnKOnNET	EnILMOTY:	MILOTYEn
EKKNOOT:	KOKONET	EnILNNOP:	PILONNEn
EKKNOOV:	KONVOKE	EnIMNNOY:	MIYONNEn
EKKNOSV:	KONVEKS	EnINNOVW:	VIWONNEn
EKKNOSY:	KEKSYON	EnINOSTW:	SEnTIWON
EKLLNOO:	KOLONEL	EnIORSTY:	ISTORYEn
EKLNOOS:	KONSOLE	EnKKLOOT:	KOLOKEnT
EKLOnPTY:	POnKTYEL	EnKMNOOnS:	KONSOnMEn
EKLOOnPT:	KOnPLOTE		KOnSONMEn
EKLOOnTW:	KOnTWOLE	EnLNOOnPT:	PLOTOnNEn
EKMNOnOnS:	KOnSOnMEN	EnMNNOPW:	PWONMNEn
EKMNOOnP:	MONKOnPE	ENNNOPY:	PYONNEN
	MOnKONPE	EnNOnOnYZZ:	ZOnZOnNYEn
EKMNOPT:	PONMKET	ENNOPSW:	PWENSON
EKNOOPT:	KONPOTE	ENNOPWW:	WONPWEN
EKNOOPZ:	KONPOZE	ENOOWYZ:	EWOZYON
EKNOORT:	OKONTRE	ENOPRSY:	PRESYON
EKNOPRS:	KONPRES	ENOPSVW:	PWOVENS
EKNOSSY:	SEKSYON	ENOPTTW:	TWONPET
EKOnOuPTY:	KOnPYOuTE	EOOnPRSY:	OPRESYOn
EKOOnPSY:	ESKOPYOn	EOOnPSSY:	POSESYOn
EKOOPTW:	PEKTOWO	EOOPPWZ:	PWOPOZE
EKOOPVW:	PWOVOKE	FFILOOZ:	FILOZOF
ELNOOPZ:	POLONEZ	FGINNOR:	GRIFONN
ELNOOTV:	VOLONTE	FIIIKRS:	KRISIFI
EMNNOnPW:	PWOnMNEN	FIIILSS:	SIFILIS
EMNNOTY:	TYEMONN	FIIKNOT:	KONFITI
EMNOOPZ:	MENOPOZ	FIIOPTZ:	POZITIF
EMNOOSY:	EMOSYON	FIKLMOO:	KOMILFO


Tirages de 7 jetons de FIKOnOnYZ à MNNOOPP - Page 28/28

FIKOnOnYZ:	KOnFIZYOn	IKLOuOuTT:	TIKOuLOuT
FIKOnRSY:	FRIKSYOn	IKMNOnOnY:	KOnMINYOn
FIKORST:	KRISTOF	IKMNOOnY:	KOMINYOn
FILNOOZ:	ZILOFON	IKMOOnSY:	KOMISYOn
FKLNOOY:	KONFYOL	IKNOOPW:	KOWONPI
FKLOOOnY:	KOnFYOLO	IKNOOTZ:	KOTIZON
FKNNNOO:	KONFONN	IKNOSTW:	KONSTWI
FKNOOnSY:	FONKSYOn	IKOOPRT:	POTORIK
	FOnKSYON	ILMNOOP:	POLINOM
GGLNOOO:	GONGOLO	ILOOnPSY:	POLISYOn
GGNOOnOnP:	POnGOnGON	ILOOnSSY:	SOLISYOn
	POnGONGOn	ILOOSWY:	WOSIYOL
	PONGOnGOn	IMNOOOT:	OTONOMI
GIINOTY:	GIYOTIN	INNOOPY:	OPINYON
GIKKNOO:	KIKONGO	INNOSTV:	TONNVIS
GIKLOOR:	KORIGOL	INOOPSZ:	SIPOZON
GILNOOP:	POLIGON	INOOSSS:	SOSISON
GKKNOOO:	GONOKOK	INOPRTW:	TWONPRI
GKLNOOO:	KONGOLO	IOOnPSYZ:	POZISYOn
GKNNOOuT:	KONNGOuT	KKLOOSW:	KLOWOKS
GKNOOuTT:	KONTGOuT	KKMNNOO:	KONKONM
GOOOPPW:	GWOPOPO	KKMOOOY:	KOMOKOY
IIIJKLT:	LITIJIK	KLMOOOY:	MOLOKOY
IIIJMNP:	MINIJIP	KLNOOTW:	KONTWOL
IIIKPRS:	PIKIRIS	KLOOOSW:	KOWOSOL
IIILLMT:	MILILIT	KMMNOOnOn:	MOnKONMOn
IIINSTZ:	SINIZIT		MOnKOnMON
IIIPPRT:	PIPIRIT		MONKOnMOn
IIIPTTT:	TIPITIT	KMNNNOO:	MONNONK
IIIRTZZ:	ZIZIRIT	KMOOOYY:	MOYOKOY
IIKLOPT:	POLITIK	KNOOuPWY:	KWOuPYON
IIKNNOT:	NIKOTIN	KOOOnWYZ:	KOWOZYOn
IIKNOSS:	SIKONSI	KOOOPSW:	OWOSKOP
IIKOPRT:	IPOKRIT	LLOOOWY:	WOLOLOY
IIKORST:	ISTORIK	MMNOOnTT:	TOnMTONM
IILLOTT:	TILOLIT		TONMTOnM
IILMNOT:	MILITON	MNNOOPP:	PONPONM
IILNOSW:	SIWOLIN		
IILNOYZ:	ILIZYON		
IILOnPPS:	POnPILIS		
IILOPPS:	POPILIS		
IIMNNOS:	SINONIM		
IIMNOnSY:	MINISYOn		
IIMOPST:	OPTIMIS		
IINOnPSY:	PINISYOn		
IINOuRST:	TINOuRIS		
IIOuRSTT:	TISOuRIT		
IKKLOOY:	KOKIYOL		
IKLNOOR:	KOLORIN		
IKLOOnYZ:	KOLIZYOn		


