Tirages de 8 jetons de AAAAnBKLL à AABBDIOY - Page 1/19

AAAAnBKLL:	AnBALAKAL	AAAMNNSV:	AVANSMAN
AAAAnBNRS:	ANBARASAn	AAAMOPPR:	PAPARAMO
	AnBARASAN	AAAnAnBMRS:	AnBARASMAn
AAABChEKR:	KARABAChE	AAAnAnDNNT:	AnNATAnDAN
AAABDENS:	ANBASADE		AnNATANDAn
AAABDKOuR:	BARAKOuDA		ANNATAnDAn
AAABDLMN:	DANMBALA	AAAnBDEGR:	AnDEGRABA
AAABDNRS:	ANBRASAD	AAAnBEJMT:	TABAMAnJE
AAABEKLR:	KARABELA	AAAnBIKRR:	ARAnBARIK
AAABENRS:	ANBARASE	AAAnBKLNT:	BATANKLAn
AAABJLNS:	ASANBLAJ		BATAnKLAN
AAABKMNN:	ANBAKMAN	AAAnBMNNZ:	BANZANMAn
AAABKNNR:	KARABANN		BANZAnMAN
AAABLNSW:	BALANSWA		BAnZANMAN
AAABMMNY:	MAYANMBA	AAAnDFMNN:	FAnDANMAN
AAABNNTV:	ANBAVANT		FANDANMAn
AAAChEKRV:	KARAVAChE		FANDAnMAN
AAADGLNV:	LAVANGAD	AAAnEJLMS:	SALAMAnJE
AAADGLPW:	LAGWADAP	AAAnFNNNS:	AnNANFANS
AAADKLMN:	MAKANDAL		ANNAnFANS
AAADKMNR:	KANMARAD		ANNANFAnS
AAADKMRS:	MASKARAD	AAAnGKRSV:	AKSAnGRAV
AAADLMTW:	MALADWAT	AAAnGNPRR:	GRANPARAn
AAADPPPP:	PAPPADAP		GRAnPARAN
AAAEJNTV:	AVANTAJE	AAAnIKLMM:	AMIKALMAn
AAAELMWY:	AMWALAYE	AAAnKNNNN:	KANNANNAn
AAAGJMNN:	ANGAJMAN		KANNAnNAN
AAAGKKLS:	KAKAGLAS		KAnNANNAN
AAAGLNPY:	GALAPYAN	AAAnLMMNW:	MAnMANLWA
AAAGMNNN:	ANGANMAN		MANMAnLWA
AAAGNPPR:	GRANPAPA	AAAnLMNPS:	AnPLASMAN
AAAIKNTW:	ANAKAWIT		ANPLASMAn
AAAIKNTY:	ANAKAYIT	AAAnMMNNS:	SANMANMAn
AAAILNTZ:	ATIZANAL		SANMAnMAN
AAAILPPS:	PASIPALA		SAnMANMAN
AAAIMMZZ:	MAZIMAZA	AAANNNNP:	ANPANNAN
AAAIMNRW:	MARIWANA	AAAnNNNRT:	ANNANTRAn
AAAINSSY:	ASASINAY		ANNAnTRAN
AAAIPPTT:	PATIPATA		AnNANTRAN
AAAJKKKO:	KAKAJAKO	AAANNNNZ:	ZANNANNA
AAAJMNNR:	ARANJMAN	AAAnNNSTZ:	SAnZATANN
AAAKLPST:	KATAPLAS		SANZATAnN
AAAKLSSS:	LASKASAS	AAANNNSV:	ANNAVANS
AAALNNRT:	ALANTRAN	AAAnNNTTZ:	TANZAnTAN
AAALNOTT:	ALATATON		TANZANTAn
AAALNPRS:	LAPARANS		TAnZANTAN
AAALNPRT:	ALATRANP	AAANNPTZ:	ZAPATANN
AAALNPST:	PLASANTA	AAANOPRY:	PARANOYA
AAALOPPT:	ALAPAPOT	AAANRTVY:	TRAVAYAN
AAAMMNNN:	AMANNMAN	AABBDIOY:	BOBADIYA


Tirages de 8 jetons de AABBDMNOn à AADIKNOnY - Page 2/19

AABBDMNOn:	BOnBADMAN	AABMNOuPY:	MAPYANBOu
AABBEMOnY:	AYABOnMBE	AABNNOWY:	BAYAWONN
AABBILNY:	BANBILAY	AAChChMMNN:	ChANMChANM
AABBIMNO:	ABOMINAB	AAChDIMNZ:	MAChANDIZ
AABBKOuST:	BOuSTABAK	AAChEILRT:	LAChARITE
AABChEMNO:	ABONMAChE	AAChEMNNP:	ANPEChMAN
AABDDEEK:	DEBAKADE	AAChENPTY:	ChAPANTYE
AABDDEFN:	DEFANDAB	AAChFMNNR:	FRANChMAN
AABDDENY:	DEBANDAY	AAChGILNT:	LANGIChAT
AABDEERS:	DEBARASE	AAChGINRT:	GANTRIChA
AABDEKLN:	KANDELAB	AAChIKLLS:	ChALKALIS
AABDEKMN:	DEBAKMAN	AAChINNTT:	ChITATANN
AABDELNY:	ANDYABLE	AAChKNOuST:	SANKOuTChA
AABDEMNT:	DEBATMAN	AAChMNNTW:	WATChMANN
AABDEnNNO:	ABANDONEn	AAChNNOnPY:	ChANPYOnNA
AABDENNO:	ABANDONE	AADDEETW:	ETADEDWA
AABDIKNS:	ANBISKAD	AADDEGNR:	DEGRADAN
AABDILSY:	ALSIBYAD	AADDEKNS:	DEKADANS
AABDNNOS:	ABONDANS	AADDJJNN:	DJANDJAN
AABDNOSW:	BWOSADAN	AADDNNRR:	DRANDRAN
AABEEKRR:	KAREBARE	AADDNNYY:	DYANDYAN
AABEGLWY:	GWAYABEL	AADEEJKK:	KADEJAKE
AABEIKRT:	KABIRATE	AADEEJPT:	DEPATAJE
AABEILNR:	BALERINA	AADEFIMT:	DIFAMATE
AABEJKOuS:	BAJOuKASE	AADEGJMN:	GADMANJE
AABEJNRY:	ANBREYAJ	AADEGMNN:	ANMEGDAN
AABEKNWY:	ENKWAYAB	AADEGNRY:	GRENADYA
AABEKPST:	AKSEPTAB	AADEIKKM:	AKADEMIK
AABELLNN:	LABALENN	AADEIKNP:	ANDIKAPE
AABELNRS:	RASANBLE	AADEIMRT:	ADMIRATE
AABEnNNNW:	BWANANNEn	AADEJNNR:	ANJANDRE
AABEnRSTY:	BATRASYEn	AADEJNPT:	DJETAPAN
AABEPRSY:	APRESYAB	AADEKLNS:	ESKANDAL
AABFNRWZ:	FRANBWAZ	AADEKLNV:	VALKANDE
AABGHNNR:	BRANHANG	AADEKLRT:	KATEDRAL
AABGIRYZ:	ZAGRIBAY	AADEKNNY:	KANADYEN
AABIJNST:	JANBATIS	AADELMNN:	LADEMANN
AABIKKLS:	KALBASIK		MANNDELA
AABIKNRY:	KRABINAY	AADELNOS:	ADOLESAN
AABILNNS:	ANBILANS	AADELNST:	LADESANT
	BALANSIN	AADEMNPT:	DEPATMAN
AABILRTV:	BATRAVIL	AADEnLMNR:	MALANDREn
AABIMNST:	BATISMAN	AADENTYZ:	ANTDEZAY
AABIOnSTY:	ABITASYOn	AADGINTV:	DATIGNAV
AABKLOSW:	KWABOSAL	AADGLNOY:	DYAGONAL
AABKLOuTW:	BLAKAWOuT	AADHOOunTY:	ADYAHOunTO
AABKNOOW:	KAWONABO	AADIJKNOn:	ADJANIKOn
AABKNOuTY:	BOuKANTAY	AADIJMNN:	DANMIJAN
AABLMNNOn:	BALOnNMAN	AADIJMNR:	JANDAMRI
AABLNNPT:	PLATBANN	AADIKNOnY:	ADYANIKOn


Tirages de 8 jetons de AADIMNNR à AAENPRTZ - Page 3/19

AADIMNNR:	MANDARIN	AAEIRSTY:	ATERISAY
AADIMNPR:	RAPIDMAN	AAEJKLSV:	ESKLAVAJ
AADIMNPT:	PIMANTAD	AAEJKNOuR:	ANKOuRAJE
AADINNRS:	ANDIRANS	AAEKKTWZ:	KAKATWEZ
AADINNRT:	DIRANTAN	AAEKLNNS:	ALEKSANN
AADINPPY:	DAPIYANP	AAEKLNOS:	ALEKONSA
AADINSTV:	ADVANTIS	AAEKLNSV:	VALKANSE
AADINSWZ:	SWADIZAN	AAEKLNSY:	AKANSYEL
AADJMMNO:	DOMAJMAN	AAEKLSVY:	ESKLAVAY
AADJMNNZ:	DJAZMANN	AAEKMNNP:	PAKEMANN
AADKMNNO:	KOMANDAN	AAEKMNRS:	SAKREMAN
AADKMNNOn:	KOnMANDAN	AAEKNNWY:	ENKWAYAN
AADKOPRS:	PARADOKS	AAEKNOPY:	AKONPAYE
AADMNNOnS:	ADANMSOnN	AAEKNPRY:	PANKREYA
AADMNNOS:	DASOMANN	AAELLMNR:	LANMERAL
AADNRSUiY:	RANDUiSAY	AAELMNNT:	LANTEMAN
AADOOnRSY:	ADORASYOn	AAELMNPT:	PALMANTE
AADOPRSY:	DYASPORA	AAELMNVY:	MALVEYAN
AAEEFNRY:	ARYENAFE	AAELMSTY:	MATLASYE
AAEEKLSZ:	ALKASEZE	AAELNNTY:	LATANYEN
AAEELNTT:	ALTENATE	AAELNOuVZ:	ALEVOuZAN
AAEELNTW:	ANETWALE	AAELNPST:	PLASENTA
AAEEnMNPY:	PANAMEYEn	AAELNPTT:	PANTALET
AAEFKNNN:	ANFANNKE	AAELNPWY:	ANPLWAYE
AAEFLMNZ:	MALFEZAN	AAELPSTW:	PATASWEL
AAEFLNNT:	NAFTALEN	AAELRTTY:	TEYATRAL
AAEFMNPT:	PAFETMAN	AAEMNNPS:	PEMANANS
AAEFMNSY:	FAMASYEN	AAEMNNPT:	PEMANANT
AAEFNNNT:	ANFANTEN	AAEMNNSY:	ANSEYMAN
AAEFNOuRY:	ANFOuRAYE	AAEMNOnSZ:	ASEZOnMAN
AAEFTTYZ:	TAFYATEZ	AAEMNSTT:	TESTAMAN
AAEGGNNN:	GAGANNEN	AAEMTWYY:	TEMWAYAY
AAEGINTV:	NAVIGATE	AAEnFNRTY:	FAREnNAYT
AAEGJNNR:	ANGRENAJ	AAEnGMNRT:	GRANMATEn
AAEGKLOT:	KATALOGE	AAEnIJKMY:	JAMAYIKEn
AAEGLLRT:	LAGRATEL	AAEnINNRS:	ANRASINEn
AAEGNTWZ:	WANGATEZ	AAEnINNSS:	ANSASINEn
AAEIJRST:	ATERISAJ	AAEnKKNNN:	KANKANNEn
AAEIKLNV:	EKIVALAN	AAEnKLNNV:	VALKANNEn
AAEIKPST:	KAPASITE	AAEnKLNTY:	ALYEnNKAT
AAEILMNT:	ALIMANTE	AAEnKNOnSY:	EnKANASYOn
AAEILPRV:	PALAVIRE	AAEnKNSTW:	AKWEnTANS
AAEILPRZ:	PARALEZI	AAEnMNNRT:	ANTREnMAN
	PARALIZE	AAEnMNPTW:	APWEnTMAN
AAEIMNTZ:	ANIMATEZ	AAENNNPP:	ANPENPAN
AAEIMNYZ:	MAYIZENA	AAEnNPSSY:	EnPASYANS
AAEINNTY:	ANEYANTI	AAENNPSY:	ENPASYAN
AAEINPST:	APETISAN	AAENNRTT:	ANTRETAN
AAEINRTV:	AVANTIRE	AAENOSYZ:	ASEZONAY
AAEIPRST:	ASPIRATE	AAENPRTZ:	PARANTEZ


Tirages de 8 jetons de AAENPSTY à AAnBDEOTW - Page 4/19

AAENPSTY:	SAPANTYE	AAIOnSVYY:	AVIYASYOn
AAENRVWY:	RANVWAYE	AAJKNNOP:	KAPONNAJ
AAFFIIMT:	AFIMATIF	AAJKNOnPR:	KRAPOnNAJ
AAFGILLN:	FILALANG	AAJLMNOuS:	SOuLAJMAN
AAFGMNOR:	GRANFOMA	AAJLNOuRT:	LANTOuRAJ
AAFIKLST:	LAKSATIF	AAJNOuPST:	POuSANTAJ
AAFIKNNT:	FANNATIK	AAKKLNOuR:	KARANKLOu
AAFILLMY:	FAMILYAL	AAKKLORY:	KLOKARYA
AAFILMNN:	FINALMAN	AAKLMNOS:	KALMASON
AAFIMOnSY:	AFIMASYOn	AAKLNOuPT:	KANTALOuP
AAFINNNT:	ANFANTIN	AAKMMNNO:	KOMANMAN
AAFINSYY:	FIYANSAY	AAKMMNNOu:	KOuMANMAN
AAFKLMOuY:	KAMOuFLAY	AAKMORWY:	AKWARYOM
AAFLNNOT:	LAFONTAN	AAKNNOPY:	KAPONNAY
AAFMNOnRS:	FRANMASOn	AAKNNRWY:	KWARYANN
AAFMNOnTW:	AFWOnTMAN	AAKNOnPRY:	KRAPOnNAY
AAGIJPRY:	GRAPIYAJ	AAKNOuSTY:	SANKOuTYA
AAGIJPSY:	GASPIYAJ	AAKOnRSTY:	ATRAKSYOn
AAGIKLNN:	ANGLIKAN	AALMNNNY:	LANMYANN
AAGIKLPS:	PIKAGLAS	AALNNOPT:	PANTALON
AAGIKNOT:	KITANAGO	AALNNOSY:	NASYONAL
AAGILNRT:	GALANTRI	AALNOOuTZ:	OZALANTOu
AAGILPSW:	LASIGWAP	AALNOPTW:	PATWONAL
AAGIMNOW:	MAWOGANI	AALNORTY:	ORYANTAL
AAGIPSYY:	GASPIYAY	AALNOuRTY:	LANTOuRAY
AAGLMOnTY:	MALATYOnG	AALOOPST:	APOSTOLA
AAGMNNOuY:	MANGOuYAN	AAMNNOPT:	ANPOTMAN
AAGMNOYZ:	ZOMANGAY	AAMPRSSY:	PRAYSMAS
AAIILNSV:	AVILISAN	AAnAnAnDFLM:	AnMALDAnFAn
AAIJMNNT:	JANTIMAN	AAnAnBFLWY:	FLAnBWAYAn
AAIJMNPS:	MASPINAJ	AAnAnBITTV:	AnBATIVAnT
AAIJMRST:	MAJISTRA	AAnAnDEKMR:	AnKADREMAn
AAIJNVWZ:	VWAZINAJ	AAnAnDNPST:	PAnDANSTAn
AAIJOnSTY:	AJITASYOn		PAnDAnSTAN
AAIKKMST:	KASKAMIT		PANDAnSTAn
AAIKLNTT:	ATLANTIK	AAnAnEMPRT:	TAnPERAMAn
	TANTAKIL	AAnAnFITYY:	AnFAnTIYAY
AAIKLOPT:	KATAPOLI	AAnAnIMSVY:	AnVAYISMAn
AAIKLTVW:	LAVIKTWA	AAnAnJKMOuR:	AnKOuRAJMAn
AAIKNPRT:	PRATIKAN	AAnAnMOnPWZ:	AnPWAZOnMAn
AAIKOnSYZ:	AKIZASYOn	AAnAnPRRST:	TRAnSPARAn
AAILMNNT:	LANMITAN	AAnBBDMNO:	BONBADMAn
AAILNRTY:	LANTIRAY	AAnBChELLT:	LABLAnChET
AAILOPSY:	ISPAYOLA	AAnBChILSY:	BLAnChISAY
AAIMNOnSY:	ANIMASYOn	AAnBChLLNN:	BLANChLAnN
AAIMNTYZ:	ZANMITAY		BLAnChLANN
AAINSSST:	ASISTANS	AAnBDEGIR:	AnBRIGADE
AAINVWYZ:	VWAZINAY	AAnBDEMWZ:	DEBWAZMAn
AAIOnPRSY:	APARISYOn	AAnBDENNO:	ABAnDONEN
AAIOnSSYY:	ASIYASYOn	AAnBDEOTW:	DEWOTAnBA


Tirages de 8 jetons de AAnBDGIRY à AAnKMNOnST - Page 5/19

AAnBDGIRY:	BRIGAnDAY	AAnEGIKST:	AKSAnTEGI
AAnBEELSZ:	AnBAZESEL	AAnEGILLM:	ILEGALMAn
AAnBEKMNT:	BATMAnNKE	AAnEGJMNR:	GRAnMANJE
AAnBEnKLST:	SALTEnBAnK		GRANMAnJE
AAnBENSTY:	ESTAnNBAY	AAnEGMMNT:	GETMANMAn
AAnBEOuTYY:	AnBOuTEYAY		GETMAnMAN
AAnBEPRTZ:	PREZAnTAB	AAnEGMNRT:	GRAnMATEN
AAnBGLLMO:	GLOBALMAn	AAnEIJMST:	AJISTEMAn
AAnBILMNOu:	MAnNIBOuLA	AAnEIMSTV:	AVETISMAn
AAnBILMOS:	ABSOLIMAn	AAnEINNRS:	AnRASINEN
AAnBIMOuST:	ABOuTISMAn	AAnEINNSS:	AnSASINEN
AAnBLMNNO:	BALONNMAn	AAnEIPRTT:	TAnPERATI
AAnChGILLT:	LAnGLIChAT	AAnEIRTVY:	AVAnTIRYE
AAnChNNOPY:	ChAnPYONNA	AAnEKKNNN:	KANKAnNEN
AAnDDEEnNP:	EnDEPANDAn		KAnKANNEN
	EnDEPAnDAN	AAnEKLLSY:	LAKAnSYEL
AAnDDENSS:	DESANDAnS	AAnEKLMTY:	AKTYELMAn
	DESAnDANS	AAnEKLNNV:	VALKAnNEN
AAnDDERTW:	DWADAnTRE	AAnEKMMNT:	KETMANMAn
AAnDDIKNT:	DIKDAnTAN		KETMAnMAN
	DIKDANTAn	AAnEKMRTY:	KARAnTYEM
AAnDEEKLS:	ESKAnDALE	AAnEKNSTW:	AKWENTAnS
AAnDEEMMZ:	DEZAMEMAn	AAnEMNNRT:	AnTRENMAN
AAnDEEnGGN:	DEGAGAnNEn		ANTRENMAn
AAnDEENVY:	AVAnDENYE	AAnEMNOSZ:	ASEZONMAn
AAnDEEPRZ:	DEZAnPARE	AAnEMNPRS:	AnPRESMAN
AAnDEFIMR:	DIFERAMAn		ANPRESMAn
AAnDEFOuWY:	AnFOuDWAYE	AAnEMNPTW:	APWENTMAn
AAnDEGGMT:	GADMAnTEG	AAnEMNRSS:	RESAnSMAN
AAnDEIKMM:	MEDIKAMAn		RESANSMAn
AAnDEIKST:	AKSIDAnTE	AAnEMNRSY:	RAnSEYMAN
AAnDELMNR:	MALAnDREN		RANSEYMAn
AAnDELMPS:	DEPLASMAn	AAnEnKPSTW:	PWASEnKAnT
AAnDELOSS:	ADOLESAnS	AAnEnNOnPWZ:	AnPWAZOnNEn
AAnDELVYZ:	LAVAnDYEZ	AAnENPSSY:	ENPASYAnS
AAnDEnLMNN:	NAnLANDMEn	AAnEPRVWY:	PREVWAYAn
	NANLAnDMEn	AAnFIMNNS:	FINAnSMAN
AAnDGIRST:	SAnTIGRAD		FINANSMAn
AAnDIJMNN:	DANMIJAnN	AAnFMNORS:	FRAnMASON
	DAnMIJANN	AAnFMNOTW:	AFWONTMAn
AAnDIKPPY:	DAPPIYAnK	AAnGNOPPW:	PWOPAGAnN
AAnDIMOnSW:	AWOnDISMAn	AAnIILMSV:	AVILISMAn
AAnDIPPPY:	DAPPIYAnP	AAnIKMOnPT:	KOnPATIMAn
AAnDKMMNO:	KOMANDMAn	AAnIKMPRT:	PRATIKMAn
	KOMAnDMAN	AAnIMMOST:	AMOTISMAn
AAnDKMNNO:	KONMANDAn	AAnIOnPSTY:	AnPITASYOn
	KONMAnDAN	AAnJKMNOuT:	MATJOuKAnN
AAnDMNNOS:	ADAnMSONN	AAnKMMNOS:	KOMAnSMAN
AAnEEJLNR:	AnJENERAL		KOMANSMAn
AAnEEJLRT:	ALETRAnJE	AAnKMNOnST:	KOnSANTMAn


Tirages de 8 jetons de AAnKMNOnST à ABIOnRSVY - Page 6/19

	KOnSAnTMAN	ABDOOOYZ:	AZOBODOY
AAnKMNOnTT:	KOnTAnTMAN	ABEEEnMPY:	EnPEMEYAB
	KOnTANTMAn	ABEEFPRR:	PREFERAB
AAnLOnPSTY:	PLAnTASYOn	ABEEIKNT:	ENKIBATE
AANNNOPR:	RANPANNO	ABEEILST:	SELIBATE
AANNNORY:	ANRANYON	ABEEKLRS:	ESKRABLE
AAnNOPRSY:	SARAnPYON	ABEEKSTZ:	BASKETEZ
AAnNOSSSY:	SAnSASYON	ABEEKTWY:	KABWETYE
AANNOSSY:	ASANSYON	ABEEnFLMS:	BLASFEMEn
AANNOSTY:	ATANSYON	ABEFMNNOu:	MANFOuBEN
AANOnPRSY:	SARANPYOn	ABEGLMNO:	LAGONMBE
AANOnSSSY:	SANSASYOn	ABEGNOSY:	NEGOSYAB
AANOSSTW:	OSTANSWA	ABEIKLOV:	VOKABILE
ABBDEEOuY:	DEBABOuYE	ABEIKNNR:	KRABINEN
ABBDENOY:	BONBADYE	ABEIKOWY:	AYEWOBIK
ABBEKLNO:	BEKANBOL	ABEILNST:	SIBALTEN
ABBEKLOZ:	ZABELBOK	ABEINNSS:	ENSANSIB
ABBEnINNO:	ANBOBINEn	ABEINNST:	BISANTNE
ABChDEENR:	DEBRANChE	ABEINOnSY:	IBENASYOn
ABChENNTW:	BWATChENN	ABEINOSY:	OBEYISAN
ABChLOOOT:	ABOLOTChO	ABEINSYZ:	ANBISYEZ
ABChNOOOT:	ABONOTChO	ABEKLNNOn:	KOnBELANN
ABDDEMNO:	DEBODMAN	ABEKNNNOu:	BOuKANNEN
ABDEEIYZ:	DEZABIYE	ABEKNNOR:	ANKONBRE
ABDEELNS:	SALDEBEN	ABEKNORY:	BAKONYER
ABDEELNW:	ABDENWEL	ABEKOnRSS:	RESKOnSAB
ABDEEMNR:	DEMANBRE	ABELMMOuZ:	MAZOuMBEL
ABDEEnIRZ:	EnDEZIRAB	ABELMNOZ:	MAZONBEL
ABDEEnKLL:	KALBLEnDE	ABELNNNO:	BALONNEN
ABDEEnMOY:	MAYODEBEn	ABELNOuRV:	RENOuVLAB
ABDEEPSS:	DESPABES	ABEnGGNRR:	GRANBREnG
ABDEESTT:	DETESTAB	ABEnGNNRR:	GRANBREnN
ABDEGINR:	BRIGANDE	ABEnIOPST:	EnSIPOTAB
ABDEGIRY:	BRIGADYE	ABEnKLOOnS:	EnKOnSOLAB
ABDEIIST:	ABSIDITE	ABENOSWY:	BWASONYE
ABDEIKTY:	DYABETIK	ABEOnPRSS:	RESPOnSAB
ABDEINTW:	TABDENWI	ABEORSSW:	BRASEWOS
ABDELNOuY:	BANDOuLYE	ABFIILST:	FISTIBAL
ABDELOYZ:	DEBLOZAY	ABFIOPTW:	PWOFITAB
ABDEnGINY:	GADYEnNBI	ABFKNOOT:	KONFOTAB
ABDEnIJNOn:	BADIJOnNEn	ABIIKLLT:	LAKILBIT
ABDEnIPSW:	PWEnDISAB	ABIIKLST:	BALISTIK
ABDEnNNNO:	BANDONNEn	ABIIKOTY:	ABIYOTIK
ABDENNNOn:	BANDOnNEN	ABIILNRT:	TRIBINAL
ABDIILMN:	MANDIBIL	ABIKORTW:	BIWOKRAT
ABDIJNOnW:	BIDJAWOnN	ABILOOnSY:	ABOLISYOn
ABDIKLOY:	DYABOLIK	ABINNORY:	ANBRIYON
ABDILMOuS:	BOuLDIMAS	ABINNOSY:	ANBISYON
ABDINOnSY:	BANDISYOn	ABINOSTY:	BITASYON
ABDMNNOnOu:	BOuDOnNMAN	ABIOnRSVY:	VIBRASYOn


Tirages de 8 jetons de ABKNNNOW à ADEINOSY - Page 7/19

ABKNNNOW:	KANBWONN	ADEELMNT:	DEMANTLE
ABKOOTYY:	BOYKOTAY	ADEELMWZ:	DEMWAZEL
ABNNOOTW:	TOWOBANN	ADEELNNY:	LADENNYE
AChDEEJNR:	DEREChANJ	ADEEMMSY:	MESYEDAM
AChDEEKLN:	DEKLANChE	ADEEMNNN:	NANDEMEN
AChDEELNY:	ChANDELYE	ADEEMORT:	MODERATE
AChDEGOTW:	DWATEGOCh	ADEEMTWY:	DEMWATYE
AChDEILMN:	LEDIMANCh	ADEEnEnMRY:	AMEREnDYEn
AChDEnIMNOn:	MADIChOnNEn	ADEEnFINR:	EnDIFERAN
AChEEMNST:	MEChANSTE	ADEEnGNRY:	EnGREDYAN
AChEENNNN:	ANChENNEN	ADEEnKLNS:	DELEnKANS
AChEENNPZ:	ChENPANZE	ADEEnKMNO:	DEMAKONEn
AChEGINRR:	GRANChIRE	ADEENNNP:	DEPANNEN
AChEGJNNO:	ChENANGOJ	ADEEnNNTT:	TENTEnNAD
AChEIIKTT:	AChITEKTI		TEnTENNAD
AChEINOnTY:	EChANTIYOn	ADEENNOT:	ETANDONE
AChEnIKNNP:	PIChKANNEn	ADEENNSS:	ENDESANS
AChEnNNNOT:	ChANTONNEn	ADEENRTV:	DEVANTRE
AChENNNOnT:	ChANTOnNEN	ADEENRVZ:	REVANDEZ
AChENNPTT:	ANChTPENT	ADEEPSWZ:	DEZESPWA
AChINNOPY:	ChANPIYON	ADEFIIKT:	EDIKATIF
AChIOPPRT:	PATRIPOCh	ADEFIINP:	DEPAFINI
ADDEEJMO:	DEDOMAJE	ADEFIJKT:	ADJEKTIF
ADDEIILP:	DILAPIDE	ADEFINRS:	DIFERANS
ADDEINPR:	DEPRADIN	ADEFLOSV:	VOLDEFAS
ADDEINRV:	VANDREDI	ADEFNNOR:	ANFONDRE
ADDEJMOO:	JAMEDODO	ADEGIJMO:	DEMAGOJI
ADDEMOOY:	DODOMEYA	ADEGIJOP:	PEDAGOJI
ADDIIKKT:	DIDAKTIK	ADEGINNR:	GRENADIN
ADDIINNV:	DIVIDANN	ADEGINRZ:	GRANDIZE
ADEEELPR:	REPEDALE	ADEGNOuST:	DEGOuTANS
ADEEFIMP:	PEDEFAMI	ADEGOuTTW:	TWADEGOuT
ADEEFLNZ:	DEZANFLE	ADEIILPR:	EPIDIRAL
ADEEFMNY:	DEMEFYAN	ADEIIMPR:	APREMIDI
ADEEFMOnZ:	MEZOnDAFE	ADEIINTT:	IDANTITE
ADEEGLMO:	MODELAGE	ADEIIPRT:	RAPIDITE
ADEEGLNS:	DESANGLE	ADEIJLNS:	DELIJANS
ADEEIKMY:	DEMAKIYE	ADEIJMNN:	DEMIJANN
ADEEIKNT:	ENDIKATE	ADEIJNNS:	ENDIJANS
ADEEIKPT:	DEKAPITE	ADEIJNSV:	DIVEJANS
ADEEIKRT:	AKREDITE	ADEIKKLS:	KILDESAK
ADEEIKTY:	DEKATIYE	ADEIKLMO:	LAKOMEDI
ADEEILVZ:	DEVALIZE	ADEIKMNS:	MISKADEN
ADEEINRS:	DERASINE	ADEIKNST:	TANDISKE
ADEEINST:	DESINATE	ADEIKOnSY:	EDIKASYOn
ADEEIPYZ:	DEZAPIYE	ADEILMPP:	PALMIPED
ADEEISTV:	ADVESITE	ADEILPTW:	PIDETWAL
ADEEJKOuR:	DEKOuRAJE	ADEIMNNOn:	AMIDOnNEN
ADEEKLNN:	DELENKAN	ADEINNPR:	ENPRIDAN
ADEELMNN:	LANDEMEN	ADEINOSY:	ADISYONE


Tirages de 8 jetons de ADEINPRZ à AEEIMNTT - Page 8/19

ADEINPRZ:	PREZIDAN		LIMONNAD
ADEINPSS:	DISPANSE	ADILMOPT:	DIPLOMAT
ADEINRSY:	SANDRIYE	ADILNOTZ:	ZANDOLIT
ADEIPRST:	DISPARET	ADIMNNOS:	DOMINANS
ADEIPRTY:	PEDYATRI	ADIMNOnSY:	DIMANSYOn
ADEIRVYZ:	DRIVAYEZ	ADIMNOSY:	ADMISYON
ADEJLOPV:	DJOLPAVE	ADIMNOuST:	TOuDISMAN
ADEKMNNO:	KONMANDE	ADINOnOnSY:	INOnDASYOn
ADEKMORT:	DEMOKRAT	ADINOnRSY:	SANDRIYOn
ADEKNNOS:	KONDANSE	ADINOnSTY:	DANTISYOn
ADEKNOOY:	AKODEYON	ADINORVY:	IDRAVYON
ADEKNOSY:	DYAKONES	ADINOSTW:	SITWONAD
ADELMNOuW:	DEWOuLMAN	ADKKOuOuTY:	DYAKOuKOuT
ADELNOPY:	PLENYADO	ADKMNNOOu:	DOuKOMANN
ADELNOSY:	DOLEYANS	ADKNOOPS:	ANDOSKOP
	LODYANSE	ADNNOOSY:	DONASYON
ADELOPYZ:	DEPLOZAY	ADNOOPSY:	ADOPSYON
ADEMNNNO:	ANDENMON	AEEEGLNS:	SENEGALE
ADEMNNOuT:	DETOuNMAN	AEEEJKRZ:	EKZAJERE
ADEMNOuPY:	DEPOuYMAN	AEEEJNRT:	JENERATE
ADEMORTY:	RADYOMET	AEEEKLRS:	AKSELERE
ADEnFIIKT:	EnDIKATIF	AEEEKRST:	EKSETERA
ADEnGINNR:	GREnNADIN	AEEEKTYZ:	EKZEYATE
ADEnIIPST:	APEnDISIT	AEEELMNT:	ELEMANTE
ADEnIKOnSY:	EnDIKASYOn	AEEELNRT:	ALENTERE
ADEnIMNNO:	AMIDONNEn	AEEEnLRTY:	ALEnTERYE
ADEnIMNNR:	MANDRINEn	AEEEnNRST:	EnTERESAN
ADEnINPRS:	EnPRIDANS	AEEESSTZ:	ASETSEZE
ADEnIOnSYY:	EnDIYASYOn	AEEFIRST:	AFRESITE
ADEnLMOPW:	PALEnDWOM	AEEFKKLW:	KELKEFWA
ADENNNOP:	PADONNEN	AEEFKLMT:	MALFEKTE
ADENOnSTY:	DETANSYOn	AEEFKNRT:	FREKANTE
ADENOPTV:	DEVANPOT	AEEFKRRT:	REFRAKTE
ADFIKNNO:	KONFIDAN	AEEFLNRT:	FRATENEL
ADFIKNOnS:	KOnFIDANS	AEEFMNOT:	ENFOMATE
ADFIOOnPW:	APWOFOnDI	AEEFOPRT:	PEFORATE
ADFNOOnSY:	FOnDASYON	AEEGIPST:	ESPAGETI
	FONDASYOn	AEEGLMNR:	REGLEMAN
ADGIMNOuZ:	GOuMANDIZ	AEEGLMRT:	TELEGRAM
ADGNORYZ:	GRANDYOZ	AEEIKLPS:	ESKAPILE
ADIIJLNS:	DILIJANS	AEEIKMNR:	AMERIKEN
ADIILNPT:	ANPLITID	AEEILNPT:	PENALITE
ADIILORT:	IDOLATRI	AEEILRTV:	LAVERITE
ADIINRST:	DISANTRI	AEEILRTY:	ELATRIYE
ADIINRTV:	VIDIRANT		REYALITE
ADIJLNOuT:	TIJOuDLAN	AEEILRYZ:	REYALIZE
ADIKMOOZ:	KAZIMODO	AEEIMMTT:	EMATIMET
ADIKNNOR:	ANDOKRIN	AEEIMNPS:	EMANSIPE
ADIKOnOnSY:	AKOnDISYOn	AEEIMNRT:	NIMERATE
ADILMNNO:	LANMIDON	AEEIMNTT:	MATENITE


Tirages de 8 jetons de AEEINRTV à AEGMNNOuV - Page 9/19

AEEINRTV:	ANVERITE	AEEnLNSST:	LASEnTSEN
AEEINSTZ:	ANESTEZI	AEEnNNOSZ:	ASEZONNEn
AEEJKLOnT:	KOnJELATE	AEENNOnSZ:	ASEZOnNEN
AEEJLNRT:	LETRANJE	AEENNRYZ:	ZARENYEN
AEEJLNRY:	ALJERYEN	AEENPRSS:	ESPERANS
AEEJNNRS:	ENJERANS	AEENPRTZ:	PREZANTE
AEEKKLSW:	KELKESWA	AEENPSTY:	SEPANTYE
AEEKKPST:	ESPEKTAK	AEENTVVY:	VATEVYEN
AEEKLNSS:	EKSELANS	AEFGJORY:	JEYOGRAF
AEEKLORT:	ELEKTORA	AEFGLMNOn:	GOnFLEMAN
AEEKMNSW:	AMWENSKE	AEFGNOuRY:	GRAFOuYEN
AEEKMOnST:	ESTOnMAKE	AEFIIKST:	SETIFIKA
AEEKMOST:	ESKAMOTE	AEFIILST:	FASILITE
	ESTOMAKE	AEFIIPRT:	APERITIF
AEEKNRTV:	KATREVEN	AEFIJNRW:	JWIFERAN
	VENKATRE	AEFIKLSY:	KLASIFYE
AEEKNSTY:	ANKSYETE	AEFIKNRY:	ENFRAYIK
AEEKRSTV:	RESTAVEK	AEFIKRRT:	FRAKTIRE
AEELMNRY:	REYELMAN	AEFIKRSY:	SAKRIFYE
AEELMORY:	AMELYORE	AEFILMOT:	FOMALITE
AEELMRTT:	MALTRETE	AEFILNPY:	PLANIFYE
AEELNPRY:	ENPERYAL	AEFILSTV:	FESTIVAL
AEELNPTZ:	PLEZANTE	AEFINNRT:	ENFANTRI
AEELNSSY:	ESANSYEL	AEFINRSZ:	FRANSIZE
AEELNSTW:	SENTELWA	AEFINRYZ:	FARIZYEN
AEELNSYZ:	SALEZYEN	AEFIORVZ:	FAVORIZE
AEELOnSVY:	ELEVASYOn	AEFJLLMO:	FLAJELOM
AEELPSSY:	ESPESYAL	AEFKNNOS:	KANSONFE
AEEMMNOT:	ANEMOMET	AEFKNOSY:	AFEKSYON
AEEMNNSS:	SENSEMAN	AEFLNNOnP:	PLAFOnNEN
AEEMNNST:	ESTAMENN	AEFLNOnSY:	ENFLASYOn
AEEnFLMNZ:	MAZENFLEn	AEFLOnTWY:	LAFWOnTYE
	MAZEnFLEN	AEFLOSTV:	VOLTEFAS
AEEnGIMNZ:	EGZAMINEn	AEFOuPTWW:	WATEPWOuF
AEEnGMNRW:	MAREnGWEN	AEGGNNNR:	GANGRENN
	MARENGWEn	AEGGNOYZ:	GANGOZYE
AEEnGMRRY:	GRAMERYEn	AEGIJLNN:	NEGLIJAN
AEEnIJLNT:	EnTELIJAN	AEGIJNSZ:	EGZIJANS
AEEnIKMNZ:	EKZAMINEn	AEGIKORT:	KATEGORI
AEEnINNSS:	EnSASINEN	AEGILMNY:	MANGLIYE
	ENSASINEn	AEGILMSW:	MASIGWEL
AEEnJKLMY:	JAKMELYEn	AEGIMNNT:	MANNIGET
AEEnKKNOnS:	EnKOnSEKAN	AEGIMNRS:	GRANMESI
AEEnKNOnPT:	EnKOnPETAN	AEGIMRSY:	GRIMASYE
AEEnKNOnVY:	EnKOnVEYAN	AEGKLNOT:	KOLANGET
AEEnKNRTV:	VEnNKATRE	AEGKLNOuT:	KOuLANGET
AEEnLMMNN:	MALMEnNEN	AEGKNSTZ:	GANKSTEZ
	MALMENNEn	AEGLNNNO:	GALONNEN
AEEnLMNPS:	SEnPLEMAN	AEGMMNNOn:	MANGOnMEN
AEEnLNOnRZ:	LAREZOnNEn	AEGMNNOuV:	GOuVENMAN


Tirages de 8 jetons de AEGMOPRW à AEKMOTYZ - Page 10/19

AEGMOPRW:	PWOGRAME	AEILMNNV:	ANVLIMEN
AEGNNOnRY:	GARYOnNEN	AEILMNPS:	SIPLEMAN
AEGNNOPT:	PENTAGON	AEILMNST:	SITELMAN
AEGNNOSY:	NEGOSYAN	AEILMORT:	MORALITE
AEGNNOuTV:	GOuVENANT	AEILMORZ:	MORALIZE
AEGNORSY:	AGRESYON	AEILMOTT:	MOTALITE
AEIIKLPT:	KAPITILE	AEILMRST:	MILATRES
AEIIKMNT:	MATINIKE	AEILNPSS:	LESPINAS
AEIIKNTT:	ANTIKITE	AEIMNNPS:	MASPINEN
AEIIKRST:	EKARISTI	AEIMNSSZ:	SEZISMAN
AEIIKTTV:	AKTIVITE	AEIMNSTT:	SANTIMET
AEIILMNP:	MANIPILE	AEIMOSTY:	SIYAMETO
AEIILRTT:	LITERATI	AEIMRTTY:	MITRAYET
AEIIMRTT:	MATIRITE	AEIMRTYZ:	MITRAYEZ
AEIIMRTZ:	MATIRIZE	AEINNPST:	PENITANS
AEIIPPST:	PATISIPE	AEINNTTY:	TITANYEN
AEIJKKSS:	JISKASKE	AEINNVWZ:	VWAZINEN
AEIJKLRS:	RESIKLAJ	AEINOTTY:	ANTOTIYE
	SAKRILEJ	AEINPRSY:	REPIYANS
AEIJKPRS:	KREPISAJ	AEINPRTW:	PWATRINE
AEIJLLNS:	LANJELIS	AEINPSST:	PESISTAN
AEIJLLNV:	LEVANJIL	AEINRSST:	RETISANS
AEIJMNST:	JISTEMAN	AEINRVWY:	IVWARYEN
AEIJMNSY:	MAJISYEN	AEINSTWY:	SITWAYEN
AEIJMORT:	MAJORITE	AEIOnSTYZ:	EZITASYOn
AEIJNSTY:	JANTIYES	AEIOPRVZ:	VAPORIZE
AEIJRRTY:	JERYATRI	AEIORSTV:	VORASITE
AEIKKLLY:	KILAKYEL	AEIOSTTW:	ATWOSITE
AEIKKNRY:	KENKAYRI	AEIPRVWY:	PWAVRIYE
AEIKKORY:	RAKOKIYE	AEIRTVWY:	TWARIVYE
AEIKKSTW:	KISAKWET	AEJKKOuSS:	JOuSKASKE
AEIKLLOT:	LOKALITE	AEJLMNNOu:	JOuNELMAN
AEIKLLOZ:	LOKALIZE	AEJMNORY:	JERANYOM
AEIKLMNS:	MASKILEN	AEJNNOPS:	PESONNAJ
AEIKLNOZ:	ANKILOZE	AEJNOPSY:	ESPYONAJ
AEIKLNPS:	EKLANPSI	AEJOnSSTY:	JESTASYOn
AEIKLNRT:	KLARINET	AEKKNNOR:	KONKERAN
AEIKLOTW:	KILOWATE	AEKKNNOS:	KONSEKAN
AEIKMNOnT:	KOnTAMINE	AEKKNOnSS:	KOnSEKANS
AEIKMNST:	SEMANTIK	AEKLMNOnP:	KOnPLEMAN
AEIKMRST:	MASKRETI	AEKLMOPW:	PWOKLAME
AEIKMRTY:	KATRIYEM	AEKLMOST:	LESTOMAK
AEIKNNNR:	RIKANNEN	AEKLNNNO:	KALONNEN
AEIKNNPT:	KAPITENN	AEKLNOPY:	KONPAYEL
AEIKNNRT:	NEKTARIN	AEKMNNNO:	MAKONNEN
AEIKNNRY:	RANKINYE	AEKMNNOS:	KONMANSE
AEIKNNST:	KANNISTE		KONMESAN
AEIKPRSY:	KAPRISYE	AEKMNNOT:	MEKONTAN
	KREPISAY	AEKMNOTY:	KAMYONET
AEIKRSST:	KRISTASE	AEKMOTYZ:	KATOZYEM


Tirages de 8 jetons de AEKNNNOP à AGIIOnRSY - Page 11/19

AEKNNNOP:	KAPONNEN	AEnIOnSTVY:	EnVITASYOn
AEKNNOnPR:	KRAPOnNEN	AEnKKLNOnS:	KLAKSOnNEn
AEKNNOnRY:	KARYOnNEN	AEnKNNOPR:	KRAPONNEn
AEKNNOnSS:	KOnNESANS	AEnKNNORY:	KARYONNEn
AEKNNOnSY:	ENKOnSYAN	AEnKNNOSY:	EnKONSYAN
AEKNNOSS:	KONESANS	AEnKNOnSSY:	EnKOnSYANS
AEKNNOSY:	AKSYONNE	AEnNNNOPT:	TANPONNEn
AEKNOnPRS:	REKOnPANS	AENNNOnPT:	TANPOnNEN
AEKNOnRRT:	RANKOnTRE	AEnNNOPWZ:	PWAZONNEn
AEKNOnRST:	KOnSANTRE	AEnNNOSTY:	EnTANSYON
AEKNOPRT:	KONPARET	AENNNOSV:	SAVONNEN
AEKNOPSZ:	EKSPOZAN	AEnNNOSVY:	EnVANSYON
AEKNORTY:	KONTRAYE	AENNNOTT:	TATONNEN
AEKNOSWY:	EKWASYON	AENNOnPWZ:	PWAZOnNEN
AEKNOSYZ:	AKSYONEZ	AENNOnSTY:	ENTANSYOn
AEKOnRRTY:	KOnTRARYE	AENNOnSVY:	ENVANSYOn
AELLNOTZ:	LENZALOT	AENNOPST:	ENPOTANS
AELMNNOT:	MALONNET	AENNOPSY:	PANSYONE
AELMNNOY:	NOMALYEN		PESONNAY
AELMNOuSV:	SOuLEVMAN	AENNORSZ:	REZONANS
AELMNPTW:	TENMPLAW	AENNOVYZ:	ENVAZYON
AELNNNOT:	TALONNEN	AENNPRSV:	PREVNANS
AELNNOPS:	LAPESONN	AENNRRTY:	RENNRAYT
AELNNOSS:	ENSOLANS	AENOPSSY:	ASPESYON
AELNOPTZ:	PLATEZON	AENOPSTT:	POTESTAN
AELNORST:	TOLERANS	AENORRST:	RESTORAN
AELNORSY:	RELASYON	AENOSSTY:	ESTASYON
AELNOSVY:	LEVASYON	AENPRSST:	PRESTANS
AEMMNOuTV:	MOuVMANTE	AEOOnPRSY:	OPERASYOn
AEMNNNOS:	MASONNEN	AEOOPTYZ:	APOTEYOZ
AEMNNOnRZ:	REZOnNMAN	AFFGNOOR:	FONOGRAF
AEMNOSWY:	WOMANSYE	AFFGOORT:	FOTOGRAF
AEMNRTTY:	TRANTYEM	AFFINOTY:	FOTIFYAN
AEMOSTWY:	MAYESTWO	AFGLNNOO:	ANGLOFON
AEnEnGGNNR:	GANGREnNEn	AFIIKRSS:	SAKRIFIS
AEnEnMNNTV:	VANTMEnNEn	AFIIMNNS:	FINISMAN
AEnFIKMOnT:	EnFOnMATIK	AFIKKNOO:	KAKOFONI
AEnFIKMOT:	EnFOMATIK	AFILLNOP:	FILAPLON
AEnFILNSY:	EnFLIYANS	AFINOnRSY:	FRANSIYOn
AEnFKOnRSY:	EnFRAKSYOn	AFKNNOSY:	KONFYANS
AEnFLNNOP:	PLAFONNEn	AFKNOOSS:	SAKSOFON
AEnFLNOSY:	EnFLASYON	AFKNORSY:	FRAKSYON
AEnFMOOnSY:	EnFOMASYOn	AFKOOuRSY:	FOSKOuRAY
AEnGMMNNO:	MANGONMEn	AFMNOOSY:	FOMASYON
AEnGNNORY:	GARYONNEn	AFOOPSTW:	APOSTWOF
AEnGNOSVV:	VOSVAGEnN	AGGILNOnY:	GANGLIYOn
AEnIKLRST:	KRISTALEn	AGGMNNOW:	GWOGMANN
AEnIKRSST:	SAKRISTEn	AGIIKNNO:	INOGANIK
AEnILPPRS:	PREnSIPAL	AGIILMMR:	MILIGRAM
AEnIMNRST:	EnSTRIMAN	AGIIOnRSY:	IRIGASYOn


Tirages de 8 jetons de AGIKLMOR à AnBEEFLTY - Page 12/19

AGIKLMOR:	KILOGRAM	AIMOOPPT:	IPOPOTAM
AGIKLNOT:	KOLANGIT	AINNORSY:	INYORANS
AGILNNOnS:	LOnGANNIS	AINNOVWZ:	ZANVIWON
AGIMNOOW:	AGWONOMI	AINOOnVWZ:	OZANVIWOn
AGIMOnRSY:	MIGRASYOn	AINOSSTY:	SITASYON
AGINNOTY:	TIYOGANN	AINOuPSYZ:	PANZOuYIS
AGKLOuOuOuT:	GALOuKOuTOu	AIOPRTTY:	PATRIYOT
AGLOOSTW:	ASTWOLOG		TRIPOTAY
AIIIKMNT:	KATIMINI	AIOPVWWZ:	PWOVIZWA
AIIJLNSV:	VIJILANS	AJKLOOnPT:	KOnPLOTAJ
AIIJLSST:	LAJISTIS	AKKLLMOuOu:	MAKLOuKLOu
AIIKKLLV:	KLAVIKIL	AKKLNNOS:	KLAKSONN
AIIKMRST:	MASKRITI	AKKOOTWY:	KWATYOKO
AIIKNNPS:	PANNISIK	AKMNOOnPT:	KOnPOTMAN
AIIKRSST:	SAKRISTI	AKNNNOPR:	KONPRANN
	SIKATRIS	AKNNOOPY:	KONPAYON
AIIKRSTY:	SIKYATRI	AKNNOOPZ:	KONPOZAN
AIILMMNZ:	MIZILMAN	AKNOOnSST:	SOnTONAKS
AIILNOuRT:	LANOuRITI	AKNOOSVY:	VOKASYON
AIILNSTT:	SANTILIT	ALMMNOOuT:	MALMOuTON
AIIMOnSTY:	IMITASYOn	ALOOnSVYY:	VYOLASYOn
AIINNPST:	PISANNIT	AMNOOSTW:	ASTWONOM
AIINNRTY:	NITRIYAN	AMOOPSTY:	POTASYOM
AIINRSST:	SITIRANS	AMOOuPVWW:	PWOMOuVWA
AIIOnRSTY:	IRITASYOn	AnAnAnDETTZ:	DETAnZAnTAn
AIJOPRTT:	TRIPOTAJ	AnAnBDIOnSY:	AnBAnDISYOn
AIKKLNOV:	VOLKANIK	AnAnBEILMS:	AnBELISMAn
AIKKLORZ:	KRIZOKAL	AnAnBEJJRT:	JAnJAnBRET
AIKKNNOR:	KONKIRAN	AnAnBEKMOnR:	AnKOnBREMAn
AIKKNOnRS:	KOnKIRANS	AnAnChDEKLM:	DEKLAnChMAn
AIKLLNOO:	LAKOLONI	AnAnDDEENP:	ENDEPAnDAn
AIKLMNOnP:	KOnPLIMAN	AnAnDDEEnPS:	EnDEPAnDAnS
AIKLMNOZ:	KANMIZOL	AnAnDDMMYY:	DYAnMDYAnM
AIKLOPTW:	TWOPIKAL	AnAnDELMNN:	NAnLAnDMEN
AIKMNOPT:	PIKOTMAN	AnAnDGIMOuS:	AnGOuDISMAn
AIKMNOTW:	WOMANTIK	AnAnEINPST:	AnPENITAnS
AIKMOOTT:	OTOMATIK	AnAnENPRRT:	AnTREPRAnN
AIKNNNOT:	KONTINAN	AnAnIKMOnST:	KOnSAnTIMAn
AIKNNOST:	KONSANTI	AnAnKMNOST:	KONSAnTMAn
AIKOOnPSY:	OKIPASYOn	AnAnKMNOTT:	KONTAnTMAn
AILLOOTT:	TOLALITO	AnAnNOuOuPSS:	SOuSOuPAnNAn
AILNNOVW:	LAVIWONN	AnBBEINNO:	AnBOBINEN
AILNORSY:	LIYORANS	AnBChDEMOW:	WOBDEChAnM
AILOOnRTZ:	ORIZOnTAL	AnBChIILRS:	BLAnChISRI
AILOOnSVY:	OVILASYOn	AnBDEFIKOu:	BOuKAnDIFE
AILOOnSYZ:	IZOLASYOn	AnBDELOSY:	LOBEDYAnS
AILOPSST:	SITOPLAS	AnBDENNNO:	BAnDONNEN
AIMMNOnSV:	VOnMISMAN	AnBDINOSY:	BAnDISYON
AIMMNOSV:	VOMISMAN	AnBDMNNOOu:	BOuDONNMAn
AIMNOSTY:	MITASYON	AnBEEFLTY:	FEBLAnTYE


Tirages de 8 jetons de AnBEEIJLR à AnEKNNOSS - Page 13/19

AnBEEIJLR:	BELIJERAn	AnEEELMNT:	ETENELMAn
AnBEEnFSYZ:	BYEnFEZAnS	AnEEENRST:	ENTERESAn
AnBEEnJJRT:	JEnJAnBRET	AnEEFPRRS:	PREFERAnS
AnBEEnSSYY:	BYEnSEYAnS	AnEEIJKMN:	ENEJIKMAn
AnBEGGNRR:	GRAnBRENG	AnEEIJLNT:	ENTELIJAn
AnBEGNNRR:	GRAnBRENN	AnEEKKNOnS:	ENKOnSEKAn
AnBEIKMRS:	BRISKEMAn	AnEEKMOuRS:	REKOuMAnSE
AnBEJJLOUi:	LUiJAnBOJE	AnEEKMOuSW:	AnMWESEKOu
AnBEKLNNO:	KONBELAnN	AnEEKNOnPT:	ENKOnPETAn
AnBELMOuSV:	BOuLVESMAn	AnEEKNOnVY:	ENKOnVEYAn
AnBEnIKKSW:	BISKAnKWEn	AnEEKOnPRS:	REKOnPAnSE
AnBEnKKOST:	SEnKAnTKOB	AnEELLSSY:	LESAnSYEL
AnBIIMNSZ:	BIZNISMAn	AnEELMNPS:	SENPLEMAn
AnBIOnSSVY:	SIBVAnSYOn	AnEEMMYYZ:	MYEZAnMYE
AnChEFILMS:	FLEChISMAn	AnEEMRSYZ:	SERYEZMAn
AnChEIKNNP:	PIChKAnNEN	AnEEnFILSY:	EnFLIYAnSE
AnChEINOTY:	EChAnTIYON	AnEEnFKRTY:	FRAnKETYEn
AnChENNNOT:	ChAnTONNEN	AnEEnGGNNR:	GAnGRENNEn
AnChFLOuOuST:	SOuFLAnTChOu		GAnGREnNEN
AnDDEEKMO:	DEKOMAnDE	AnEEnIJLST:	EnTELIJAnS
AnDDEOORY:	DEYODORAn	AnEEnKKNOS:	EnKONSEKAn
AnDDEOORZ:	DEZODORAn	AnEEnKMSTY:	SEnKAnTYEM
AnDEEFINR:	ENDIFERAn	AnEEnKNOnVY:	EnKOnVENYAn
AnDEEGNRY:	ENGREDYAn	AnEEnKNOPT:	EnKONPETAn
AnDEEIKRV:	REVAnDIKE	AnEEnKNOVY:	EnKONVEYAn
AnDEEIMNT:	DETEMINAn	AnEEnMNNTV:	VAnTMEnNEN
AnDEEJMOnZ:	DEMAnJEZOn		VAnTMENNEn
AnDEEKLNS:	DELENKAnS	AnEEPRSSY:	ESPERYAnS
AnDEEKMOR:	REKOMAnDE	AnEEPRSTY:	PRETAnSYE
AnDEEMMYZ:	DEZYEMMAn	AnEFGLMNO:	GONFLEMAn
AnDEEnFIRS:	EnDIFERAnS	AnEFILNSY:	ENFLIYAnS
AnDEEnGRYZ:	ZEnGREDYAn	AnEFIPRTV:	PREVAnTIF
AnDEENOuYZ:	DEZAnNOuYE	AnEFKMMOOn:	KOnFOMEMAn
AnDEFIITY:	IDAnTIFYE	AnEFOuOuPTY:	PAnTOuFOuYE
AnDEIILPV:	VILIPAnDE	AnEGGORYZ:	GRAnGOZYE
AnDEIKMOT:	DOKIMAnTE	AnEGIJLNS:	NEGLIJAnS
AnDEILRSV:	DELIVRAnS	AnEGISSTZ:	EGZISTAnS
AnDEIMNNR:	MAnDRINEN	AnEGMMNNO:	MAnGONMEN
AnDEIMOuST:	ETOuDISMAn	AnEIIKLTT:	LAnTIKITE
AnDEINPRS:	ENPRIDAnS	AnEIIPRSZ:	ISIPREZAn
AnDEKOnRST:	KOnTREDAnS	AnEIKNRST:	KAnNISTER
AnDELMOPV:	DEVLOPMAn	AnEILPRTZ:	PLEZAnTRI
AnDENOORZ:	DEZONORAn	AnEIMNRST:	ENSTRIMAn
AnDENOSTY:	DETAnSYON	AnEIOnPSTY:	IPETAnSYOn
AnDFIKNOS:	KONFIDAnS	AnEIPRRTZ:	AnTREPRIZ
AnDIMNOSY:	DIMAnSYON	AnEIRSSTZ:	REZISTAnS
AnDINORSY:	SAnDRIYON	AnEJMOPSY:	AnJYOSPEM
AnDINOSTY:	DAnTISYON	AnEKKNOSS:	KONSEKAnS
AnDIOOuVYZ:	VODOuYIZAn	AnEKLMNOP:	KONPLEMAn
AnDIOPSVW:	PWOVIDAnS	AnEKNNOSS:	KONNESAnS


Tirages de 8 jetons de AnEKNNOSY à BELLNOOuS - Page 14/19

AnEKNNOSY:	ENKONSYAn	BChIIIMOY:	BIYOChIMI
AnEKNOnSSY:	ENKOnSYAnS	BDEEGLNO:	GOLDENBE
AnEKNOPRS:	REKONPAnS	BDEEILNW:	BELDENWI
AnEKNORRT:	RAnKONTRE	BDEEIOYZ:	DEZOBEYI
AnEKNORST:	KONSAnTRE	BDEEJNNR:	BREDJENN
AnELOPSTY:	POTAnSYEL	BDEEnILNOu:	DEBOuLINEn
AnEMNNORZ:	REZONNMAn	BDEEnNOnOuT:	DEBOuTOnNEn
AnEMNOPST:	ESPOTMAnN	BDEIIOST:	ESTIBIDO
AnEMOSTTY:	TAnSYOMET	BDEIIRSY:	DIBREYIS
AnEnFIINSY:	EnSINIFYAn	BDEIJLNO:	BIDJONEL
AnEnFIISYY:	EnSIYIFYAn	BDEIJLNOn:	BIDJOnNEL
AnEnFIKRSS:	FRAnSISKEn	BDEMNOWY:	DONMBWEY
AnEnINOnPRZ:	AnPRIZOnNEn	BDENNNOOu:	BOuDONNEN
AnEnKNOSSY:	EnKONSYAnS	BDIILNOV:	BIDONVIL
AnENNNOPT:	TAnPONNEN	BDIINOPS:	DISPONIB
AnENNOSTY:	ENTAnSYON	BDIKOuOuRS:	BRIDSOuKOu
AnENNOSVY:	ENVAnSYON	BEEEEnRTV:	EnVETEBRE
AnEOnPRSTY:	PRETAnSYOn	BEEEFNTY:	BYENFETE
AnEOnPRSVY:	PREVAnSYOn	BEEEKLMN:	KELENMBE
AnEOPSTTW:	PWOTESTAn	BEEELNWZ:	BENEZWEL
AnFFKNOOR:	FRAnKOFON	BEEEnLNVY:	BYEnNELVE
AnFIIKSTY:	SYAnTIFIK	BEEENNRY:	BYENNERE
AnFIIRTTZ:	TRAnZITIF	BEEGGINT:	GITENBEG
AnFINORSY:	FRAnSIYON	BEEGNNRZ:	BRENZENG
AnGGILNOY:	GAnGLIYON	BEEIIKLR:	EKILIBRE
AnGILNNOS:	LONGAnNIS	BEEINNVY:	BYENVENI
AnIIKLRTV:	VAnTRIKIL	BEEIPRST:	PRESBITE
AnIIKMNOW:	IWONIKMAn	BEEIPRTZ:	PREZBITE
AnIIKNPST:	PAnNISTIK	BEELNORY:	REBELYON
AnIKKNORS:	KONKIRAnS	BEEMORSW:	SEREBWOM
AnIKLMNOP:	KONPLIMAn	BEEnIKLRV:	VILBREKEn
AnIKMOORZ:	AnKRIMOZO	BEEnILRYZ:	BREZILYEn
AnIKOnSSST:	SIKOnSTAnS	BEENNNOT:	BETONNEN
AnIMMNOSV:	VONMISMAn	BEENOSWY:	BWESONYE
AnINOOVWZ:	OZAnVIWON	BEFIJKOT:	OBJEKTIF
AnJLMOOnPW:	PWOLOnJMAn	BEFINOYZ:	ZONBIFYE
AnKMNOOPT:	KONPOTMAn	BEFLOOuTZ:	FOuTBOLEZ
ANOOSTTW:	ASTWONOT	BEGNNNOOu:	BOuGONNEN
ANOOSTVY:	VOTASYON	BEGNNORW:	GWOBRENN
ANOOSTWY:	WOTASYON	BEIIKLPR:	REPIBLIK
AnOuOuTTTYY:	AnTYOuTYOuT	BEIIKLST:	BISEKTIL
BBBDEILO:	BBEBIDOL		BISIKLET
BBDEEINO:	DEBOBINE	BEIILPST:	PLEBISIT
BBDEEnINO:	DEBOBINEn	BEIKNOnOnZ:	KOnBINEZOn
BBEELLNN:	BLENBLEN	BEIKOnRST:	ESKOnBRIT
BBEFLNOOn:	BOnBONFLE	BEILNOVY:	BOLIVYEN
	BONBOnFLE	BEJNNNOOu:	BOuJONNEN
BBEnNNOOY:	BONBONYEn	BEKLNOOnY:	KOLOnBYEN
BBENNOOnY:	BOnBONYEN	BEKMOORS:	KOSMOBER
BChDEENOT:	ChOTDEBEN	BELLNOOuS:	BOuLSENLO


Tirages de 8 jetons de BELNNNOOu à DEIIINTV - Page 15/19

BELNNNOOu:	BOuLONNEN	DEEENPTW:	DEPWENTE
BEnKLNOOY:	KOLONBYEn	DEEEORTY:	TEDOREYE
BENNNOOuT:	BOuTONNEN	DEEEPRSY:	DEPRESYE
BENNOOuTY:	BOuTONNYE	DEEFFILO:	DEFOFILE
BIIJLOOY:	BIYOLOJI	DEEFGIIR:	DEFIGIRE
BIKOuOuRST:	BRITSOuKOu	DEEFGLNO:	DEGONFLE
BILMOOOT:	OTOMOBIL	DEEFIILT:	FIDELITE
BKLMOOuOuT:	BLOuKOTOuM	DEEFIKTT:	DETEKTIF
ChChEENNTT:	TChENTChEN	DEEFNNOnR:	FREDOnNEN
ChDEEEIPY:	DEChEPIYE	DEEGINST:	DISTENGE
ChDEEENNN:	DEChENNEN	DEEIINTY:	ENDIYITE
ChDEEnFINOn:	DEChIFOnNEn	DEEIIRSV:	RESIDIVE
ChDEKNNOOn:	KOChOnDENN	DEEIISTV:	DIVESITE
ChDEnKNNOO:	KOChONDEnN	DEEIKLNR:	ENKREDIL
ChEEEMRST:	ChEMETRES	DEEIKNRS:	ENDISKRE
ChEFINNNO:	ChIFONNEN	DEEIKOnRS:	KOnSIDERE
ChEIIJNRY:	ChIRIJYEN	DEEIKOPZ:	DEZOKIPE
ChEINORTY:	OTRIChYEN	DEEIKTTY:	DYETETIK
ChENNNOOT:	TOChONNEN	DEEILMNP:	DEPLIMEN
ChFIOOuRST:	ChOFSOuRIT	DEEIMNSY:	MEDSIYEN
ChLLOuOuOuTT:	TChOuLOuLOuT	DEEIMSTY:	DISETYEM
DDEEEGOnV:	DEVEGOnDE	DEEKLOOR:	DEKOLORE
DDEEEnNNS:	SENDENDEn	DEEKMNOnY:	KOnMEDYEN
	SEnDENDEN	DEEKMNOO:	ENKOMODE
	SENDEnDEN	DEEKMNOY:	KOMEDYEN
DDEEEOPS:	DEPOSEDE	DEEKNNOT:	DEKONNET
DDEENOOZ:	DEZODONE	DEEKOOnPZ:	DEKOnPOZE
DDEIIINV:	ENDIVIDI	DEELLOTY:	TELEDYOL
DDFIOORY:	FRIDODOY	DEEMNORT:	DEMONTRE
DDFIOOWY:	FWIDODOY	DEEnFNNOR:	FREDONNEn
DDGGOuOuOuOu:	GOuDOuGOuDOu	DEEnGLNOZ:	ZENGLEnDO
DDJJNNOO:	DJONDJON		ZEnGLENDO
DDNNOOYY:	DYONDYON	DEEnIIJNS:	EnDIJENIS
DEEEEJNR:	DEJENERE	DEEnIJOnSY:	EnDIJESYOn
DEEEFGKL:	FLEGEDEK	DEEnIOnSYZ:	EnDESIZYOn
DEEEFGLP:	FLEGEDEP	DEEnIOPSZ:	EnDISPOZE
DEEEFIRZ:	DEREFIZE	DEEnKMNOY:	KONMEDYEn
DEEEIMNT:	DETEMINE	DEENOORZ:	DEZONORE
DEEEIPYZ:	DEPEYIZE	DEENOPTW:	DETWONPE
DEEEJNTW:	DEJWENTE	DEENORSW:	DEWONSRE
DEEEKPSY:	EKSPEDYE	DEENOSYZ:	DYOSEZEN
DEEELMPR:	DEMEPLER	DEEOnPRSY:	DEPRESYOn
DEEEnGGLO:	DEGEnGOLE	DEEOnPSSY:	DESEPSYOn
DEEEnGNNR:	DEGREnNEN	DEEOuPPRY:	PYEPOuDRE
	DEGRENNEn	DEFFIINT:	DEFINITF
DEEEnKMNR:	DEKRENMEn	DEFIIJST:	DIJESTIF
	DEKREnMEN	DEFNOOPW:	PWOFONDE
DEEEnKNNW:	DEKWENNEn	DEGNNNOO:	GODONNEN
	DEKWEnNEN	DEGNNOnOuW:	GOuDWOnNEN
DEEEnNOnRZ:	DEREZOnNEn	DEIIINTV:	DIVINITE


Tirages de 8 jetons de DEIIKKOnR à EEGOPRSW - Page 16/19

DEIIKKOnR:	KOnKIDIRE		KOnDISYON
DEIILOST:	DOSILITE	DLLLOOOP:	DLOLOLOP
DEIINRST:	ENDISTRI	DMNNOOOnW:	WONDONMOn
DEIIPSST:	PESTISID		WONDOnMON
DEIJLNOW:	JIWONDEL		WOnDONMON
DEIJNOSY:	DIJESYON	DMNNOOOW:	WONDOMON
DEIKKNOT:	KONDIKTE	EEEEKKKL:	KELEKEKE
DEIKKOST:	DISKOTEK	EEEENRST:	ENTERESE
DEIKLNOV:	DEKONVIL	EEEEPRSV:	PESEVERE
DEIKMOST:	DOMESTIK	EEEFKLRT:	REFLEKTE
DEIKNOnSY:	DIKSYOnNE	EEEFLNOT:	TELEFONE
DEIKNORT:	KONTREDI	EEEFNRYZ:	ENFERYEZ
DEIKNOSW:	DESKIWON	EEEIKPST:	PESEKITE
DEIKNOSY:	DIKSYONE	EEEILNTT:	LETENITE
DEIKOnRSY:	DIREKSYOn	EEEINRTV:	VETERINE
DEIKOnRTT:	TIREDKOnT	EEEINSST:	NESESITE
DEIKOPRY:	PERYODIK	EEEIRSTV:	SEVERITE
DEIKOPTW:	PWODIKTE	EEEJMNRY:	JEREMYEN
DEILNOSV:	DOSENVIL	EEEJNNNY:	ENJENNYE
DEILNOWZ:	ZIWONDEL	EEEJNRTY:	JERETYEN
DEIMNNNO:	MIDONNEN	EEEKNPST:	ENSPEKTE
DEIMNOSY:	DEMISYON	EEEKPRST:	RESPEKTE
DEIMOOWY:	EMOWOYID	EEEKRSTY:	EKSTERYE
DEIMTUiYZ:	DIZUiTYEM	EEELNPTT:	PELENTET
DEINNOOP:	ONONDIPE	EEELNSST:	SELESTEN
DEINNORY:	ONDIRYEN	EEELPPTY:	PEPETYEL
DEINNOYZ:	DEZINYON	EEEnGISTV:	EnVESTIGE
DEINOOTZ:	NODOZITE	EEEnGLPTZ:	ZEPEnGLET
DEINOPSY:	PEDISYON	EEEnIMNST:	ESTEMINEn
DEINOSYZ:	DESIZYON	EEEnISSTV:	EnVESTISE
DEKLNOnTUi:	LENKOnDUiT	EEEnKKNSW:	KESEKWEnN
DEKNNOOY:	KODONNYE	EEEnNNNPP:	PENPEnNEN
DEKNNOTUi:	ENKONDUiT		PEnPENNEN
DEKNOOOW:	KOWODONE		PENPENNEn
DEKOORST:	DOKTORES	EEENNSTT:	ENTESTEN
DEnGNNOOuW:	GOuDWONNEn	EEENOPWY:	EWOPEYEN
DEnIIKMNO:	DOMINIKEn	EEFIILST:	FELISITE
DEnKLNOTUi:	LEnKONDUiT	EEFIIMNT:	ENFIMITE
DENNOOST:	ONDONSTE	EEFIKPRT:	PREFEKTI
DENNOOuST:	OuNDONSTE	EEFIKRTY:	REKTIFYE
DENOOnSTW:	WONDOnSTE	EEFILNRT:	ENFILTRE
	WOnDONSTE	EEFKNOnSY:	ENFEKSYOn
DENOOSVY:	DEVOSYON	EEFKOnPSY:	PEFEKSYOn
DFIINOYZ:	DIFIZYON	EEFNNOSS:	SENNESOF
DIIILNPS:	DISIPLIN	EEGGLNNO:	GENNGOLE
DIIJLNOT:	LONJITID	EEGGLNOR:	GRENGOLE
DIIKOnSSY:	DISKISYOn	EEGIILRY:	IREGILYE
DIINOVYZ:	DIVIZYON	EEGILNST:	ESTELING
DIKKLOOW:	KWOKODIL	EEGIOSZZ:	EGZOSIZE
DIKNOOnSY:	KONDISYOn	EEGOPRSW:	PWOGRESE


Tirages de 8 jetons de EEGOSTWY à EGINNOnRZ - Page 17/19

EEGOSTWY:	GWOSYETE	EEnIOPVWZ:	EnPWOVIZE
EEIIKKMN:	EKIMENIK	EEnIPRSST:	SEnTESPRI
EEIIKRST:	SEKIRITE	EEnKKNOnSY:	KEKSYOnNEn
EEIILMNN:	ELIMINEN	EEnKLNOPT:	EnKONPLET
EEIILNSV:	INIVESEL	EEnKNNOSY:	KESYONNEn
EEIIPPRS:	PERIPESI	EEnKOnPSSY:	EnSPEKSYOn
EEIIPSVZ:	SIPEVIZE	EEnLOnPRSY:	LEnPRESYOn
EEIIRSST:	RESISITE	EEnMNNOnPW:	PWOnMEnNEN
EEIJKNOS:	OKSIJENE		PWOnMENNEn
EEIJMNNT:	MENENJIT	EEnMNNOPW:	PWOMENNEn
EEIJNNRY:	NIJERYEN		PWOMEnNEN
EEIJNPSY:	EJIPSYEN	EENNNOSZ:	SEZONNEN
EEIKKLPS:	EKSPLIKE	EEnNOPRSY:	EnPRESYON
EEIKKLRT:	ELEKTRIK	EENNRRST:	RESTRENN
EEIKKMNS:	MEKSIKEN	EENNVVYY:	VYENVYEN
EEIKLOPT:	ELIKOPTE	EENOnPRSY:	ENPRESYOn
EEIKPSTZ:	EKSPETIZ	EENOPSTW:	PWOSTENE
EEIKRSYZ:	RESKIYEZ	EENOPTYY:	ETYOPYEN
EEILLMMO:	MELIMELO	EEOnPRSSY:	ESPRESYOn
EEILNOPP:	ENPOPILE		RESEPSYOn
EEILOSTV:	VELOSITE	EEOPPRSW:	PWOSPERE
EEIMNORS:	SEREMONI	EEOPPRTW:	PWOPRETE
EEIMNSTY:	METSIYEN	EEOPSTTW:	PWOTESTE
EEIMNWYZ:	MENWIZYE	EEOPSTWY:	ESTWOPYE
EEINPRVY:	PERIVYEN	EEORTTYZ:	TETZORYE
EEINPTWY:	PWENTIYE	EFFKOORR:	KOFREFRO
EEJKOPTW:	PWOJEKTE	EFGILORY:	GLORIFYE
EEJNNORS:	JERENONS	EFGINNOnR:	GRIFOnNEN
EEJNNVVY:	JENNVYEV	EFGNNNOOu:	FOuGONNEN
EEJNOSTW:	ESTWOJEN	EFIIIPSS:	SIPEFISI
EEKKNNOT:	KONNEKTE	EFIIJSTY:	JISTIFYE
EEKLNOnPT:	ENKOnPLET	EFIIKRSY:	KRISIFYE
EEKLNORT:	LEKONTRE	EFIIMSTY:	MISTIFYE
EEKLNOSY:	ELEKSYON	EFIINSYZ:	FIZISYEN
EEKLNOTW:	ELEKTWON	EFIKKNOS:	KONFISKE
EEKLOPST:	TELESKOP	EFIKLNOT:	KONIFLET
EEKLOPSZ:	EKSPLOZE	EFIKMNNO:	KONFIMEN
EEKLOSWZ:	ESKLEWOZ	EFIKNORR:	KONFRERI
EEKMOnRTT:	KOnTREMET	EFINNOnRS:	FRISOnNEN
EEKNNOnSY:	KESYOnNEN	EFKKLNOS:	KONFLEKS
EEKNOPRS:	KONPRESE	EFKNOOnSY:	FOnKSYONE
EEKOnPSSY:	EKSEPSYOn		KONFESYOn
EEKOnRSSY:	ESKRESYOn		KOnFESYON
EEKOPTTW:	PWOTEKTE	EFKNOOnTW:	KONFWOnTE
EELLOPRV:	POLVEREL		KOnFWONTE
EELOPSTY:	POLYESTE	EFOOnPSWY:	PWOFESYOn
EEMNNNOR:	RENONMEN	EGIILNRS:	GLISERIN
EEnFILPSY:	SEnPLIFYE	EGIJKLNO:	GLIKOJEN
EEnFKNOSY:	EnFEKSYON	EGINNNOY:	GIYONNEN
EEnIKRSTT:	EnSTRIKTE	EGINNOnRZ:	GRIZOnNEN


Tirages de 8 jetons de EGINNORZ à EnNNNOOWW - Page 18/19

EGINNORZ:	GRIZONEN	EILOOnSVY:	EVOLISYOn
EGMMNNOOn:	MONGOnMEN	EIMNNNOY:	MIYONNEN
	MOnGONMEN	EIMNOPSY:	PEMISYON
EIIIJLMT:	ILEJITIM	EINNNOVW:	VIWONNEN
EIIIJNTV:	VIJINITE	EINNORYY:	REYINYON
EIIJLPRV:	PRIVILEJ	EINNOSTW:	SENTIWON
EIIJNSST:	ENJISTIS	EINOPRYZ:	PRIZONYE
EIIKKMNO:	KOMINIKE	EINOPTWY:	PWOTEYIN
EIIKLLRT:	KILTIREL	EINORSTY:	ISTORYEN
EIIKLMNR:	KRIMINEL	EINOTTTW:	TWOTINET
EIIKLSTT:	TESTIKIL	EIOnPRVYZ:	PREVIZYOn
EIIKMRST:	SIMETRIK	EIOnPSTTW:	TWOnPETIS
EIIKNWYZ:	KWIZINYE	EIOPRTTY:	TRIPOTYE
EIILMNSY:	MILISYEN	EIOPSSSW:	PWOSESIS
EIILNOPZ:	POLINIZE	EJLNOOPW:	PWOLONJE
EIILOSTT:	OSTILITE	EKKLMOOY:	KOMOKYEL
EIILPRST:	PERISTIL	EKKLNOOT:	KOLOKENT
EIILSSSY:	SELSIYIS	EKKNNOOnT:	KONKOnNET
EIIMNPRR:	ENPRIMRI		KOnKONNET
EIIMNSYZ:	MIZISYEN	EKLNOOPT:	KONPLOTE
EIINOPTZ:	IPNOTIZE	EKLNOOTW:	KONTWOLE
	IPOTENIZ	EKLNOPTY:	PONKTYEL
EIINRSST:	SINISTRE	EKMNNOOnS:	KOnSONMEN
EIJJLOOY:	JEYOLOJI		KONSOnMEN
EIJKKLOO:	EKOLOJIK	EKMNNOOP:	MONKONPE
EIJKLOOS:	EKOLOJIS	EKMNOOTW:	KWONOMET
EIJLLOSY:	LOJISYEL	EKMOOSTW:	ESKWOTOM
EIJLNOOT:	ETNOLOJI	EKNOOnPRS:	KORESPOnN
EIJLNORY:	RELIJYON	EKNOOPSY:	ESKOPYON
EIJNNOTW:	NITWOJEN	EKNOOuPTY:	KONPYOuTE
EIKKLNOP:	KONPLIKE	EKOnOnPSSY:	KOnSEPSYOn
EIKKMNOO:	EKONOMIK	EKOOnPRSY:	PREKOSYOn
EIKLNOST:	KONSILTE	ELLOOnSVY:	VYOLOnSEL
EIKLOOnSY:	ELOKISYOn	ELNNOOnPT:	PLOTOnNEN
EIKLOSTT:	LESKOTIT	EMNNNOPW:	PWONMNEN
EIKMNNOY:	KOMINYEN	EMNOOSTZ:	MOTSEZON
EIKMNOOS:	EKONOMIS	EnEnIIKMNR:	EnKRIMINEn
EIKMNOOT:	KOMINOTE	EnEnMNNOPW:	PWONMEnNEn
EIKMNOPR:	KONPRIME	EnFFIIINT:	EnFINITIF
EIKNNOPT:	NENPOTKI	EnFGINNOR:	GRIFONNEn
EIKNNOTY:	KONTINYE	EnFINNORS:	FRISONNEn
EIKNOPST:	KONSTIPE	EnGIKLSTUi:	LEnGUiSTIK
EIKOPRSW:	RESIPWOK	EnGINNORZ:	GRIZONNEn
EIKOuRTYZ:	KOuTIRYEZ	EnGMMNNOO:	MONGONMEn
	KOuTRIYEZ	EnIIJLSST:	LEnJISTIS
EILLOuPSV:	SILVOuPLE	EnIIKOnSYZ:	EnKIZISYOn
EILNNNOP:	PILONNEN	EnILMOuPWZ:	PLIZOuMWEn
EILNORVZ:	LIVREZON	EnKMNNOOS:	KONSONMEn
EILNOSTW:	SITWONEL	EnLNNOOPT:	PLOTONNEn
EILNOSTY:	LEYONTIS	EnNNNOOWW:	WONWONNEn


Tirages de 8 jetons de EnNNOOnYZZ à OOOnPPSWY - Page 19/19

EnNNOOnYZZ:	ZOnZONNYEn	IOOnPVWYZ:	PWOVIZYOn
	ZONZOnNYEn	IOOOnPSYZ:	OPOZISYOn
ENNOnOnYZZ:	ZOnZOnNYEN	JKKOnOnOnSY:	KOnJOnKSYOn
ENNOOPSW:	PWONONSE	KLOOOOST:	SOLOKOTO
ENOOPRSY:	OPRESYON	KLOOOPPT:	PLOKOTOP
ENOOPSSY:	POSESYON	KLOOOPTW:	PWOTOKOL
EOOnPSSWY:	PWOSESYOn	KMMNNOOOn:	MOnKONMON
EOOTTWYY:	TYOTYOWE		MONKOnMON
FFIILOOZ:	FILOZOFI		MONKONMOn
FIIIMPRT:	PRIMITIF	KMMOOOWZ:	KWOMOZOM
FIIINRTT:	NITRITIF	KNOOOWYZ:	KOWOZYON
FIJLMOOO:	MOFOLOJI	MMNNOOTT:	TONMTONM
FIKLLOOW:	KLOWOFIL	MOOOnPSWY:	PWOMOSYOn
FIKNOOnYZ:	KONFIZYOn	OOOnPPSWY:	PWOPOSYOn
	KOnFIZYON		
FIKNOOOT:	OTOFONIK		
FIKNORSY:	FRIKSYON		
FIKOOOPT:	FOTOKOPI		
FKLNOOOY:	KONFYOLO		
FKNNOOSY:	FONKSYON		
GGNNOOOnP:	POnGONGON		
	PONGOnGON		
	PONGONGOn		
GILLOOPT:	POLIGLOT		
IIIILTTT:	TILITITI		
IIIKLMNS:	MINISKIL		
IIIKLOTT:	OTIKILTI		
IIJKLOOS:	SIKOLOJI		
IIJLOOST:	SITOLOJI		
IIKKPPRR:	KRIPKRIP		
IIKLNNOR:	KRINOLIN		
IIKLORST:	KLITORIS		
IILLPPPP:	PLIPPLIP		
IILNOPPS:	PONPILIS		
IIMNNOSY:	MINISYON		
IIMNORST:	MONITRIS		
IINNOPSY:	PINISYON		
IINOnRSTY:	NITRISYOn		
IJLOOOWZ:	ZOWOLOJI		
IKKKOOOR:	KOKORIKO		
IKKLOnOnYZ:	KOnKLIZYOn		
IKLNOOYZ:	KOLIZYON		
IKMNNOOnY:	KOnMINYON		
	KONMINYOn		
IKMNNOOY:	KOMINYON		
IKMNOOSY:	KOMISYON		
ILNOOPSY:	POLISYON		
ILNOOSSY:	SOLISYON		
ILNOOSVY:	VYOLONIS		
INOOPSYZ:	POZISYON		


