Tirages de 9 lettres de AAAABKLLN à AABGLLMNO - Page 1/11

AAAABKLLN:	ANBALAKAL	AAAnDFLMOnT:	FOnDAMAnTAL
AAAABNNRS:	ANBARASAN	AAAnDNNPST:	PANDAnSTAN
AAAAKNNOW:	ANAKAWONA		PANDANSTAn
AAAALMNSZ:	SALMANAZA		PAnDANSTAN
AAAAnBMNRS:	AnBARASMAN	AAAnEGMNPT:	PEMAnGANAT
	ANBARASMAn	AAAnEMNNPS:	AnPEMANANS
AAAAnDNNNT:	ANNATANDAn	AAAnEMNPRT:	TAnPERAMAN
	ANNATAnDAN		TANPERAMAn
	AnNATANDAN	AAAnFINTYY:	ANFAnTIYAY
AAAAnKKLMM:	AnMALMAKAK		AnFANTIYAY
AAABDEGNR:	ANDEGRABA	AAAnFLMOnSY:	AnFLAMASYOn
AAABDKOnVY:	VAKABOnDAY	AAAnIMNSVY:	ANVAYISMAn
AAABEFLNT:	ANALFABET		AnVAYISMAN
AAABEJMNT:	TABAMANJE	AAAnIPRSTY:	APRAnTISAY
AAABIKNRR:	ARANBARIK	AAAnJKMNOuR:	AnKOuRAJMAN
AAABINOWY:	ANAYIBOWA		ANKOuRAJMAn
AAABKLNNT:	BATANKLAN	AAAnMNOnPWZ:	AnPWAZOnMAN
AAABLORTW:	LABORATWA		ANPWAZOnMAn
AAABMNNNZ:	BANZANMAN	AAANNNNRT:	ANNANTRAN
AAAChIKKPT:	KATChAPIKA	AAANNNSTZ:	SANZATANN
AAADFMNNN:	FANDANMAN	AAANNNTTZ:	TANZANTAN
AAADIKMRR:	KAMARADRI	AAAnNPRRST:	TRANSPARAn
AAADOnPSTY:	ADAPTASYOn		TRAnSPARAN
AAAEIMRVY:	AVEMARIYA	AABBDMNNO:	BONBADMAN
AAAEJLMNS:	SALAMANJE	AABBEMNOY:	AYABONMBE
AAAEKLPRT:	KAPRELATA	AABBEnRRYZ:	ZARYEnBRAB
AAAFNNNNS:	ANNANFANS	AABBIKKRR:	BRIKABRAK
AAAGILMTY:	GALIMATYA	AABBIKNOT:	BIKABONAT
AAAGKNRSV:	AKSANGRAV	AABChELLNT:	LABLANChET
AAAGNNPRR:	GRANPARAN	AABChILNSY:	BLANChISAY
AAAIKLMMN:	AMIKALMAN	AABChLLNNN:	BLANChLANN
AAAKLMOnSY:	AKLAMASYOn	AABDEGINR:	ANBRIGADE
AAAKNNNNN:	KANNANNAN	AABDEKOPT:	DEKAPOTAB
AAALMMNNW:	MANMANLWA	AABDELLSY:	LADYABLES
AAALMNNPS:	ANPLASMAN	AABDEMNWZ:	DEBWAZMAN
AAALNOWYY:	ALAWONYAY	AABDENNNO:	ABANDONEN
AAAMMNNNS:	SANMANMAN	AABDENOTW:	DEWOTANBA
AAAnAnDFLMN:	AnMALDAnFAN	AABDGINRY:	BRIGANDAY
	AnMALDANFAn	AABDILRST:	BALISTRAD
	ANMALDAnFAn	AABEELNSZ:	ANBAZESEL
AAAnBDIRSS:	AnBASADRIS	AABEFIKLT:	ALFABETIK
AAAnBDLLRT:	LATRAnBLAD	AABEGNOnSY:	ABNEGASYOn
AAAnBFLNWY:	FLANBWAYAn	AABEKMNNT:	BATMANNKE
	FLAnBWAYAN	AABEnKLNST:	SALTEnBANK
AAAnBINTTV:	AnBATIVANT	AABENNNNW:	BWANANNEN
	ANBATIVAnT	AABENNSTY:	ESTANNBAY
AAAnDEJLMM:	DEMAJAnMAL	AABENOuTYY:	ANBOuTEYAY
AAAnDEJTVZ:	DEZAVAnTAJ	AABENPRTZ:	PREZANTAB
AAAnDEKMNR:	AnKADREMAN	AABENRSTY:	BATRASYEN
	ANKADREMAn	AABGLLMNO:	GLOBALMAN


Tirages de 9 lettres de AABILMNNOu à AAENPRVWY - Page 2/11

AABILMNNOu:	MANNIBOuLA	AADMNNNOS:	ADANMSONN
AABILMNOS:	ABSOLIMAN	AADNOORSY:	ADORASYON
AABILOTTY:	TABLATIYO	AAEEJLNNR:	ANJENERAL
AABIMNOuST:	ABOuTISMAN	AAEEJLNRT:	ALETRANJE
AABINOSTY:	ABITASYON	AAEEMNNPY:	PANAMEYEN
AABLMNNNO:	BALONNMAN	AAEEnGPRWY:	PARAGWEYEn
AAChGILLNT:	LANGLIChAT	AAEEnIKPST:	EnKAPASITE
AAChNNNOPY:	ChANPYONNA	AAEFILNTT:	ALTENATIF
AADDEEnNNP:	EnDEPANDAN	AAEFNNRTY:	FARENNAYT
AADDENNSS:	DESANDANS	AAEGIKNST:	AKSANTEGI
AADDENRTW:	DWADANTRE	AAEGILLMN:	ILEGALMAN
AADDIKNNT:	DIKDANTAN	AAEGILNVZ:	GALVANIZE
AADEEJKKZ:	KADEJAKEZ	AAEGJMNNR:	GRANMANJE
AADEEKLNS:	ESKANDALE	AAEGMMNNT:	GETMANMAN
AADEEMMNZ:	DEZAMEMAN	AAEGMNNRT:	GRANMATEN
AADEEnEnFFL:	ALAFEnDEFEn	AAEIJKMNY:	JAMAYIKEN
AADEEnGGNN:	DEGAGANNEn	AAEIJMNST:	AJISTEMAN
AADEENNVY:	AVANDENYE	AAEIKLTTY:	AKTYALITE
AADEENPRZ:	DEZANPARE	AAEIKMMTT:	MATEMATIK
AADEFIMNR:	DIFERAMAN	AAEILMNTY:	LAMATINYE
AADEFNOuWY:	ANFOuDWAYE	AAEIMNSTV:	AVETISMAN
AADEGGMNT:	GADMANTEG	AAEINNNRS:	ANRASINEN
AADEIILMS:	AMEDISALI	AAEINNNSS:	ANSASINEN
AADEIKMMN:	MEDIKAMAN	AAEINPRTT:	TANPERATI
AADEIKNST:	AKSIDANTE	AAEINRTVY:	AVANTIRYE
AADEILNNR:	ADRENALIN	AAEJKLLSV:	LESKLAVAJ
AADELMMWZ:	MADMWAZEL	AAEKKNNNN:	KANKANNEN
AADELMNNR:	MALANDREN	AAEKLLNSY:	LAKANSYEL
AADELMNPS:	DEPLASMAN	AAEKLMNTY:	AKTYELMAN
AADELNOSS:	ADOLESANS	AAEKLNNNV:	VALKANNEN
AADEnLMNNN:	NANLANDMEn	AAEKLNNTY:	ALYENNKAT
AADFGKORY:	KADYOGRAF	AAEKLOnRSY:	EKLARASYOn
AADFIMOnSY:	DIFAMASYOn	AAEKMMNNT:	KETMANMAN
AADGIILMT:	AMIGDALIT	AAEKMNRTY:	KARANTYEM
AADGINRST:	SANTIGRAD	AAEKNNOnSY:	ENKANASYOn
AADGKMORY:	KADYOGRAM	AAEKNNSTW:	AKWENTANS
AADHNOOuTY:	ADYAHOuNTO	AAELMMTWZ:	MATMWAZEL
AADIIKLPT:	DIPLIKATA	AAEMNNNRT:	ANTRENMAN
AADIJKNNO:	ADJANIKON	AAEMNNOSZ:	ASEZONMAN
AADIJMNNN:	DANMIJANN	AAEMNNPRS:	ANPRESMAN
AADIKNNOY:	ADYANIKON	AAEMNNPTW:	APWENTMAN
AADIKNPPY:	DAPPIYANK	AAEMNNRSS:	RESANSMAN
AADILOnSTY:	DILATASYOn	AAEMNNRSY:	RANSEYMAN
AADIMNOnSW:	AWOnDISMAN	AAEnFLMOnSY:	EnFLAMASYOn
AADIMOnRSY:	ADMIRASYOn	AAEnKNNOSY:	EnKANASYON
AADINPPPY:	DAPPIYANP	AAEnKNPSTW:	PWASEnKANT
AADIOnRSYY:	RADIYASYOn	AAEnLOnSSTY:	EnSTALASYOn
AADKMMNNO:	KOMANDMAN	AAEnNNOnPWZ:	ANPWAZOnNEn
AADKMNNNO:	KONMANDAN	AAENNPSSY:	ENPASYANS
AADKNOnOnSY:	KOnDANASYOn	AAENPRVWY:	PREVWAYAN


Tirages de 9 lettres de AAEOnPRRSY à AAnENNPRRT - Page 3/11

AAEOnPRRSY:	REPARASYOn	AAnBDINOnSY:	ANBAnDISYOn
AAEOnPRSSY:	SEPARASYOn		AnBANDISYOn
AAEOnRSSTY:	ARESTASYOn	AAnBEILMNS:	ANBELISMAn
AAFIIKMNY:	MANYIFIKA		AnBELISMAN
AAFIIKMTY:	MAYIFIKAT	AAnBEILMTY:	ABITYELMAn
AAFILOnSYY:	AFILYASYOn	AAnBEISSTY:	ABSAnTEYIS
AAFIMNNNS:	FINANSMAN	AAnBEJJNRT:	JAnJANBRET
AAFIMNOSY:	AFIMASYON		JANJAnBRET
AAFKOSTTW:	KATASTWOF	AAnBEKLNST:	SALTENBAnK
AAFMNNORS:	FRANMASON	AAnBEKMNOnR:	ANKOnBREMAn
AAFMNNOTW:	AFWONTMAN		AnKOnBREMAN
AAGIJLNOS:	LAGOJANIS	AAnChDEKLMN:	DEKLANChMAn
AAGINOnSVY:	NAVIGASYOn		DEKLAnChMAN
AAGLMNOTY:	MALATYONG	AAnChEFIRRS:	RAFREChISAn
AAGNNOPPW:	PWOPAGANN	AAnDDEENNP:	ENDEPANDAn
AAIIKLPST:	KAPITALIS		ENDEPAnDAN
AAIILMNSV:	AVILISMAN	AAnDDEEnNPS:	EnDEPAnDANS
AAIILNRST:	NATIRALIS		EnDEPANDAnS
AAIIMNRST:	ANIMATRIS	AAnDDEJMMO:	DEDOMAJMAn
AAIJNOSTY:	AJITASYON	AAnDDEMOOY:	AnDODOMEYA
AAIKLOnPSY:	APLIKASYOn	AAnDDMMNYY:	DYAnMDYANM
AAIKLOPPS:	APOKALIPS		DYANMDYAnM
AAIKMNOnPT:	KOnPATIMAN	AAnDEEGGNN:	DEGAGAnNEN
AAIKMNPRT:	PRATIKMAN	AAnDEEGMRZ:	DEZAGREMAn
AAIKNOSYZ:	AKIZASYON	AAnDEEKLSZ:	ESKAnDALEZ
AAILMOPRS:	MARISALOP	AAnDEEKNSS:	AKDENESAnS
AAIMMNOST:	AMOTISMAN	AAnDEEPSTY:	DEPASYAnTE
AAIMNNOSY:	ANIMASYON	AAnDEIKKLR:	KALAnDERIK
AAINOnPSTY:	ANPITASYOn	AAnDEIKLRY:	KALAnDRIYE
AAINOPRSY:	APARISYON	AAnDEIMNRS:	DERASINMAn
AAINOSSYY:	ASIYASYON	AAnDELMNNN:	NAnLANDMEN
AAINOSVYY:	AVIYASYON		NANLAnDMEN
AAIOnPRSSY:	ASPIRASYOn	AAnDGIMNOuS:	AnGOuDISMAN
AAJKMNNOuT:	MATJOuKANN		ANGOuDISMAn
AAJKNNOPR:	KRAPONNAJ	AAnDILMOPS:	APLODISMAn
AAKKKKMOO:	KOKOMAKAK	AAnDIMNOSW:	AWONDISMAn
AAKLOPSTT:	KATPOSTAL	AAnDINSSSW:	SWASAnNDIS
AAKMMNNOS:	KOMANSMAN	AAnEEJLMNR:	JENERALMAn
AAKMNNOnST:	KOnSANTMAN	AAnEEPRTTZ:	PREZAnTATE
AAKMNNOnTT:	KOnTANTMAN	AAnEFMOnSTY:	FEMAnTASYOn
AAKNNOPRY:	KRAPONNAY	AAnEFOnSTTY:	FETATAnSYOn
AAKNORSTY:	ATRAKSYON	AAnEILMNRT:	NATIRELMAn
AALNOnPSTY:	PLANTASYOn	AAnEINNPST:	AnPENITANS
AAnAnBELMRS:	RASAnBLEMAn		ANPENITAnS
AAnAnDENTTZ:	DETAnZAnTAN	AAnEKNPSTW:	PWASENKAnT
	DETAnZANTAn	AAnELRSSTV:	TRAnSVESAL
	DETANZAnTAn	AAnEMSSTWY:	SWASAnTYEM
AAnAnDGIMRS:	AGRAnDISMAn	AAnEnNNOPWZ:	AnPWAZONNEn
AAnAnMNOPWZ:	AnPWAZONMAn	AAnENNOnPWZ:	AnPWAZOnNEN
AAnBChEHKOZ:	ChEHKOBAnZA	AAnENNPRRT:	ANTREPRAnN


Tirages de 9 lettres de AAnENNPRRT à ADDENOORY - Page 4/11

	AnTREPRANN	ABEEKPRST:	RESPEKTAB
AAnEPRSVWY:	PREVWAYAnS	ABEEnFNSYZ:	BYEnFEZANS
AAnFIIKMPS:	PASIFIKMAn	ABEEnJJNRT:	JEnJANBRET
AAnIKLMOnPS:	AKOnPLISMAn	ABEEnNSSYY:	BYEnSEYANS
AAnIKMNOnST:	KOnSANTIMAn	ABEGGNNRR:	GRANBRENG
	KOnSAnTIMAN	ABEGNNNRR:	GRANBRENN
AAnIKMNOPT:	KONPATIMAn	ABEIILRTT:	BRITALITE
AAnINOPSTY:	AnPITASYON	ABEIILRTZ:	BRITALIZE
AAnKMNNOST:	KONSAnTMAN	ABEIJLNOR:	BLENORAJI
	KONSANTMAn	ABEIKMNRS:	BRISKEMAN
AAnKMNNOTT:	KONTANTMAn	ABEILMOST:	METABOLIS
	KONTAnTMAN	ABEINNOSY:	IBENASYON
AAnKOnRSTYZ:	TRAnZAKSYOn	ABEINOPST:	ENSIPOTAB
AAnLNOPSTY:	PLAnTASYON	ABEIOnPRSS:	IRESPOnSAB
AAnNNOuOuPSS:	SOuSOuPANNAn	ABEJJLNOUi:	LUiJANBOJE
	SOuSOuPAnNAN	ABEKLNNNO:	KONBELANN
AANNOOuRTW:	ORANWOuTAN	ABEKLNOOnS:	ENKOnSOLAB
AANNOPRSY:	SARANPYON	ABEKNORSS:	RESKONSAB
AANNOSSSY:	SANSASYON	ABELMNOuSV:	BOuLVESMAN
AAnOOnRSTYY:	ORYAnTASYOn	ABEnIKKNSW:	BISKANKWEn
ABBBIOORT:	TRIBOBABO	ABEnKKNOST:	SEnKANTKOB
ABBEINNNO:	ANBOBINEN	ABEnKLNOOS:	EnKONSOLAB
ABBEKLOST:	BASKETBOL	ABENOPRSS:	RESPONSAB
ABChDEELOR:	DEChALBORE	ABEOOnSSVY:	OBSEVASYOn
ABChDEMNOW:	WOBDEChANM	ABFGIIORY:	BIYOGRAFI
ABChIILNRS:	BLANChISRI	ABGILOOnSY:	OBLIGASYOn
ABDEEEnLNS:	ABSEDELEnN	ABIIKKNOnY:	KOnKIBINAY
ABDEEINRZ:	ENDEZIRAB	ABIIKORSW:	BIWOKRASI
ABDEEITYZ:	DEZABITYE	ABIIMNNSZ:	BIZNISMAN
ABDEEKLLN:	KALBLENDE	ABILNOOSY:	ABOLISYON
ABDEEMNOY:	MAYODEBEN	ABILOOnSSY:	ABSOLISYOn
ABDEEnJLOS:	EnSELBADJO	ABINOnSSVY:	SIBVANSYOn
ABDEENORZ:	DEREZONAB	ABINORSVY:	VIBRASYON
ABDEFIKNOu:	BOuKANDIFE	AChDEEELMW:	DEMAChWELE
ABDEGINNY:	GADYENNBI	AChDEEIJPY:	DEChEPIYAJ
ABDEIJNNOn:	BADIJOnNEN	AChDEIMNNOn:	MADIChOnNEN
ABDEINPSW:	PWENDISAB	AChDEIOSYZ:	AChIDYOSEZ
ABDELNOSY:	LOBEDYANS	AChDEnIMNNO:	MADIChONNEn
ABDEnEnIPSS:	EnDISPEnSAB	AChEFILMNS:	FLEChISMAN
ABDEnIJNNO:	BADIJONNEn	AChEIKNNNP:	PIChKANNEN
ABDENNNNO:	BANDONNEN	AChEINNOTY:	EChANTIYON
ABDIILMOT:	ADLIBITOM	AChENNNNOT:	ChANTONNEN
ABDIJNNOW:	BIDJAWONN	AChFLNOuOuST:	SOuFLANTChOu
ABDINNOSY:	BANDISYON	ADDEEEPSW:	DEPESWADE
ABDMNNNOOu:	BOuDONNMAN	ADDEEGOnVY:	DEVEGOnDAY
ABEEEMNPY:	ENPEMEYAB	ADDEEIRTZ:	DEZIDRATE
ABEEFLMNS:	BLASFEMEN	ADDEEJNYZ:	DYAZDEJEN
ABEEFLNTY:	FEBLANTYE	ADDEEKMNO:	DEKOMANDE
ABEEIJLNR:	BELIJERAN	ADDEIKPRW:	KWADRIPED
ABEEKLRSZ:	ESKRABLEZ	ADDENOORY:	DEYODORAN


Tirages de 9 lettres de ADDENOORZ à AEEGMNRRY - Page 5/11

ADDENOORZ:	DEZODORAN	ADEIMNNNR:	MANDRINEN
ADDLOORYY:	RADYODYOL	ADEIMNOuST:	ETOuDISMAN
ADEEELMTW:	ETWALDEME	ADEINNPRS:	ENPRIDANS
ADEEEnMNRY:	AMERENDYEn	ADEINOnSYY:	ENDIYASYOn
	AMEREnDYEN	ADEIOnSSTY:	DISETASYOn
ADEEFINNR:	ENDIFERAN	ADEKNOnRST:	KOnTREDANS
ADEEFMNOZ:	MEZONDAFE	ADEKOOnRSY:	DEKORASYOn
ADEEGLOnSY:	DELEGASYOn	ADELMNOPV:	DEVLOPMAN
ADEEGNNRY:	ENGREDYAN	ADELMNOPW:	PALENDWOM
ADEEIKLST:	DELIKATES	ADELOOnSYZ:	DEZOLASYOn
ADEEIKNRV:	REVANDIKE	ADEMOOnRSY:	MODERASYOn
ADEEIKPRT:	PREDIKATE	ADEnGIIRTT:	EnGRATITID
ADEEIMNNT:	DETEMINAN	ADEnIINPST:	APEnNDISIT
ADEEJMNOnZ:	DEMANJEZOn	ADEnIKNOSY:	EnDIKASYON
ADEEKLNNS:	DELENKANS	ADEnINOSYY:	EnDIYASYON
ADEEKMNNO:	DEMAKONEN	ADENNOORZ:	DEZONORAN
ADEEKMNOR:	REKOMANDE	ADENNOSTY:	DETANSYON
ADEELLLOY:	DYOLALELE	ADEOOnPSTY:	DEPOTASYOn
ADEELPSTY:	PYEDESTAL	ADFIKNNOS:	KONFIDANS
ADEEMMNYZ:	DEZYEMMAN	ADFIKOnRSY:	DIFRAKSYOn
ADEEnFINRS:	EnDIFERANS	ADFINOOPW:	APWOFONDI
ADEEnGNRYZ:	ZEnGREDYAN	ADFNNOOSY:	FONDASYON
ADEENNNTT:	TENTENNAD	ADGIIIJMR:	MADIGRIJI
ADEENNOuYZ:	DEZANNOuYE		MAJIGRIDI
ADEEOuPVWZ:	DEZAPWOuVE	ADIILMOPS:	DIPLOMASI
ADEFFIIST:	FEDATIFIS	ADIKNOOnSY:	AKONDISYOn
ADEFGIMOR:	DEMOGRAFI		AKOnDISYON
ADEFIIKNT:	ENDIKATIF	ADIKOOnSSY:	OKSIDASYOn
ADEFIINTY:	IDANTIFYE	ADIMNNOSY:	DIMANSYON
ADEFIKORT:	DEKORATIF	ADIMNOOnSY:	DOMINASYOn
ADEFIMOTW:	EMAFWODIT	ADINNOOnSY:	INONDASYOn
ADEFKOnOnSY:	FEKOnDASYOn		INOnDASYON
ADEFMOOnSY:	DEFOMASYOn	ADINNORSY:	SANDRIYON
ADEFOnOuPVW:	FOnDEPOuVWA	ADINNOSTY:	DANTISYON
ADEGIJKMO:	DEMAGOJIK	ADINOOuVYZ:	VODOuYIZAN
ADEGINNNR:	GRENNADIN	ADINOPSVW:	PWOVIDANS
ADEGORRTW:	RETWOGRAD	AEEEKPSTT:	ESPEKTATE
ADEIILNPV:	VILIPANDE	AEEELMNNT:	ETENELMAN
ADEIILSTT:	DISTILATE	AEEELNRTY:	ALENTERYE
ADEIIMNVZ:	MADIVINEZ	AEEEnINRST:	EnSINERATE
ADEIINPST:	APENDISIT	AEEENNRST:	ENTERESAN
ADEIKLOnSY:	LEDIKASYOn	AEEFIIKST:	EFIKASITE
ADEIKMNOT:	DOKIMANTE	AEEFINRTT:	FRATENITE
ADEIKMORS:	DEMOKRASI	AEEFINRTZ:	FRATENIZE
ADEIKNOnSY:	ENDIKASYOn	AEEFNPRRS:	PREFERANS
ADEIKNOSY:	EDIKASYON	AEEGIILLT:	ILEGALITE
ADEIKPRTY:	PEDYATRIK	AEEGIILNT:	INEGALITE
ADEILNRSV:	DELIVRANS	AEEGIMNNZ:	EGZAMINEN
ADEILORTY:	EDITORYAL	AEEGMNNRW:	MARENGWEN
ADEIMNNNO:	AMIDONNEN	AEEGMNRRY:	GRAMERYEN


Tirages de 9 lettres de AEEIJKMNN à AEIIPRTVZ - Page 6/11

AEEIJKMNN:	ENEJIKMAN	AEEnKKNNOS:	EnKONSEKAN
AEEIJLNNT:	ENTELIJAN	AEEnKMNSTY:	SEnKANTYEM
AEEIJLNPR:	PELERINAJ	AEEnKNNOnVY:	EnKOnVENYAN
AEEIJRSTT:	ESTRATEJI	AEEnKNNOPT:	EnKONPETAN
AEEIKKRRZ:	AZIKREKRE	AEEnKNNOVY:	EnKONVEYAN
AEEIKMNNZ:	EKZAMINEN	AEEnKORTWY:	EKWATORYEn
AEEILMSTV:	MALVESITE	AEEnLNNORZ:	LAREZONNEn
AEEILNPRY:	PELERINAY	AEEnMNNNTV:	VANTMEnNEN
AEEINNNSS:	ENSASINEN		VANTMENNEn
AEEINSSTZ:	ANESTEZIS	AEEnMNTVYY:	VYETNAMYEn
AEEJKLMNY:	JAKMELYEN	AEENNNOSZ:	ASEZONNEN
AEEJKLNOT:	KONJELATE	AEENOSSTY:	ESTASYONE
AEEJKOPRT:	JAKOREPET	AEENPRSSY:	ESPERYANS
AEEJLMOTY:	JEYOTEMAL	AEENPRSTY:	PRETANSYE
AEEJNOnRSY:	JENERASYOn	AEFGIJORY:	JEYOGRAFI
AEEKKNNOnS:	ENKOnSEKAN	AEFGLMNNO:	GONFLEMAN
AEEKLLNOT:	NETALKOLE	AEFIIJLRT:	FRAJILITE
AEEKLLORT:	ELEKTORAL	AEFIIKLSZ:	FISKALIZE
AEEKLMNOnT:	MALOnNEKTE	AEFIILSTY:	ATIFISYEL
AEEKLOnRSY:	EKLERASYOn	AEFIKMNOnT:	ENFOnMATIK
AEEKLORRT:	KOLERATER	AEFIKMNOT:	ENFOMATIK
AEEKLPSTW:	EKSPLWATE	AEFILNNSY:	ENFLIYANS
AEEKMNOST:	ESTONMAKE	AEFINPRTV:	PREVANTIF
AEEKMNOuRS:	REKOuMANSE	AEFKMMNOOn:	KOnFOMEMAN
AEEKMNOuSW:	ANMWESEKOu	AEFKNOnRSY:	ENFRAKSYOn
AEEKMOSTZ:	ESKAMOTEZ	AEFKOnRRSY:	REFRAKSYOn
AEEKNNOnPT:	ENKOnPETAN	AEFLNNNOP:	PLAFONNEN
AEEKNNOnVY:	ENKOnVEYAN	AEFLNNOSY:	ENFLASYON
AEEKNNRTV:	VENNKATRE	AEFLNOTWY:	LAFWONTYE
AEEKNOnPRS:	REKOnPANSE	AEFMMOOTZ:	METAMOFOZ
AEEKOnRTTY:	KOnTRAYETE	AEFMNOOnSY:	ENFOMASYOn
AEELLNSSY:	LESANSYEL	AEFNOuOuPTY:	PANTOuFOuYE
AEELMMNNN:	MALMENNEN	AEGGNORYZ:	GRANGOZYE
AEELMNNPS:	SENPLEMAN	AEGIIKLRT:	AGRIKILTE
AEELMNOnTT:	MALOnNETTE	AEGIJLNNS:	NEGLIJANS
AEELNNOnRZ:	LAREZOnNEN	AEGIKKORT:	KATEGORIK
AEELNNSST:	LASENTSEN	AEGINSSTZ:	EGZISTANS
AEELNOSVY:	ELEVASYON	AEGMMNNNO:	MANGONMEN
AEELOSSTY:	LASOSYETE	AEGNNNORY:	GARYONNEN
AEEMMNYYZ:	MYEZANMYE	AEGNNOSVV:	VOSVAGENN
AEEMNRSYZ:	SERYEZMAN	AEIIKKRST:	EKARISTIK
AEEnFILNSY:	EnFLIYANSE	AEIIKLNTT:	LANTIKITE
AEEnFIMOTZ:	EnFOMATIZE	AEIIKLPST:	EKALIPTIS
AEEnFKNRTY:	FRANKETYEn	AEIIKLTTV:	KILTIVATE
AEEnGGNNNR:	GANGREnNEN	AEIIKMRTT:	ARITMETIK
	GANGRENNEn	AEIILMORT:	IMORALITE
AEEnIJLNST:	EnTELIJANS	AEIILRSSY:	SIREYALIS
AEEnIKMNSY:	MEKANISYEn	AEIIMNRSS:	SEMINARIS
AEEnILNSTT:	EnTESTINAL	AEIINPRSZ:	ISIPREZAN
AEEnILPRSY:	EnPERYALIS	AEIIPRTVZ:	PRIVATIZE


Tirages de 9 lettres de AEIJKLNOnT à AIKLOnOnPSY - Page 7/11

AEIJKLNOnT:	KOnJENITAL	AEnFMNOOSY:	EnFOMASYON
AEIJKRRTY:	JERYATRIK	AEnGINOVYY:	GONAYIVYEn
AEIJLOOPT:	EPATOLOJI	AEnIILSSTW:	EnSISWATIL
AEIJMNOnSY:	JEMINASYOn	AEnIKKORST:	KOSTARIKEn
AEIKLNRST:	KRISTALEN	AEnILOPSVW:	ALEnPWOVIS
AEIKMNNOT:	KONTAMINE	AEnINNOnPRZ:	ANPRIZOnNEn
AEIKMORTT:	EMATOKRIT	AEnINOSTVY:	EnVITASYON
AEIKMOSTV:	VASEKTOMI	AEnKKLNNOS:	KLAKSONNEn
AEIKNNRST:	KANNISTER	AEnKNNOSSY:	EnKONSYANS
AEIKNRSST:	SAKRISTEN	AENNNNOPT:	TANPONNEN
AEIKOnSSTY:	EKSITASYOn	AENNNOPWZ:	PWAZONNEN
AEILNPPRS:	PRENSIPAL	AENNNOSTY:	ENTANSYON
AEILNPRTZ:	PLEZANTRI	AENNNOSVY:	ENVANSYON
AEILOPRST:	RAPISTOLE	AENOnPRSTY:	PRETANSYOn
AEIMNNRST:	ENSTRIMAN	AENOnPRSVY:	PREVANSYOn
AEIMOnSSTY:	ESTIMASYOn	AENOOnRSVY:	RENOVASYOn
AEINOnPSTY:	IPETANSYOn	AENOOPRSY:	OPERASYON
AEINOnSTVY:	ENVITASYOn	AENOPSTTW:	PWOTESTAN
AEINOSTYZ:	EZITASYON	AFFKNNOOR:	FRANKOFON
AEINPRRTZ:	ANTREPRIZ	AFIIKNSTY:	SYANTIFIK
AEINRSSTZ:	REZISTANS	AFIINRTTZ:	TRANZITIF
AEIOnPRSTY:	REPATISYOn	AFIKLLOnSY:	LAFLIKSYOn
AEIOnRSSTY:	RESITASYOn	AFIKMOnOnSY:	KOnFIMASYOn
AEIOPPRWY:	APWOPRIYE	AFINNORSY:	FRANSIYON
AEJMNOPSY:	ANJYOSPEM	AGGILNNOY:	GANGLIYON
AEJNOSSTY:	JESTASYON	AGIIIKLRT:	AGRIKILTI
AEKKLNNOnS:	KLAKSOnNEN	AGIIMOnRSY:	IMIGRASYOn
AEKKNNOSS:	KONSEKANS	AGIINORSY:	IRIGASYON
AEKLMNNOP:	KONPLEMAN	AGIKMOPRT:	KRIPTOGAM
AEKNNNOPR:	KRAPONNEN	AGILNNNOS:	LONGANNIS
AEKNNNORY:	KARYONNEN	AGIMNORSY:	MIGRASYON
AEKNNNOSS:	KONNESANS	AIIIKLMST:	MISKILATI
AEKNNNOSY:	ENKONSYAN	AIIJKMNST:	JIMNASTIK
AEKNNOnSSY:	ENKOnSYANS	AIIKLNRTV:	VANTRIKIL
AEKNNOPRS:	REKONPANS	AIIKLOnSSY:	SIKILASYOn
AEKNNORRT:	RANKONTRE	AIIKMNNOW:	IWONIKMAN
AEKNNORST:	KONSANTRE	AIIKNNPST:	PANNISTIK
AEKNORRTY:	KONTRARYE	AIIKNRSSY:	KRISYANIS
AEKOnOnSSVY:	KOnSEVASYOn	AIILMMNOY:	ALIMINYOM
AEKOOPTVW:	PWOVOKATE	AIILMMOTT:	ILTIMATOM
AELMOPPTW:	MALPWOPTE	AIILMOnSYY:	IMILYASYOn
AELNOPSTY:	POTANSYEL	AIIMNOSTY:	IMITASYON
AEMNNNORZ:	REZONNMAN	AIINOnSSYY:	INISYASYOn
AEMNNOPST:	ESPOTMANN	AIINORSTY:	IRITASYON
AEMNOSTTY:	TANSYOMET	AIIOnSSTYY:	SITIYASYOn
AEnFIINNSY:	EnSINIFYAN	AIIOPSTWZ:	SIPOZITWA
AEnFIINSYY:	EnSIYIFYAN	AIJLOOSTW:	ASTWOLOJI
AEnFIKMNOT:	EnFONMATIK	AIKKNNORS:	KONKIRANS
AEnFIKNRSS:	FRANSISKEn	AIKLMNNOP:	KONPLIMAN
AEnFKNORSY:	EnFRAKSYON	AIKLOnOnPSY:	KOnPILASYOn


Tirages de 9 lettres de AIKLOOnPSY à AnEINNOnPRZ - Page 8/11

AIKLOOnPSY:	KOPILASYOn	AnDEEIMPRR:	REPRIMAnDE
AIKLOOPST:	APOSTOLIK	AnDEEJMNOZ:	DEMAnJEZON
AIKLOOuPST:	POTAKOuLIS	AnDEEORTYZ:	DEZORYAnTE
AIKMNOORZ:	ANKRIMOZO	AnDEEOTTYZ:	DEZAnTOTYE
AIKMOOnPST:	KOMAPISTOn	AnDEFIIKOnT:	AnDEKOnFITI
AIKNOnSSST:	SIKOnSTANS	AnDEIIMSTV:	DIVETISMAn
AIKNOOPSY:	OKIPASYON	AnDEILMMOS:	DEMOLISMAn
AIKOOnSTYZ:	KOTIZASYOn	AnDEKLOOnSY:	KOnDOLEYAnS
AILNOORTZ:	ORIZONTAL	AnDEKNORST:	KONTREDAnS
AILNOOSVY:	OVILASYON	AnDEKOOnPRS:	KORESPOnDAn
AILNOOSYZ:	IZOLASYON	AnDFIIILMS:	DIFISILMAn
AILOOnPPSY:	POPILASYOn	AnEEEIJLVZ:	EVAnJELIZE
AIMMNNOSV:	VONMISMAN	AnEEELMPPR:	REPEPLEMAn
AIMNOOSTW:	ASTWONOMI	AnEEELSSVY:	EVESAnSYEL
AIMOOnSTVY:	MOTIVASYOn	AnEEENPRRT:	AnTREPRENE
AINNOOVWZ:	OZANVIWON	AnEEEPRRTZ:	REPREZAnTE
AJKLNOOPT:	KONPLOTAJ	AnEEEPRSSV:	PESEVERAnS
AJLMNOOnPW:	PWOLOnJMAN	AnEEFIKRST:	FREKAnSITE
AKMNNOOPT:	KONPOTMAN	AnEEFILNSY:	ENFLIYAnSE
AKNNOOSST:	SONTONAKS	AnEEFKNRTY:	FRAnKETYEN
ALNOOSVYY:	VYOLASYON	AnEEFKOnRSY:	KOnFERAnSYE
ALOOPPSTW:	PWOTOPLAS	AnEEGGNNNR:	GAnGRENNEN
AnAnBDINOSY:	AnBAnDISYON	AnEEIIKRST:	AnSEKIRITE
AnAnBEKMNOR:	AnKONBREMAn	AnEEIJLNST:	ENTELIJAnS
AnAnDDEENPS:	ENDEPAnDAnS	AnEEIJRRST:	AnREJISTRE
AnAnEEPRRTZ:	REPREZAnTAn	AnEEILMPST:	SIPLEMAnTE
AnAnEIMPRST:	PRESAnTIMAn	AnEEKKMORT:	KOREKTEMAn
AnAnEKMMOnTT:	MEKOnTAnTMAn	AnEEKKNNOS:	ENKONSEKAn
AnAnIKMNOST:	KONSAnTIMAn	AnEEKLMOnPT:	KOnPLEMAnTE
AnAnIMNOnPRZ:	AnPRIZOnNMAn	AnEEKMMRST:	EKSTREMMAn
AnBDEIJLOZ:	DEZOBLIJAn	AnEEKMNSTY:	SENKAnTYEM
AnBEEFNSYZ:	BYENFEZAnS	AnEEKNNOnVY:	ENKOnVENYAn
AnBEEINRTT:	TEREBAnTIN	AnEEKNNOPT:	ENKONPETAn
AnBEEJJNRT:	JENJAnBRET	AnEEKNNOVY:	ENKONVEYAn
AnBEENSSYY:	BYENSEYAnS	AnEEKNOPRS:	REKONPAnSE
AnBEIJJLOW:	LWIJAnBOJE	AnEEKPRSSY:	EKSPERYAnS
AnBEIKKNSW:	BISKAnKWEN	AnEELMNOuRV:	RENOuVELMAn
AnBEKKNOST:	SENKAnTKOB	AnEEMNNNTV:	VAnTMENNEN
AnBIIKOTTY:	AnTIBYOTIK	AnEEnIMSSTV:	EnVESTISMAn
AnBINOSSVY:	SIBVAnSYON	AnEEnKNNOVY:	EnKONVENYAn
AnChDEEELPY:	DEPLAnChEYE	AnEFIINNSY:	ENSINIFYAn
AnDDEEIMTY:	DEMIYEDTAn	AnEFIINSYY:	ENSIYIFYAn
AnDDEEnEnLPS:	LEnDEPEnDAnS	AnEFIKNRSS:	FRAnSISKEN
AnDDEEnIRSV:	VAnDREDISEn	AnEFIKOnRSS:	SIKOnFERAnS
AnDEEEnFKTZ:	DEZEnFEKTAn	AnEFIKOSYY:	KOYEFISYAn
AnDEEEPRTZ:	DEZAnPETRE	AnEFKMMNOO:	KONFOMEMAn
AnDEEFINRS:	ENDIFERAnS	AnEIIKLRTT:	TRAnKILITE
AnDEEGIMPS:	DEGEPISMAn	AnEIIKLRTZ:	TRAnKILIZE
AnDEEGNRYZ:	ZENGREDYAn	AnEIIKPSTT:	AnTISEPTIK
AnDEEIKMRT:	DIREKTEMAn	AnEINNOnPRZ:	AnPRIZOnNEN


Tirages de 9 lettres de AnEINOPSTY à DEIKNORTT - Page 9/11

AnEINOPSTY:	IPETAnSYON	DDEEENNNS:	SENDENDEN
AnEKNNOSSY:	ENKONSYAnS	DDEEnIILVY:	EnDIVIDYEL
AnEnINNOPRZ:	AnPRIZONNEn	DEEEEnFKTZ:	DEZEnFEKTE
AnENOPRSTY:	PRETAnSYON	DEEEEPRSZ:	DEZESPERE
AnENOPRSVY:	PREVAnSYON	DEEEGGLNO:	DEGENGOLE
AnFIOnRSTYZ:	TRAnSFIZYOn	DEEEGNNNR:	DEGRENNEN
AnFKMNOnOnSY:	FOnKSYOnNMAn	DEEEIKLMR:	LEMEKREDI
AnIIKNOSTT:	AnTITOKSIN	DEEEKKNOnT:	DEKOnNEKTE
AnIKNOSSST:	SIKONSTAnS	DEEEKMNNR:	DEKRENMEN
AnJLMNOOPW:	PWOLONJMAn	DEEEKNNNW:	DEKWENNEN
ANOuOuTTTYY:	ANTYOuTYOuT	DEEEnFIILT:	EnFIDELITE
BBDEEINNO:	DEBOBINEN	DEEEnGGLOR:	DEGREnGOLE
BBEFLNNOO:	BONBONFLE	DEEEnNNORZ:	DEREZONNEn
BBENNNOOY:	BONBONYEN	DEEENNOnRZ:	DEREZOnNEN
BDEEEILRS:	SELEBRIDE	DEEEORRTY:	DETERYORE
BDEEIIKLZ:	DEZEKILIB	DEEFNNNOR:	FREDONNEN
BDEEILNNOu:	DEBOuLINEN	DEEGLNNOZ:	ZENGLENDO
BDEEnEnGLNgV:	VLEnGBEnDENg	DEEIIJNNS:	ENDIJENIS
BDEEnNNOOuT:	DEBOuTONNEn	DEEIJNOnSY:	ENDIJESYOn
BDEENNOnOuT:	DEBOuTOnNEN	DEEIKMOST:	DOMESTIKE
BDEIIRSTY:	DISTRIBYE	DEEIKNORS:	KONSIDERE
BDEIJLNNO:	BIDJONNEL	DEEIMNOSY:	DEMISYONE
BDEKLOOOS:	DEKOLBOSO	DEEIMNSVY:	DISNEVYEM
BDEnEnEnGGLV:	VLEnGBEnDEnG	DEEINOnSYZ:	ENDESIZYOn
BEEEENRTV:	ENVETEBRE	DEEINOPSZ:	ENDISPOZE
BEEEFINSY:	BENEFISYE	DEEIOnPSSY:	ESPEDISYOn
BEEELMORS:	SEREBELOM	DEEKLOOnTW:	DEKOnTWOLE
BEEELNNVY:	BYENNELVE	DEEKMNNOY:	KONMEDYEN
BEEEnIILST:	EnBESILITE	DEEKNOOPZ:	DEKONPOZE
BEEIJLOST:	SETOBLIJE	DEEMNOOTW:	DETEWONOM
BEEIKLNRV:	VILBREKEN	DEEnIIKSST:	EnSEKTISID
BEEILNRYZ:	BREZILYEN	DEEnIJNOSY:	EnDIJESYON
BEEnGILOuVY:	BOuGEnVILYE	DEEnINOSYZ:	EnDESIZYON
BEGILMNOO:	EMOGLOBIN	DEEnLNOOnPT:	DEPLOTOnNEn
BEIIILPST:	PIBLISITE	DEENOPRSY:	DEPRESYON
BEIIILTVZ:	VIZIBLITE	DEENOPSSY:	DESEPSYON
BEIIKLOTZ:	TIBEKILOZ	DEFIIIKLT:	DIFIKILTE
BEIIKOnSYZ:	EKZIBISYOn	DEFIINOnSY:	DEFINISYOn
BEIKNNOOnZ:	KONBINEZOn	DEGNNNOOuW:	GOuDWONNEN
	KOnBINEZON	DEIIILNPS:	DISIPLINE
BEIKNORST:	ESKONBRIT	DEIIIRSSV:	RESIDIVIS
BEKLNNOOY:	KOLONBYEN	DEIIKKMOR:	KOMKIDIRE
BIIJLOOSY:	BIYOLOJIS	DEIIKKNOR:	KONKIDIRE
ChDEEEIPYZ:	DEChEPIYEZ	DEIIKMNNO:	DOMINIKEN
ChDEEFINNOn:	DEChIFOnNEN	DEIIKMORZ:	MIZERIKOD
ChDEEIMNUiZ:	ChEMIZDENUi	DEIIKRRST:	DIREKTRIS
ChDEEIOPRT:	DEPOTChIRE	DEIILOPSY:	ELIPSOYID
ChDEEnFINNO:	DEChIFONNEn	DEIKNNOSY:	DIKSYONNE
ChDEKNNNOO:	KOChONDENN	DEIKNORSY:	DIREKSYON
DDEEEGNOV:	DEVEGONDE	DEIKNORTT:	TIREDKONT


Tirages de 9 lettres de DEIKOnPRSY à EIIILMSST - Page 10/11

DEIKOnPRSY:	PREDIKSYOn	EEILOPSTY:	POLIYESTE
DEILMOOnSY:	DEMOLISYOn	EEIMORTTY:	METEYORIT
DEIOOnPSYZ:	DEPOZISYOn	EEINOPVWZ:	ENPWOVIZE
DEKLNNOTUi:	LENKONDUiT	EEINPRSST:	SENTESPRI
DEnIIILNPS:	DISIPLINEn	EEIOnPRSTY:	REPETISYOn
	EnDISIPLIN	EEIOPPRST:	POSPERITE
DEnIKOnSSTY:	DISTEnKSYOn	EEIORTVWZ:	RETWOVIZE
DENNOOSTW:	WONDONSTE	EEKKNNOnSY:	KEKSYOnNEN
DFIIKOPTW:	PWODIKTIF	EEKKOnRSSY:	EKSKRESYOn
DGMOOOOSW:	GWOSOMODO	EEKLNNOPT:	ENKONPLET
DIIIMNOnSY:	DIMINISYOn	EEKMNORTT:	KONTREMET
DIIKMOOnRT:	MITOKOnDRI	EEKNNNOSY:	KESYONNEN
DIIKNOSSY:	DISKISYON	EEKNOnPSSY:	ENSPEKSYOn
DIKNNOOSY:	KONDISYON	EEKNOPSSY:	EKSEPSYON
DIKOOnPSWY:	PWODIKSYOn	EEKNORSSY:	ESKRESYON
DMNNNOOOW:	WONDONMON	EELNOnPRSY:	LENPRESYOn
EEEGINSTV:	ENVESTIGE	EEMNNNOnPW:	PWOnMENNEN
EEEGLNPTZ:	ZEPENGLET	EEMNNNOPW:	PWOMENNEN
EEEIKMNST:	EKSTEMINE	EEnFOOSTTZ:	FOTOSEnTEZ
EEEIMNNST:	ESTEMINEN	EEnIIKMNNR:	EnKRIMINEN
EEEINSSTV:	ENVESTISE		ENKRIMINEn
EEEKKNNSW:	KESEKWENN	EEnIINRSTT:	SEnTRINITE
EEEnIIKRST:	EnSEKIRITE	EEnKKNNOSY:	KEKSYONNEn
EEEnIKMNST:	EKSTEMINEn	EEnKNOPSSY:	EnSPEKSYON
EEEnJKOnSTY:	EnTEJEKSYOn	EEnLNOPRSY:	LEnPRESYON
EEEnKOnSSTY:	EnTESEKSYOn	EEnMNNNOPW:	PWONMEnNEN
EEENNNNPP:	PENPENNEN		PWONMENNEn
EEFIIKPSS:	ESPESIFIK	EENNOPRSY:	ENPRESYON
EEFILNPSY:	SENPLIFYE	EENOPRSSY:	ESPRESYON
EEFIOPTWZ:	PWOFETIZE		RESEPSYON
EEFKLOnRSY:	REFLEKSYOn	EFFIIINNT:	ENFINITIF
EEFKNNOSY:	ENFEKSYON	EFGINNNOR:	GRIFONNEN
EEFKNOPSY:	PEFEKSYON	EFIIIMNOT:	INIFOMITE
EEFOOTTWW:	ETEWOTWOF	EFIIKKOnST:	KOnSEKITIF
EEIIINSTV:	INIVESITE	EFIILORYZ:	FLIYORIZE
EEIILMNPR:	PRELIMINE	EFIJKNOOT:	FOTOJENIK
EEIIPPRST:	PRESIPITE	EFINNNORS:	FRISONNEN
EEIJMORTW:	JEWOMETRI	EFKNNOOSY:	FONKSYONE
EEIJMORTY:	JEYOMETRI		KONFESYON
EEIJPRSTY:	PRESTIJYE	EFKNNOOTW:	KONFWONTE
EEIKKMOTZ:	EKZOTEMIK	EFNOOPSWY:	PWOFESYON
EEIKLMOPS:	ESPEKILOM	EGIJKLNOO:	JINEKOLOG
EEIKLOnRSY:	REKOnSILYE	EGIKLNSTUi:	LENGUiSTIK
EEIKMNOOZ:	EKONOMIZE	EGINNNORZ:	GRIZONNEN
EEIKMOSST:	EKOSISTEM	EGIOPRSSW:	PWOGRESIS
EEIKMRSST:	EKSTREMIS	EGMMNNNOO:	MONGONMEN
EEIKNRSTT:	ENSTRIKTE	EGOOnPRSWY:	PWOGRESYOn
EEIKOnPSSY:	PESEKISYOn	EIIIKLPST:	PISIKILTE
EEIKPPSTV:	PESPEKTIV	EIIILLNPS:	PELISILIN
EEILOnSTVY:	TELEVISYOn	EIIILMSST:	ESTIMILIS


Tirages de 9 lettres de EIIILNNPS à NOOOPPSWY - Page 11/11

EIIILNNPS:	PENISILIN	IINNORSTY:	NITRISYON
EIIJLNSST:	LENJISTIS	IIOOnPSSYZ:	SIPOZISYOn
EIIKNOnSYZ:	ENKIZISYOn	IJLOOOSWZ:	ZOWOLOJIS
EIIKNWYZZ:	KWIZINYEZ	IKKLNOOnYZ:	KOnKLIZYON
EIIOPRRTY:	PRIYORITE		KONKLIZYOn
EIJKLNOOT:	TEKNOLOJI	IKKMOOPSW:	MIKWOSKOP
EIJMMNOPS:	JIMNOSPEM	IKMNNNOOY:	KONMINYON
EIKLMOOTT:	MOTOKILTE	IKNOOPSTW:	PWONOSTIK
EIKLNOOSY:	ELOKISYON	IKOOnOnPSYZ:	KOnPOZISYOn
EIKLOOPPY:	POLIKOPYE	INOOOPSYZ:	OPOZISYON
EIKMNOnOnSY:	KOnMISYOnNE	INOOPVWYZ:	PWOVIZYON
EIKMNOOnSY:	KOMISYOnNE	JKKNOOnOnSY:	KOnJOnKSYON
EIKMNOOSY:	KOMISYONE		KONJOnKSYOn
EIKOnOnPSTY:	KOnPETISYOn		KOnJONKSYOn
EILMNOuPWZ:	PLIZOuMWEN	KLMOOORST:	KOLOSTROM
EILNOOSVY:	EVOLISYON	KMMNNNOOO:	MONKONMON
EILOOnRSVY:	REVOLISYOn	MNOOOPSWY:	PWOMOSYON
EINOPRVYZ:	PREVIZYON	NOOOPPSWY:	PWOPOSYON
EINOPSTTW:	TWONPETIS		
EJKOOnPSWY:	PWOJEKSYOn		
EKKNNNOOT:	KONKONNET		
EKKNNOOSY:	KONEKSYON		
EKLOOnPSYZ:	EKSPLOZYOn		
EKMNNNOOS:	KONSONMEN		
EKNNOOPRS:	KORESPONN		
EKNOOnPSSY:	KOnSEPSYON		
	KONSEPSYOn		
EKNOOPRSY:	PREKOSYON		
EKOOnOuRTTT:	TOuTOKOnTRE		
EKOOnPSTWY:	PWOTEKSYOn		
ELLNOOSVY:	VYOLONSEL		
ELNNNOOPT:	PLOTONNEN		
EnFIKNOnRSY:	FRIKSYOnNEn		
EnIIKNOSYZ:	EnKIZISYON		
EnIILOPSTY:	POLITISYEn		
EnIIOnSSTTY:	EnSTITISYOn		
EnIKOnPRSSY:	EnSKRIPSYOn		
EnIKOnRSSTY:	EnSTRIKSYOn		
ENNNNOOWW:	WONWONNEN		
EnNNNOOYZZ:	ZONZONNYEn		
ENNNOOnYZZ:	ZOnZONNYEN		
	ZONZOnNYEN		
ENOOPSSWY:	PWOSESYON		
EOOOPTWWZ:	PWOTOZOWE		
FIIJLOOYZ:	FIZYOLOJI		
FIKNNOOYZ:	KONFIZYON		
GGNNNOOOP:	PONGONGON		
IIIIKLPST:	PISIKILTI		
IIJLNOOOT:	ONITOLOJI		
IIKOnOnSSYZ:	SIKOnSIZYOn		


