Tirages de 10 jetons de AAAABMNNRS à AADILMNOPS - Page 1/7

AAAABMNNRS:	ANBARASMAN	AAAnFLMNOSY:	AnFLAMASYON
AAAADNNNNT:	ANNATANDAN	AAAnILMOnSTY:	ALIMAnTASYOn
AAAAKKLMMN:	ANMALMAKAK	AAAnMNNOPWZ:	ANPWAZONMAn
AAAAnDFLMNN:	AnMALDANFAN		AnPWAZONMAN
	ANMALDANFAn	AAANNPRRST:	TRANSPARAN
	ANMALDAnFAN	AABBENRRYZ:	ZARYENBRAB
AAAAnIMRSTY:	SAnTAMARIYA	AABChEHKNOZ:	ChEHKOBANZA
AAABDELNOnW:	ALAWOnNBADE	AABDEEGRYZ:	DEZAGREYAB
AAABDINRSS:	ANBASADRIS	AABDINNOnSY:	ANBANDISYOn
AAABDKNOVY:	VAKABONDAY	AABEEFILTZ:	ALFABETIZE
AAABDLLNRT:	LATRANBLAD	AABEEnJLNRY:	JANRABELYEn
AAABEKLORY:	BAKALOREYA	AABEGNNOSY:	ABNEGASYON
AAABFLNNWY:	FLANBWAYAN	AABEILMNNS:	ANBELISMAN
AAABIKMNOT:	KOTIBANAMA	AABEILMNTY:	ABITYELMAN
AAABINNTTV:	ANBATIVANT	AABEILMRTV:	LAMVERITAB
AAADDIMNNR:	NADMARINAD	AABEINSSTY:	ABSANTEYIS
AAADEJLMMN:	DEMAJANMAL	AABEJJNNRT:	JANJANBRET
AAADEJNTVZ:	DEZAVANTAJ	AABEKLNNST:	SALTENBANK
AAADEKLSSZ:	DELASKAZAS	AABEKMNNOnR:	ANKOnBREMAN
AAADEKMNNR:	ANKADREMAN	AABIMNOOnSY:	ABOMINASYOn
AAADEPRVWZ:	DAPREZAVWA	AAChDEKLMNN:	DEKLANChMAN
AAADFLMNOnT:	FOnDAMANTAL	AAChEFINRRS:	RAFREChISAN
AAADNNNPST:	PANDANSTAN	AADDEENNNP:	ENDEPANDAN
AAADNOPSTY:	ADAPTASYON	AADDEEnNNPS:	EnDEPANDANS
AAAEFLRWYZ:	RAFAYELWAZ	AADDEGOnRSY:	DEGRADASYOn
AAAEGMNNPT:	PEMANGANAT	AADDEJMMNO:	DEDOMAJMAN
AAAEMNNNPS:	ANPEMANANS	AADDEMNOOY:	ANDODOMEYA
AAAEMNNPRT:	TANPERAMAN	AADDMMNNYY:	DYANMDYANM
AAAEPPRRTW:	PREPARATWA	AADEEEnFFLN:	ALAFEnDEFEN
AAAFILNNTT:	NATIFNATAL		ALAFENDEFEn
AAAFINNTYY:	ANFANTIYAY	AADEEGGNNN:	DEGAGANNEN
AAAFLMNOnSY:	ANFLAMASYOn	AADEEGMNRZ:	DEZAGREMAN
AAAFLNOSWZ:	ANSAFOLWAZ	AADEEKLNSZ:	ESKANDALEZ
AAAGIKLMRT:	GRAMATIKAL	AADEEKNNSS:	AKDENESANS
AAAIMNNSVY:	ANVAYISMAN	AADEENPSTY:	DEPASYANTE
AAAINPRSTY:	APRANTISAY	AADEIKKLNR:	KALANDERIK
AAAJKMNNOuR:	ANKOuRAJMAN	AADEIKLNRY:	KALANDRIYE
AAAKKLORWZ:	KARAKOLWAZ	AADEIKLRTW:	KWADRILATE
AAAKLMNOSY:	AKLAMASYON	AADEIKLSWY:	SIYDELAKWA
AAAMNNOnPWZ:	ANPWAZOnMAN	AADEILPPRT:	PLATDEPARI
AAAnBELMNRS:	RASANBLEMAn	AADEIMNNRS:	DERASINMAN
	RASAnBLEMAN	AADEIMNSYY:	MAYISADYEN
AAAnDEEJTVZ:	DEZAVAnTAJE	AADEKLOnRSY:	DEKLARASYOn
AAAnDELMPTT:	DEPATMAnTAL	AADELMNNNN:	NANLANDMEN
AAAnDENNTTZ:	DETAnZANTAN	AADEnLORSVY:	SALVADORYEn
	DETANZAnTAN	AADEOnSSTVY:	DEVASTASYOn
	DETANZANTAn	AADFGIORRY:	RADYOGRAFI
AAAnDFLMNOT:	FONDAMAnTAL	AADFIMNOSY:	DIFAMASYON
AAAnDGIMNRS:	AGRANDISMAn	AADGIMNNOuS:	ANGOuDISMAN
	AGRAnDISMAN	AADILMNOPS:	APLODISMAN


Tirages de 10 jetons de AADILNOSTY à AAnEOnPRSTYZ - Page 2/7

AADILNOSTY:	DILATASYON	AAIIJMNOnSY:	IMAJINASYOn
AADIMNNOSW:	AWONDISMAN	AAIIKKMRST:	KARISMATIK
AADIMNORSY:	ADMIRASYON	AAIILMOPST:	IPOTALAMIS
AADINNSSSW:	SWASANNDIS	AAIILNOnSSY:	ALISINASYOn
AADINORSYY:	RADIYASYON	AAIKLMNOnPS:	AKOnPLISMAN
AADKNNOOnSY:	KONDANASYOn	AAIKLNOPSY:	APLIKASYON
	KOnDANASYON	AAIKMNNOnST:	KOnSANTIMAN
AAEEEKLRST:	AKSELERATE	AAIKMNNOPT:	KONPATIMAN
AAEEGNPRWY:	PARAGWEYEN	AAIKMOSTWZ:	TOMASIKWAZ
AAEEIKLLRT:	EKILATERAL	AAIKNOnSSVY:	VAKSINASYOn
AAEEIKNPST:	ENKAPASITE	AAIKORRSTT:	ARISTOKRAT
AAEEJLMNNR:	JENERALMAN	AAILNNOSSY:	NASYONALIS
AAEEMNNTWZ:	WANAMENTEZ	AAILOnPPSTY:	PALPITASYOn
AAEEnGOTTWW:	EnTEWOGATWA	AAINNOPSTY:	ANPITASYON
AAEENNSSVY:	SAVANESYEN	AAINOPRSSY:	ASPIRASYON
AAEENPRTTZ:	PREZANTATE	AAIOOnSSSYY:	ASOSIYASYOn
AAEFLMNOnSY:	ENFLAMASYOn	AAKMNNNOST:	KONSANTMAN
AAEFMNOnSTY:	FEMANTASYOn	AAKMNNNOTT:	KONTANTMAN
AAEFNOnSTTY:	FETATANSYOn	AAKNOnRSTYZ:	TRANZAKSYOn
AAEGLMNOTV:	GALVANOMET	AALNNOPSTY:	PLANTASYON
AAEIILMNTW:	ELIMINATWA	AAMNOORSTY:	SANATORYOM
AAEILMNNRT:	NATIRELMAN	AAnBDINNOSY:	AnBANDISYON
AAEILOnSVYY:	EVALIYASYOn		ANBAnDISYON
AAEINNNPST:	ANPENITANS	AAnBEEJLNRY:	JAnRABELYEN
AAEIOPRTVZ:	VAPORIZATE	AAnBEEnKKOuRY:	BOuKAnKAREYEn
AAEKLMOnRSY:	REKLAMASYOn	AAnBEILMRST:	RETABLISMAn
AAEKLNORSY:	EKLARASYON	AAnBEKMNNOR:	AnKONBREMAN
AAEKNNNOSY:	ENKANASYON		ANKONBREMAn
AAEKNNPSTW:	PWASENKANT	AAnChEFIMRRS:	RAFREChISMAn
AAELMOnSSVY:	MALVESASYOn	AAnChKMNOOuTW:	KAWOTChOuMAnN
AAELNOnSSTY:	ENSTALASYOn	AAnDDEENNPS:	ENDEPANDAnS
AAELNRSSTV:	TRANSVESAL		ENDEPAnDANS
AAELOPRTWY:	PWOLETARYA	AAnDEFIMRSW:	REFWADISMAn
AAEMNSSTWY:	SWASANTYEM	AAnDEILLRSV:	LADELIVRAnS
AAEnFLMNOSY:	EnFLAMASYON	AAnEELMPSSY:	ESPESYALMAn
AAEnLNOSSTY:	EnSTALASYON	AAnEENPRRTZ:	REPREZAnTAN
AAEnNNNOPWZ:	ANPWAZONNEn		REPREZANTAn
AAENNNOnPWZ:	ANPWAZOnNEN	AAnEFKOnRSTY:	FREKAnTASYOn
AAENNNPRRT:	ANTREPRANN	AAnEFMNOSTY:	FEMAnTASYON
AAENOPRRSY:	REPARASYON	AAnEFMORSTT:	TRAnSFOMATE
AAENOPRSSY:	SEPARASYON	AAnEFNOSTTY:	FETATAnSYON
AAENORSSTY:	ARESTASYON	AAnEIKKLLSW:	KELKILAnSWA
AAENPRSVWY:	PREVWAYANS	AAnEIMNPRST:	PRESANTIMAn
AAEOnPPRRSY:	PREPARASYOn		PRESAnTIMAN
AAEOOnPRSVY:	EVAPORASYOn	AAnEIMOnPSSY:	EMAnSIPASYOn
AAFIIKMNPS:	PASIFIKMAN	AAnEKMMNOnTT:	MEKOnTANTMAn
AAFILNOSYY:	AFILYASYON		MEKOnTAnTMAN
AAFNOOnPSWY:	PWOFANASYOn	AAnEnILMPPRS:	PREnSIPALMAn
AAGINNOSVY:	NAVIGASYON	AAnENNNOPWZ:	AnPWAZONNEN
AAGOOnPPSWY:	PWOPAGASYOn	AAnEOnPRSTYZ:	PREZAnTASYOn


Tirages de 10 jetons de AAnIKLMNOPS à ADEINOnSSTY - Page 3/7

AAnIKLMNOPS:	AKONPLISMAn	ADDEEGNOVY:	DEVEGONDAY
AAnIKMMOOTT:	OTOMATIKMAn	ADDEEIMNTY:	DEMIYEDTAN
AAnIKMNNOST:	KONSAnTIMAN	ADDEEnEnLNPS:	LEnDEPEnDANS
	KONSANTIMAn	ADDEEnGIKNN:	KINDEGADEnN
AAnIMNNOnPRZ:	ANPRIZOnNMAn	ADDEEnINRSV:	VANDREDISEn
	AnPRIZOnNMAN	ADEEEFIKNY:	DEKAFEYINE
AAnIMOPVWWZ:	PWOVIZWAMAn	ADEEEMNNRY:	AMERENDYEN
AAnKNORSTYZ:	TRAnZAKSYON	ADEEEnFKNTZ:	DEZEnFEKTAN
AAnKOnOnRSSTY:	KOnSAnTRASYOn	ADEEENPRTZ:	DEZANPETRE
AAnKOnOnRSTVY:	KOnTRAVAnSYOn	ADEEFINNRS:	ENDIFERANS
AANNNOuOuPSS:	SOuSOuPANNAN	ADEEGIMNPS:	DEGEPISMAN
AAnNOORSTYY:	ORYAnTASYON	ADEEGLNOSY:	DELEGASYON
AANOOnRSTYY:	ORYANTASYOn	ADEEGNNRYZ:	ZENGREDYAN
ABBEEELNNY:	BALENBEYEN	ADEEIKKLLY:	DEKILAKYEL
ABBEEEnLNSY:	BASEnBLEYEN	ADEEIKMNRT:	DIREKTEMAN
	BASENBLEYEn	ADEEIKMOuTZ:	DEMAKOuTIZE
ABDEEEHNWZ:	BEDEHENWAZ	ADEEIKPRTZ:	PREDIKATEZ
ABDEEELNNS:	ABSEDELENN	ADEEILMORZ:	DEMORALIZE
ABDEEJLNOS:	ENSELBADJO	ADEEILNNSY:	DESALINYEN
ABDEEnINPSS:	EnDISPENSAB	ADEEIMNNOT:	DENOMINATE
	ENDISPEnSAB	ADEEIMNPRR:	REPRIMANDE
ABDEIJLNOZ:	DEZOBLIJAN	ADEEJMNNOZ:	DEMANJEZON
ABDEIJNNNO:	BADIJONNEN	ADEEnGLOuPWY:	GWADLOuPEYEn
ABEEFNNSYZ:	BYENFEZANS	ADEEnIJMNSW:	JASMEnDENWI
ABEEIILSTZ:	ESTABILIZE	ADEEnIKRSTV:	KATREVEnDIS
ABEEINNRTT:	TEREBANTIN	ADEENORTYZ:	DEZORYANTE
ABEEJJNNRT:	JENJANBRET	ADEENOTTYZ:	DEZANTOTYE
ABEEJORSTT:	ESTRABOJET	ADEFIIKLSY:	DISKALIFYE
ABEENNSSYY:	BYENSEYANS	ADEFIIKNOnT:	ANDEKOnFITI
ABEIJJLNOW:	LWIJANBOJE	ADEFKNOOnSY:	FEKONDASYOn
ABEIKKNNSW:	BISKANKWEN		FEKOnDASYON
ABEINOPRSS:	IRESPONSAB	ADEFMNOOSY:	DEFOMASYON
ABEKKNNOST:	SENKANTKOB	ADEFNOOuPVW:	FONDEPOuVWA
ABEKLNNOOS:	ENKONSOLAB	ADEGIIKTTZ:	EGZAKTITID
ABENOOSSVY:	OBSEVASYON	ADEGIINRTT:	ENGRATITID
ABGIINOSWZ:	AGWOBIZNIS	ADEIILRSVY:	DIVALYERIS
ABGILNOOSY:	OBLIGASYON	ADEIIMNRST:	ADMINISTRE
ABIIKKNNOY:	KONKIBINAY	ADEIIMNSTV:	DIVETISMAN
ABIIKLOnPSY:	PIBLIKASYOn	ADEIINNPST:	APENNDISIT
ABIIKNOTTY:	ANTIBYOTIK	ADEIJLMOOT:	DEMATOLOJI
ABIILOnRSTY:	TRIBILASYOn	ADEIKKMORT:	DEMOKRATIK
ABILNOOSSY:	ABSOLISYON	ADEIKLMOnSY:	MALEDIKSYOn
ABINNOSSVY:	SIBVANSYON	ADEIKLNOSY:	LEDIKASYON
AChDEEELNPY:	DEPLANChEYE	ADEIKNNOPZ:	KANPINODEZ
AChDEIMNNNO:	MADIChONNEN	ADEIKNNOSY:	ENDIKASYON
AChEEILMNSW:	SENMIChELWA	ADEIKNOOSY:	AKODEYONIS
AChEEnILMSWZ:	SEnMIChELWAZ	ADEILMMNOS:	DEMOLISMAN
AChELMNNOSY:	ChANSOLMYEN	ADEILMNNOY:	LIMONADYEN
AChGIKNNOuOuY:	ChIKOuNGOuNYA	ADEINNOSYY:	ENDIYASYON
AChLLLOuOuOuTT:	LATChOuLOuLOuT	ADEINOnSSTY:	DESTINASYOn


Tirages de 10 jetons de ADEINOSSTY à AEIILLMORT - Page 4/7

ADEINOSSTY:	DISETASYON	AEEJKOPTVY:	JAKOPYEVET
ADEKLNOOnSY:	KOnDOLEYANS	AEEJNNORSY:	JENERASYON
ADEKNNORST:	KONTREDANS	AEEKKMNORT:	KOREKTEMAN
ADEKNOOnPRS:	KORESPOnDAN	AEEKKNNNOS:	ENKONSEKAN
ADEKNOORSY:	DEKORASYON	AEEKLMNNOT:	MALONNEKTE
ADELNOOSYZ:	DEZOLASYON	AEEKLMNOnPT:	KOnPLEMANTE
ADEMNOORSY:	MODERASYON	AEEKLNORSY:	EKLERASYON
ADENNOOSTY:	DETONASYON	AEEKMMNRST:	EKSTREMMAN
ADENOOPSTY:	DEPOTASYON	AEEKMNNSTY:	SENKANTYEM
ADFFINOOWZ:	FODOFINWAZ	AEEKNNNOnVY:	ENKOnVENYAN
ADFIIILMNS:	DIFISILMAN	AEEKNNNOPT:	ENKONPETAN
ADFIKNORSY:	DIFRAKSYON	AEEKNNNOVY:	ENKONVEYAN
ADGIKNOSTY:	DYAGNOSTIK	AEEKNNOPRS:	REKONPANSE
ADIIKLMOPT:	DIPLOMATIK	AEEKNORTTY:	KONTRAYETE
ADIILOnSSTY:	DISTILASYOn	AEEKNORTWY:	EKWATORYEN
ADIIOnPRSSY:	DISPARISYOn	AEEKNPRSSY:	EKSPERYANS
ADIKNNOOSY:	AKONDISYON	AEEKOnRRSYY:	REKREYASYOn
ADIKNOOSSY:	OKSIDASYON	AEEKOnRRTTY:	KOnTRARYETE
ADIKOnRSSTY:	DISTRAKSYOn	AEELMNNOTT:	MALONNETTE
ADIMNNOOSY:	DOMINASYON	AEELMNNOuRV:	RENOuVELMAN
ADINNNOOSY:	INONDASYON	AEELNNNORZ:	LAREZONNEN
AEEEIJLNRZ:	JENERALIZE	AEEMNNNNTV:	VANTMENNEN
AEEEIJLNVZ:	EVANJELIZE	AEEMNNTVYY:	VYETNAMYEN
AEEEIKLPST:	ESPEKILATE	AEEnGIPTVWY:	PETIGWAVYEn
AEEEILLMTZ:	LEZEMILATE	AEEnIMNSSTV:	EnVESTISMAN
AEEEINNRST:	ENSINERATE	AEEnKNNNOVY:	EnKONVENYAN
AEEELMNPPR:	REPEPLEMAN	AEEOnPRSVYZ:	PREZEVASYOn
AEEELNSSVY:	EVESANSYEL	AEFIINNNSY:	ENSINIFYAN
AEEENNPRRT:	ANTREPRENE	AEFIINNSYY:	ENSIYIFYAN
AEEENPRRTZ:	REPREZANTE	AEFIKMNNOT:	ENFONMATIK
AEEENPRSSV:	PESEVERANS	AEFIKNNRSS:	FRANSISKEN
AEEFIKNRST:	FREKANSITE	AEFIKNOnRSS:	SIKOnFERANS
AEEFILNNSY:	ENFLIYANSE	AEFIKNOSYY:	KOYEFISYAN
AEEFIMNOTZ:	ENFOMATIZE	AEFKMMNNOO:	KONFOMEMAN
AEEFIPRTVZ:	PREZEVATIF	AEFKNNORSY:	ENFRAKSYON
AEEFKNNRTY:	FRANKETYEN	AEFKNORRSY:	REFRAKSYON
AEEFKNOnRSY:	KOnFERANSYE	AEFMNNOOSY:	ENFOMASYON
AEEGGNNNNR:	GANGRENNEN	AEGGIKNOnRS:	KOnGREGANIS
AEEGIIRSTV:	AGRESIVITE	AEGGKOnOnRSY:	KOnGREGASYOn
AEEGINOSTY:	NEGOSIYATE	AEGINNOVYY:	GONAYIVYEN
AEEIIKNRST:	ANSEKIRITE	AEGKNORSWY:	GWARYONEKS
AEEIJJLNOY:	JENEYALOJI	AEGMNNOOTZ:	MONTOGANEZ
AEEIJLNNST:	ENTELIJANS	AEGMNOOPTY:	POMAGOTYEN
AEEIJNRRST:	ANREJISTRE	AEIIKLNRTT:	TRANKILITE
	JENERATRIS	AEIIKLNRTZ:	TRANKILIZE
AEEIKMNNSY:	MEKANISYEN	AEIIKLRSTZ:	KRISTALIZE
AEEILMNPST:	SIPLEMANTE	AEIIKMSSTT:	SISTEMATIK
AEEILNNSTT:	ENTESTINAL	AEIIKNPSTT:	ANTISEPTIK
AEEILNOPST:	PESONALITE	AEIIKSSTTT:	ESTATISTIK
AEEILNPRSY:	ENPERYALIS	AEIILLMORT:	LIMORALITE


Tirages de 10 jetons de AEIILMNOnSY à AnEINNNOPRZ - Page 5/7

AEIILMNOnSY:	ELIMINASYOn	AIKLNOOnPSY:	KONPILASYOn
AEIILNSSTW:	ENSISWATIL		KOnPILASYON
AEIILOPPRT:	POPILARITE	AIKLNOOPSY:	KOPILASYON
AEIJKLNNOT:	KONJENITAL	AIKLOnOnSSTY:	KOnSILTASYOn
AEIJMNNOSY:	JEMINASYON	AIKMNOOPST:	KOMAPISTON
AEIKKNORST:	KOSTARIKEN	AIKNNOSSST:	SIKONSTANS
AEIKNOSSTY:	EKSITASYON	AIKNOOSTYZ:	KOTIZASYON
AEIKOnPRSSY:	EKSPIRASYOn	AIKOnOnPSSTY:	KOnSTIPASYOn
AEILNOPSVW:	ALENPWOVIS	AILNOOPPSY:	POPILASYON
AEILOnPTVWY:	PETYOnVILWA	AIMNOOSTVY:	MOTIVASYON
AEIMNOSSTY:	ESTIMASYON	AIOOOnRSTYZ:	OTORIZASYOn
AEINNNOnPRZ:	ANPRIZOnNEN	AJLMNNOOPW:	PWOLONJMAN
AEINNOPSTY:	IPETANSYON	AKOnOuRSSSTY:	SOuSTRAKSYOn
AEINNOSTVY:	ENVITASYON	AKOOOnPSVWY:	PWOVOKASYOn
AEINOPRSTY:	REPATISYON	AnAnEKMMNOTT:	MEKONTAnTMAn
AEINORSSTY:	RESITASYON	AnAnIMNNOPRZ:	AnPRIZONNMAn
AEIOnPRRSSY:	RESPIRASYOn	AnBDEEIILMT:	DEMAnTIBILE
AEKKLNNNOS:	KLAKSONNEN	AnBDEEIOSYZ:	DEZOBEYISAn
AEKLOnOnSSTY:	KOnSTELASYOn	AnBEIIILSST:	SAnSIBILITE
AEKNNNOSSY:	ENKONSYANS	AnBEINOSSVY:	SIBVAnSYONE
AEKNOOnSSVY:	KONSEVASYOn	AnBIIJLOORY:	AnBRIYOLOJI
	KOnSEVASYON	AnDDEEELSTY:	DESAnTDELYE
AEKOnOnRRTYZ:	KOnTRARYEZOn	AnDDEEEnEnPST:	EnTEDEPEnDAnS
AEnFFIIILNT:	ALEnFINITIF	AnDDEEEnLNPS:	LEnDEPENDAnS
AEnFIIKRSTT:	EnFRASTIKTI		LENDEPEnDAnS
AEnFILOnRSTY:	EnFILTRASYOn	AnDDEEINRSV:	VAnDREDISEN
AEnIIKLMMSY:	MAKSIMILYEn	AnDEEEFKNTZ:	DEZENFEKTAn
AEnINNNOPRZ:	ANPRIZONNEn	AnDEEEFPRRS:	DEPREFERAnS
AENNOORSVY:	RENOVASYON	AnDEEEKPRST:	DERESPEKTAn
AENNOPRSTY:	PRETANSYON	AnDEEEnIKMRT:	EnDIREKTEMAn
AENNOPRSVY:	PREVANSYON	AnDEEFILRSY:	DIFERAnSYEL
AEOOnRRSSTY:	RESTORASYOn	AnDEEIIKLPP:	PEPAnDIKILE
AFIKLLNOSY:	LAFLIKSYON	AnDEFFIIINT:	AnDEFINITIF
AFIKMNOOnSY:	KOnFIMASYON	AnDEFIIKNOT:	AnDEKONFITI
	KONFIMASYOn	AnDEFIKLOnSY:	KOnFIDAnSYEL
AFINOnRSTYZ:	TRANSFIZYOn	AnDEIIKLOPS:	AnSIKLOPEDI
AFIOnRRSSTY:	FRISTRASYOn	AnDEIILLPPZ:	DEPLIZAnPLI
AFKMNNOnOnSY:	FOnKSYOnNMAN	AnDEKLNOOSY:	KONDOLEYAnS
AGIIIKLLRT:	LAGRIKILTI	AnDEKNOOPRS:	KORESPONDAn
AGIIMNORSY:	IMIGRASYON	AnDEKOOnPRSS:	KORESPOnDAnS
AGIINOOnRSY:	INOGIRASYOn	AnEEEIMPRST:	ESPERIMAnTE
AIIILOnSTYZ:	ITILIZASYOn	AnEEFKMOnPSY:	PEFEKSYOnMAn
AIIKLNOSSY:	SIKILASYON	AnEEFKNORSY:	KONFERAnSYE
AIIKNNOSTT:	ANTITOKSIN	AnEEIMNSSTV:	ENVESTISMAn
AIIKOPRTTY:	PATRIYOTIK	AnEEKLMNOPT:	KONPLEMAnTE
AIILMNOSYY:	IMILYASYON	AnEEKNNNOVY:	ENKONVENYAn
AIILOnRSSTY:	ILISTRASYOn	AnEEnIKRTVVY:	KRETYEnVIVAn
AIINNOSSYY:	INISYASYON	AnEFIKNORSS:	SIKONFERAnS
AIINOSSTYY:	SITIYASYON	AnEIKKMMNOO:	EKONOMIKMAn
AIKKLOnOnPSY:	KOnPLIKASYOn	AnEINNNOPRZ:	AnPRIZONNEN


Tirages de 10 jetons de AnEKOnOnPRSYY à EEMNNNNOPW - Page 6/7

AnEKOnOnPRSYY:	KOnPREYAnSYOn	DEIKOnRSSTY:	DESTRIKSYOn
AnFINORSTYZ:	TRAnSFIZYON	DEILMNOOSY:	DEMOLISYON
AnFKMNNOOnSY:	FONKSYOnNMAn	DEILOOVYYZ:	ODYOVIZYEL
	FOnKSYONNMAn	DEINOOPSYZ:	DEPOZISYON
BBEIIKLOTY:	BIBLIYOTEK	DEnIIIKMNRS:	DISKRIMINEn
BDEEIILMOZ:	DEMOBILIZE	DEnIKNOSSTY:	DISTEnKSYON
BDEEIKNOnSY:	BENEDIKSYOn	DIIIJKOnRSY:	JIRIDIKSYOn
BDEEKOnOnRST:	DEKOnSTOnBRE	DIIIMNNOSY:	DIMINISYON
BDEEnEnGGLNV:	VLEnGBEnDENG	DIIKMNOORT:	MITOKONDRI
	VLEnGBENDEnG	DIIOOnPSSYZ:	DISPOZISYOn
	VLENGBEnDEnG	DIKNOOPSWY:	PWODIKSYON
BDEEnIKMOST:	KOSTIMDEBEn	EEEELNNVYZ:	VENEZYELEN
BDEENNNOOuT:	DEBOuTONNEN	EEEEnKLLTTY:	EnTELEKTYEL
BEEEIILNST:	ENBESILITE	EEEFKNOPSY:	PEFEKSYONE
BEEGILNOuVY:	BOuGENVILYE	EEEFNOnRTVY:	FOnVERETYEN
BEIIKNOSYZ:	EKZIBISYON	EEEIIKNRST:	ENSEKIRITE
BEIKNNNOOZ:	KONBINEZON	EEEIILRSTZ:	ESTERILIZE
BIIKOnOnRSTY:	KOnTRIBISYOn	EEEIJNNSTY:	JENETISYEN
ChDEEFINNNO:	DEChIFONNEN	EEEIJNOTWZ:	JENEWOZITE
DDEEIILNVY:	ENDIVIDYEL	EEEIKMNNST:	EKSTEMINEN
DDEIIKLOOnT:	DIKOTILEDOn	EEEIKMRSTT:	EKSTREMITE
DEEEEEnRSTZ:	DEZEnTERESE	EEEJKNOnSTY:	ENTEJEKSYOn
DEEEEFKNTZ:	DEZENFEKTE	EEEKNOnSSTY:	ENTESEKSYOn
DEEEEKPRST:	DERESPEKTE	EEEnFNORTVY:	FONVERETYEn
DEEEFIILNT:	ENFIDELITE	EEEnIKLRSTY:	ELEKTRISYEn
DEEEGGLNOR:	DEGRENGOLE	EEEnJKNOSTY:	EnTEJEKSYON
DEEEKKNNOT:	DEKONNEKTE	EEEnJOuRTWYY:	TERYEWOuJYEn
DEEEnIIKLRT:	EnKREDILITE	EEEnKNOSSTY:	EnTESEKSYON
DEEEnIKPRVY:	DEKIPREVYEn	EEFKKNNOSY:	KENSKOFYEN
DEEEnISTTYY:	DYETETISYEn	EEFKLNORSY:	REFLEKSYON
DEEENNNORZ:	DEREZONNEN	EEFNOOSTTZ:	FOTOSENTEZ
DEEENOPPYZ:	PODEPEZYEN	EEIIKMNNNR:	ENKRIMINEN
DEEFIIMSTY:	DEMISTIFYE	EEIINNRSTT:	SENTRINITE
DEEIIKNSST:	ENSEKTISID	EEIJKMORTW:	JEWOMETRIK
DEEIJNNOSY:	ENDIJESYON	EEIJKMORTY:	JEYOMETRIK
DEEIKNOOnSY:	EKOnDISYONE	EEIJLMOOTY:	METEYOLOJI
DEEIKOnPSSY:	EKSPEDISYOn	EEIKLNORSY:	REKONSILYE
DEEINNOSYZ:	ENDESIZYON	EEIKNOPSSY:	PESEKISYON
DEEINOPSSY:	ESPEDISYON	EEILNNSWYZ:	SENLWIZYEN
DEEKLNOOTW:	DEKONTWOLE	EEILNOSTVY:	TELEVISYON
DEELNNOOnPT:	DEPLOTOnNEN	EEINOPRSTY:	REPETISYON
DEEnIIILNPS:	EnDISIPLINE	EEIOPPRSTW:	PWOSPERITE
DEEnLNNOOPT:	DEPLOTONNEn	EEIOPPRTWY:	PWOPRIYETE
DEFIINNOSY:	DEFINISYON	EEKKNNNOSY:	KEKSYONNEN
DEIIILNNPS:	DISIPLINEN	EEKKNORSSY:	EKSKRESYON
	ENDISIPLIN	EEKMNOORTW:	KWONOMETRE
DEIJLMOOOT:	METODOLOJI	EEKNNOPSSY:	ENSPEKSYON
DEIKNOnSSTY:	DISTENKSYOn	EEKOOPSSTT:	ESTETOSKOP
DEIKNOPRSY:	PREDIKSYON	EELNNOPRSY:	LENPRESYON
DEIKOnPRSSY:	DESKRIPSYOn	EEMNNNNOPW:	PWONMENNEN


Tirages de 10 jetons de EFIIKKNOST à JKKNNOOOnSY - Page 7/7

EFIIKKNOST:	KONSEKITIF		
EFIKNNOnRSY:	FRIKSYOnNEN		
EGNOOPRSWY:	PWOGRESYON		
EIIIJLPRVY:	PRIVILIJYE		
EIIILLMPTY:	MILTIPLIYE		
EIIJJKLNOO:	JINEKOLOJI		
EIIKKLNOPT:	POLITEKNIK		
EIIKNNOSYZ:	ENKIZISYON		
EIILNOPSTY:	POLITISYEN		
EIINOnSSTTY:	ENSTITISYOn		
EIIOnPSSSTY:	SIPESTISYOn		
EIKLMOOSTT:	MOTOSIKLET		
EIKMNNOOnSY:	KOnMISYONNE		
	KONMISYOnNE		
EIKMNNOOSY:	KOMISYONNE		
EIKNOnPRSSY:	ENSKRIPSYOn		
EIKNOnRSSTY:	ENSTRIKSYOn		
EIKNOOnPSTY:	KOnPETISYON		
	KONPETISYOn		
EIKOnRRSSTY:	RESTRIKSYOn		
EILNOORSVY:	REVOLISYON		
EIMOOPRSTT:	OPTOMETRIS		
EIOOnPPRSYZ:	PREPOZISYOn		
EJKNOOPSWY:	PWOJEKSYON		
EKLNOOPSYZ:	EKSPLOZYON		
EKNNOOPSSY:	KONSEPSYON		
EKNOOOuRTTT:	TOuTOKONTRE		
EKNOOPSTWY:	PWOTEKSYON		
EnEnEnGMNNOnPR:	GREnNPOnMEnNEn		
EnEnOOPPRSTY:	POTOPREnSYEn		
EnFIKNNORSY:	FRIKSYONNEn		
EnIINOSSTTY:	EnSTITISYON		
EnIKNOPRSSY:	EnSKRIPSYON		
EnIKNORSSTY:	EnSTRIKSYON		
ENNNNOOYZZ:	ZONZONNYEN		
IIKLMOOSST:	MOTOSIKLIS		
IIKNOOnSSYZ:	SIKOnSIZYON		
	SIKONSIZYOn		
IIKOnOnSSTTY:	KOnSTITISYOn		
IINOOPSSYZ:	SIPOZISYON		
IKKLNNOOYZ:	KONKLIZYON		
IKKOnOnRSSTY:	KOnSTRIKSYOn		
IKNOOOnPSYZ:	KOnPOZISYON		
	KONPOZISYOn		
IOOOnPPSWYZ:	PWOPOZISYOn		
JKKNNOOOnSY:	KONJONKSYOn		
	KONJOnKSYON		
	KOnJONKSYON		
			
			


