Tirages de 11 jetons de AAAADFLMNNN à AAnEILMNPPRS - Page 1/4

AAAADFLMNNN:	ANMALDANFAN	AAEFMNORSTT:	TRANSFOMATE
AAAAIMNRSTY:	SANTAMARIYA	AAEFNNOSTTY:	FETATANSYON
AAABDELNNOW:	ALAWONNBADE	AAEGIMNOnSYZ:	EGZAMINASYOn
AAABELMNNRS:	RASANBLEMAN	AAEIKKLLNSW:	KELKILANSWA
AAADEEJNTVZ:	DEZAVANTAJE	AAEIKMNOnSYZ:	EKZAMINASYOn
AAADELMNPTT:	DEPATMANTAL	AAEILNNOSTY:	NASYONALITE
AAADENNNTTZ:	DETANZANTAN	AAEILNNOSYZ:	NASYONALIZE
AAADFLMNNOT:	FONDAMANTAL	AAEILNOSVYY:	EVALIYASYON
AAADGIMNNRS:	AGRANDISMAN	AAEIMNNPRST:	PRESANTIMAN
AAAFLMNNOSY:	ANFLAMASYON	AAEIMNOnPSSY:	EMANSIPASYOn
AAAILMNOnSTY:	ALIMANTASYOn	AAEIOnPRSSYY:	APRESIYASYOn
AAAMNNNOPWZ:	ANPWAZONMAN	AAEKLMNORSY:	REKLAMASYON
AAAnILMNOSTY:	ALIMAnTASYON	AAEKMMNNOnTT:	MEKOnTANTMAN
AABDINNNOSY:	ANBANDISYON	AAELMNOSSVY:	MALVESASYON
AABEILMNRST:	RETABLISMAN	AAELMOOnRSYY:	AMELYORASYOn
AABEIOnRSVYY:	ABREVIYASYOn	AAELNNOSSTY:	ENSTALASYON
AABEKMNNNOR:	ANKONBREMAN	AAEnILMNPPRS:	PREnSIPALMAN
AABEKMORRYZ:	KRABMAZOREY	AAENNNNOPWZ:	ANPWAZONNEN
AABIMNNOOSY:	ABOMINASYON	AAENOnPRSTYZ:	PREZANTASYOn
AAChEFIMNRRS:	RAFREChISMAN	AAENOOPRSVY:	EVAPORASYON
AAChKMNNOOuTW:	KAWOTChOuMANN	AAENOPPRRSY:	PREPARASYON
AADDEENNNPS:	ENDEPANDANS	AAFIKKOSTTW:	KATASTWOFIK
AADDEGNORSY:	DEGRADASYON	AAFIKOnSSSTY:	SATISFAKSYOn
AADDIILOnPSY:	DILAPIDASYOn	AAFNNOOPSWY:	PWOFANASYON
AADEEEFFLNN:	ALAFENDEFEN	AAGMOOnPRSWY:	PWOGRAMASYOn
AADEEILPPPR:	PARALEPIPED	AAGNOOPPSWY:	PWOPAGASYON
AADEFIMNRSW:	REFWADISMAN	AAIIJMNNOSY:	IMAJINASYON
AADEGKOnRSSY:	AKSYOnDEGRAS	AAIIKKLLRST:	KALKILATRIS
AADEIKOnRSTY:	AKREDITASYOn	AAIIKORRSST:	ARISTOKRASI
AADEILLNRSV:	LADELIVRANS	AAIILNNOSSY:	ALISINASYON
AADEIMNOSTW:	DIMATENOSWA	AAIKLMNNOPS:	AKONPLISMAN
AADEKLNORSY:	DEKLARASYON	AAIKMMNOOTT:	OTOMATIKMAN
AADELNORSVY:	SALVADORYEN	AAIKMNNNOST:	KONSANTIMAN
AADENOSSTVY:	DEVASTASYON	AAIKMNOnOnSTY:	KOnTAMINASYOn
AADFGIKLORT:	DAKTILOGRAF	AAIKNNOSSVY:	VAKSINASYON
AADKNNNOOSY:	KONDANASYON	AAILNOPPSTY:	PALPITASYON
AAEEGKLMTTW:	GWATEMALTEK	AAIMNNNOnPRZ:	ANPRIZOnNMAN
AAEEGNOTTWW:	ENTEWOGATWA	AAIMNOPVWWZ:	PWOVIZWAMAN
AAEEIKLLRTW:	EKWILATERAL	AAINOOSSSYY:	ASOSIYASYON
AAEEIMMNTTV:	VITAMETENAM	AAKLMOOnPSWY:	PWOKLAMASYOn
AAEEJKOnRSYZ:	EKZAJERASYOn	AAKNNORSTYZ:	TRANZAKSYON
AAEEKLOnRSSY:	AKSELERASYOn	AAKNOnOnRSSTY:	KOnSANTRASYOn
AAEELMNPSSY:	ESPESYALMAN	AAKNOnOnRSTVY:	KOnTRAVANSYOn
AAEEnGIKNRWY:	NIKARAGWEYEn	AAnDEEILRSTZ:	DESAnTRALIZE
AAEEnIMMSTTY:	MATEMATISYEn	AAnDEIKOnRSVY:	REVAnDIKASYOn
AAEENNPRRTZ:	REPREZANTAN	AAnDEKMOOnRSY:	REKOMAnDASYOn
AAEFIILMRYZ:	FAMILYARIZE	AAnDIKMOOnSTY:	DOKIMAnTASYOn
AAEFKNOnRSTY:	FREKANTASYOn	AAnEFKNORSTY:	FREKAnTASYON
AAEFLMNNOSY:	ENFLAMASYON	AAnEIKKMOSST:	MAnSIKATOEKS
AAEFMNNOSTY:	FEMANTASYON	AAnEILMNPPRS:	PRENSIPALMAn


Tirages de 11 jetons de AAnEIMNOPSSY à AEIILMNNOSY - Page 2/4

AAnEIMNOPSSY:	EMAnSIPASYON	ADEEIMNOnSTY:	DETEMINASYOn
AAnEKMMNNOTT:	MEKONTAnTMAN	ADEEnFMOOnSYZ:	DEZEnFOMASYOn
	MEKONTANTMAn	ADEFFIIINNT:	ANDEFINITIF
AAnENOPRSTYZ:	PREZAnTASYON	ADEFIIKNNOT:	ANDEKONFITI
AAnIMNNNOPRZ:	ANPRIZONNMAn	ADEFIKLNOnSY:	KOnFIDANSYEL
	AnPRIZONNMAN	ADEFKNNOOSY:	FEKONDASYON
AAnIMOnRSSTYY:	MAnSTRIYASYOn	ADEIIKLNOPS:	ANSIKLOPEDI
AAnIOnPRRSSTY:	TRAnSPIRASYOn	ADEIILLNPPZ:	DEPLIZANPLI
AAnKNOOnRSSTY:	KOnSAnTRASYON	ADEIJKLMOOT:	DEMATOLOJIK
	KONSAnTRASYOn	ADEIKLMNOSY:	MALEDIKSYON
AAnKNOOnRSTVY:	KOnTRAVAnSYON	ADEIKOOnPSYZ:	DEZOKIPASYOn
	KONTRAVAnSYOn	ADEIMNNOOnSY:	DENOMINASYOn
AANNOORSTYY:	ORYANTASYON	ADEINNOSSTY:	DESTINASYON
ABBBEIOORRT:	TRIBOREBABO	ADEINOnOnSSYY:	DENOnSIYASYOn
ABBEIILOPTW:	PWOBABILITE	ADEKLNNOOSY:	KONDOLEYANS
ABDEEIILMNT:	DEMANTIBILE	ADEKNNOOPRS:	KORESPONDAN
ABDEEIILSTZ:	DESTABILIZE	ADEKNOOnPRSS:	KORESPOnDANS
ABDEEINNPSS:	ENDISPENSAB	ADEMOnOnRSSTY:	DEMOnSTRASYOn
ABDEEINOSYZ:	DEZOBEYISAN	ADIILNOSSTY:	DISTILASYON
ABEEILPRRST:	PRESBITERAL	ADIINOPRSSY:	DISPARISYON
ABEIIIKLLPT:	KILPABILITE	ADIKKOnOnRSTY:	KOnTRADIKSYOn
ABEIIILNSST:	SANSIBILITE	ADIKNORSSTY:	DISTRAKSYON
ABEINNOSSVY:	SIBVANSYONE	AEEEIMNPRST:	ESPERIMANTE
ABFIIKOnOnSYZ:	ZOnBIFIKASYOn	AEEEJNOnRRSY:	REJENERASYOn
ABIIJLNOORY:	ANBRIYOLOJI	AEEEnKMRTTVY:	KATREVEnTYEM
ABIIKLNOPSY:	PIBLIKASYON	AEEFKMNOnPSY:	PEFEKSYOnMAN
ABIIKLOPRTV:	TRAVOPIBLIK	AEEFKNNORSY:	KONFERANSYE
ABIILNORSTY:	TRIBILASYON	AEEGIIILRRT:	IREGILARITE
ABIKLMOOuOuTT:	KOMATIBOuLOuT	AEEIIKRTTVY:	KREYATIVITE
ADDEEELNSTY:	DESANTDELYE	AEEIMNNSSTV:	ENVESTISMAN
ADDEEEnEnNPST:	EnTEDEPEnDANS	AEEKLMNNOPT:	KONPLEMANTE
ADDEEEnLNNPS:	LEnDEPENDANS	AEEKNNNNOVY:	ENKONVENYAN
	LENDEPEnDANS	AEEKNORRSYY:	REKREYASYON
ADDEEGIKNNN:	KINDEGADENN	AEEKNORRTTY:	KONTRARYETE
ADDEEILNOnVW:	LAVIWOnNDEDE	AEEnIKNRTVVY:	KRETYEnVIVAN
ADDEEINNRSV:	VANDREDISEN	AEENOPRSVYZ:	PREZEVASYON
ADDEEnGGLNOR:	DEGREnNGOLAD	AEFFIIILNNT:	ALENFINITIF
ADDEnIIILSVY:	EnDIVIDYALIS	AEFIIKNRSTT:	ENFRASTIKTI
ADEEEFKNNTZ:	DEZENFEKTAN	AEFIILOnSSTY:	FELISITASYOn
ADEEEFNPRRS:	DEPREFERANS	AEFIIOPRTYZ:	FIZYOTERAPI
ADEEEKNPRST:	DERESPEKTAN	AEFIKNNORSS:	SIKONFERANS
ADEEELOPTTY:	DELATETOPYE	AEFILNOnRSTY:	ENFILTRASYOn
ADEEEnIKMNRT:	EnDIREKTEMAN	AEFKKLMOOST:	KOFLESTOMAK
ADEEFILNRSY:	DIFERANSYEL	AEGGIKNNORS:	KONGREGANIS
ADEEFKOnOnRSY:	KOnFEDERASYOn	AEGGKNOOnRSY:	KOnGREGASYON
ADEEGLNOuPWY:	GWADLOuPEYEN		KONGREGASYOn
ADEEIIKLNPP:	PEPANDIKILE	AEGINOOnSSYY:	NEGOSIYASYOn
ADEEIJMNNSW:	JASMENDENWI	AEIIIKLMNRT:	KRIMINALITE
ADEEIKNORST:	EKSTRAODINE	AEIIKLMMNSY:	MAKSIMILYEN
ADEEIKNRSTV:	KATREVENDIS	AEIILMNNOSY:	ELIMINASYON


Tirages de 11 jetons de AEIILPRSSTT à EEEJKNNOSTY - Page 3/4

AEIILPRSSTT:	PERISTALTIS	AnDEFIKLNOSY:	KONFIDAnSYEL
AEIKKLOnPSSY:	EKSPLIKASYOn	AnDEILOPSVWY:	PWOVIDAnSYEL
AEIKKMMNNOO:	EKONOMIKMAN	AnDEKNOOPRSS:	KORESPONDAnS
AEIKNOPRSSY:	EKSPIRASYON	AnEEEKMNNTTW:	KWETMAnNENET
AEINNNNOPRZ:	ANPRIZONNEN	AnEEFKMNOPSY:	PEFEKSYONMAn
AEINOPRRSSY:	RESPIRASYON	AnEEIKNRTVVY:	KRETYENVIVAn
AEKLNOOnSSTY:	KONSTELASYOn	AnEIOPSSTTTW:	PWOTESTAnTIS
	KOnSTELASYON	AnEKNOOnPRSYY:	KONPREYAnSYOn
AEKNNOOSSVY:	KONSEVASYON		KOnPREYAnSYON
AEKNOnOnPRSYY:	KOnPREYANSYOn	AnFKMNNNOOSY:	FONKSYONNMAn
AEKNOOnRRTYZ:	KONTRARYEZOn	BBEEIIKLOTY:	BIBLIYOTEKE
	KOnTRARYEZON	BDEEEGLNNNgV:	VLENGBENDENg
AEnFILNORSTY:	EnFILTRASYON	BDEEEIIKLRZ:	DEZEKILIBRE
AEnIIKMNOnRSY:	EnKRIMINASYOn	BDEEEnGGLNNV:	VLEnGBENDENG
AEnIOOnPSVWYZ:	EnPWOVIZASYOn		VLENGBENDEnG
AENOORRSSTY:	RESTORASYON		VLENGBEnDENG
AEOOnPSSTTWY:	PWOTESTASYOn	BDEEIKMNOST:	KOSTIMDEBEN
AFIIIKOnSSYY:	SIYIFIKASYOn	BDEEIKNNOSY:	BENEDIKSYON
AFIKMNNOOSY:	KONFIMASYON	BDEEKNOOnRST:	DEKONSTOnBRE
AFINNORSTYZ:	TRANSFIZYON		DEKOnSTONBRE
AFINORRSSTY:	FRISTRASYON	BDIIIOnRSSTY:	DISTRIBISYOn
AFKMNNNOOnSY:	FONKSYOnNMAN	BEEnIORSSTTY:	OBSTETRISYEn
	FOnKSYONNMAN	BIIKNOOnRSTY:	KONTRIBISYOn
AGIINNOORSY:	INOGIRASYON		KOnTRIBISYON
AIIILNOSTYZ:	ITILIZASYON	DDEIIKLNOOT:	DIKOTILEDON
AIIJKLLMOOT:	KLIMATOLOJI	DEEEEENRSTZ:	DEZENTERESE
AIIKKMNOOnSY:	KOMINIKASYOn	DEEEIIKLNRT:	ENKREDILITE
AIILMNOnRSTY:	MALNITRISYOn	DEEEIKNPRVY:	DEKIPREVYEN
AIILNOOnPSYZ:	POLINIZASYOn	DEEEINSTTYY:	DYETETISYEN
AIILNORSSTY:	ILISTRASYON	DEEEJKNOOnSY:	DEKOnJESYONE
AIKKLNOOnPSY:	KONPLIKASYOn	DEEIIILNNPS:	ENDISIPLINE
	KOnPLIKASYON	DEEIIJNSSVY:	SEVISDIJYEN
AIKLNNOOPSY:	KONPILASYON	DEEIKNNOOSY:	EKONDISYONE
AIKLNOOnSSTY:	KONSILTASYOn	DEEIKNOPSSY:	EKSPEDISYON
	KOnSILTASYON	DEELNNNOOPT:	DEPLOTONNEN
AIKNOOnPSSTY:	KONSTIPASYOn	DEIIIKKOnTTV:	KOnDIKTIVITE
	KOnSTIPASYON	DEIIIKMNNRS:	DISKRIMINEN
AINOOORSTYZ:	OTORIZASYON	DEIKNNOSSTY:	DISTENKSYON
AKNOOOPSVWY:	PWOVOKASYON	DEIKNOPRSSY:	DESKRIPSYON
AKNOOuRSSSTY:	SOuSTRAKSYON	DEIKNORSSTY:	DESTRIKSYON
AnAnBEELMNRTT:	TRAnBLEMAnNTE	DEIKOOnOnPSYZ:	DEKOnPOZISYOn
AnAnEEIJMRRST:	AnREJISTREMAn	DEIKOOnPRSWY:	REPWODIKSYOn
AnBDEEIOSSYZ:	DEZOBEYISAnS	DEnIIOOnPSSYZ:	EnDISPOZISYOn
AnDDEEEEnNPST:	ENTEDEPEnDAnS	DIIIJKNORSY:	JIRIDIKSYON
	EnTEDEPENDAnS	DIINOOPSSYZ:	DISPOZISYON
AnDDEEELNNPS:	LENDEPENDAnS	EEEEKLLNTTY:	ENTELEKTYEL
AnDEEEIKMNRT:	ENDIREKTEMAn	EEEIIKLRSTT:	ELEKTRISITE
AnDEEEKPRSST:	DERESPEKTAnS	EEEIKLNRSTY:	ELEKTRISYEN
AnDEEKLMOOnSY:	MEKOnDOLEYAnS	EEEILMRSSTY:	SEMESTRIYEL
AnDEEnEnIKMSTT:	EnDISTEnKTEMAn	EEEJKNNOSTY:	ENTEJEKSYON


Tirages de 11 jetons de EEEKNNOSSTY à JKKNNNOOOSY - Page 4/4

EEEKNNOSSTY:	ENTESEKSYON		
EEFIJKLNOnSY:	JENIFLEKSYOn		
EEFIKNOPSSY:	PEFEKSYONIS		
EEFLNOOPSWY:	PWOFESYONEL		
EEIILMNRSTY:	MINISTERYEL		
EEIJLMOOSTY:	METEYOLOJIS		
EEnEnGMNNNOnPR:	GREnNPOnMEnNEN		
	GRENNPOnMEnNEn		
	GREnNPOnMENNEn		
EFIKNNNORSY:	FRIKSYONNEN		
EIINNOSSTTY:	ENSTITISYON		
EIINOPSSSTY:	SIPESTISYON		
EIKMNNNOOSY:	KONMISYONNE		
EIKNNOOPSTY:	KONPETISYON		
EIKNNOPRSSY:	ENSKRIPSYON		
EIKNNORSSTY:	ENSTRIKSYON		
EIKNORRSSTY:	RESTRIKSYON		
EINOOPPRSYZ:	PREPOZISYON		
ELNOOOPPSWY:	PWOPOSYONEL		
EnEnEnGMNNNOPR:	GREnNPONMEnNEn		
EnEnEnGMNNOPRW:	GREnNPWOMEnNEn		
FIIIKKOnRSSY:	KRISIFIKSYOn		
IIKNNOOSSYZ:	SIKONSIZYON		
IIKNOOnSSTTY:	KOnSTITISYON		
	KONSTITISYOn		
IIOOnPSSTTWY:	PWOSTITISYOn		
IKKNOOnRSSTY:	KOnSTRIKSYON		
	KONSTRIKSYOn		
IKNNOOOPSYZ:	KONPOZISYON		
INOOOPPSWYZ:	PWOPOZISYON		
JKKNNNOOOSY:	KONJONKSYON		
			
			
			
			
			
			
			
			
			
			
			
			
			
			
			
			
			
			
			


