Tirages de 12 lettres de AAAAGGIKKNRW à ADEINNOOnSSYY - Page 1/2

AAAAGGIKKNRW:	GWAKANAGARIK	AAnBEELMNNRTT:	TRANBLEMAnNTE
AAAEGLLMOPRR:	PARALELOGRAM		TRAnBLEMANNTE
AAAILMNNOSTY:	ALIMANTASYON	AAnDEIKKMMORT:	DEMOKRATIKMAn
AABBDDEGIORY:	BIYODEGRADAB	AAnDEIKNORSVY:	REVAnDIKASYON
AABDEOOnPSWYZ:	DEZAPWOBASYOn	AAnDEIMNSSWYZ:	SWASAnNDIZYEM
AABEINORSVYY:	ABREVIYASYON	AAnDEKMNOORSY:	REKOMAnDASYON
AABEKLMORRYZ:	KRABMALZOREY	AAnDFIIIKOnSTY:	IDAnTIFIKASYOn
AADDEIOnRSTYZ:	DEZIDRATASYOn	AAnDIKMNOOSTY:	DOKIMAnTASYON
AADDIILNOPSY:	DILAPIDASYON	AAnEEIJMNRRST:	ANREJISTREMAn
AADEEILLNNSY:	LADESALINYEN		AnREJISTREMAN
AADEEILNRSTZ:	DESANTRALIZE	AAnEIIKMMSSTT:	SISTEMATIKMAn
AADEGKNORSSY:	AKSYONDEGRAS	AAnIIKMOPRTTY:	PATRIYOTIKMAn
AADEIIMNRSTT:	ADMINISTRATE	AAnIMNORSSTYY:	MAnSTRIYASYON
AADEIKNOnRSVY:	REVANDIKASYOn	AAnINOPRRSSTY:	TRAnSPIRASYON
AADEIKNORSTY:	AKREDITASYON	AAnKNNOORSSTY:	KONSAnTRASYON
AADEKMNOOnRSY:	REKOMANDASYOn	AAnKNNOORSTVY:	KONTRAVAnSYON
AADFGIIKLORT:	DAKTILOGRAFI	ABBFGIIILORY:	BIBLIYOGRAFI
AADIKMNOOnSTY:	DOKIMANTASYOn	ABDEEIKLNOnSY:	LABENEDIKSYOn
AADILMOnOnSYYZ:	MOnDYALIZASYOn	ABDEEINOSSYZ:	DEZOBEYISANS
AAEEGIKNNRWY:	NIKARAGWEYEN	ABEEEIILMPTY:	PEMEYABILITE
AAEEIMMNSTTY:	MATEMATISYEN	ABEEILOnPRSST:	RESPOnSABLITE
AAEEJKNORSYZ:	EKZAJERASYON	ABEIJKLOORTY:	BAKTERYOLOJI
AAEEKLNORSSY:	AKSELERASYON	ABFGIIOOORTY:	OTOBIYOGRAFI
AAEFKNNORSTY:	FREKANTASYON	ABFIIKNOOnSYZ:	ZONBIFIKASYOn
AAEGIMNNOSYZ:	EGZAMINASYON		ZOnBIFIKASYON
AAEIKKMNOSST:	MANSIKATOEKS	ADDEEEEnNNPST:	ENTEDEPEnDANS
AAEIKMNNOSYZ:	EKZAMINASYON		EnTEDEPENDANS
AAEILMNNPPRS:	PRENSIPALMAN	ADDEEELNNNPS:	LENDEPENDANS
AAEIMNNOPSSY:	EMANSIPASYON	ADDEEGGLNNOR:	DEGRENNGOLAD
AAEINOPRSSYY:	APRESIYASYON	ADDEEILNNOVW:	LAVIWONNDEDE
AAEKLOnPSSTWY:	EKSPLWATASYOn	ADDEIIILNSVY:	ENDIVIDYALIS
AAEKMMNNNOTT:	MEKONTANTMAN	ADEEEIKMNNRT:	ENDIREKTEMAN
AAELMNOORSYY:	AMELYORASYON	ADEEEKNPRSST:	DERESPEKTANS
AAENNOPRSTYZ:	PREZANTASYON	ADEEEnGOnRSTYZ:	DEZEnTEGRASYOn
AAFGIIKOnRSTY:	GRATIFIKASYOn	ADEEFKNOOnRSY:	KONFEDERASYOn
AAFIIKKLOnSSY:	KLASIFIKASYOn		KOnFEDERASYON
AAFIIKLNOnPSY:	PLANIFIKASYOn	ADEEFMNOOnSYZ:	DEZENFOMASYOn
AAFIKNOSSSTY:	SATISFAKSYON	ADEEIIILMRTZ:	DEMILITARIZE
AAGMNOOPRSWY:	PWOGRAMASYON	ADEEIMNNOSTY:	DETEMINASYON
AAIIOnPRSTVYZ:	PRIVATIZASYOn	ADEEIOnPRSSYY:	DEPRESIYASYOn
AAIKMNNOOnSTY:	KOnTAMINASYON	ADEEKLMNOOnSY:	MEKOnDOLEYANS
	KONTAMINASYOn	ADEEnEnIKMNSTT:	EnDISTEnKTEMAN
AAIMNNNNOPRZ:	ANPRIZONNMAN	ADEEnFMNOOSYZ:	DEZEnFOMASYON
AAIMNOnRSSTYY:	MANSTRIYASYOn	ADEEOOnRRSTYY:	DETERYORASYOn
AAINOnPRRSSTY:	TRANSPIRASYOn	ADEFIKLNNOSY:	KONFIDANSYEL
AAKLMNOOPSWY:	PWOKLAMASYON	ADEIKKOnOnRSTY:	AKDEKOnTRISYOn
AAKNNOOnRSSTY:	KOnSANTRASYON	ADEIKNOOPSYZ:	DEZOKIPASYON
	KONSANTRASYOn	ADEILNOPSVWY:	PWOVIDANSYEL
AAKNNOOnRSTVY:	KOnTRAVANSYON	ADEIMNNNOOSY:	DENOMINASYON
	KONTRAVANSYOn	ADEINNOOnSSYY:	DENOnSIYASYON


Tirages de 12 lettres de ADEINNOOnSSYY à IKKNNOORSSTY - Page 2/2

	DENONSIYASYOn	BDIIINORSSTY:	DISTRIBISYON
ADEKNNOOPRSS:	KORESPONDANS	BEEINORSSTTY:	OBSTETRISYEN
ADEMNOOnRSSTY:	DEMONSTRASYOn	BIIKNNOORSTY:	KONTRIBISYON
	DEMOnSTRASYON	DEEEJKNNOOSY:	DEKONJESYONE
ADIKKNOOnRSTY:	KOnTRADIKSYON	DEEIIKKLORTW:	IDWOELEKTRIK
	KONTRADIKSYOn	DEIIIKKNOTTV:	KONDIKTIVITE
AEEEJNNORRSY:	REJENERASYON	DEIINOOnPSSYZ:	ENDISPOZISYOn
AEEEKMNNNTTW:	KWETMANNENET	DEIKNOOOnPSYZ:	DEKOnPOZISYON
AEEEKMNRTTVY:	KATREVENTYEM		DEKONPOZISYOn
AEEFKMNNOPSY:	PEFEKSYONMAN	DEIKNOOPRSWY:	REPWODIKSYON
AEEIKMNOnSSTY:	EKSTEMINASYOn	DEnIINOOPSSYZ:	EnDISPOZISYON
AEEIKNNRTVVY:	KRETYENVIVAN	EEEnGMNNNNOnPR:	GREnNPOnMENNEN
AEEnIMOPRSTTY:	REPATIMYEnTOS		GRENNPOnMENNEn
AEFIIKKOnRSTY:	REKTIFIKASYOn		GRENNPOnMEnNEN
AEFIILNOSSTY:	FELISITASYON	EEFIJKLNNOSY:	JENIFLEKSYON
AEFILNNORSTY:	ENFILTRASYON	EEnEnGMNNNNOPR:	GREnNPONMENNEn
AEGGKNNOORSY:	KONGREGASYON		GRENNPONMEnNEn
AEGINNOOSSYY:	NEGOSIYASYON		GREnNPONMEnNEN
AEIIIILMNPST:	MINISIPALITE	EEnEnGMNNNOPRW:	GREnNPWOMEnNEN
AEIIKMNNOnRSY:	ENKRIMINASYOn		GRENNPWOMEnNEn
AEIIOnPPRSSTY:	PRESIPITASYOn		GREnNPWOMENNEn
AEIKKLNOPSSY:	EKSPLIKASYON	EEnIILNOSSTTY:	EnSTITISYONEL
AEINOOnPSVWYZ:	ENPWOVIZASYOn	FIIIKKNORSSY:	KRISIFIKSYON
AEINOPSSTTTW:	PWOTESTANTIS	IIKNNOOSSTTY:	KONSTITISYON
AEKLNNOOSSTY:	KONSTELASYON	IINOOPSSTTWY:	PWOSTITISYON
AEKNNOOnPRSYY:	KONPREYANSYOn	IKKNNOORSSTY:	KONSTRIKSYON
	KOnPREYANSYON		
AEKNNOORRTYZ:	KONTRARYEZON		
AEnIIKMNNORSY:	EnKRIMINASYON		
AEnINOOPSVWYZ:	EnPWOVIZASYON		
AENOOPSSTTWY:	PWOTESTASYON		
AFIIIKMOnSSTY:	MISTIFIKASYOn		
AFIIIKNOSSYY:	SIYIFIKASYON		
AFKMNNNNOOSY:	FONKSYONNMAN		
AIIJKLLMOOST:	KLIMATOLOJIS		
AIIKKMNNOOSY:	KOMINIKASYON		
AIILMNNORSTY:	MALNITRISYON		
AIILNNOOPSYZ:	POLINIZASYON		
AIKKLNNOOPSY:	KONPLIKASYON		
AIKLNNOOSSTY:	KONSILTASYON		
AIKNNOOPSSTY:	KONSTIPASYON		
AnAnChIIIOPPRTT:	OPIPIRITChAnTAn		
AnDDEEEENNPST:	ENTEDEPENDAnS		
AnDEEEnIKMNSTT:	EnDISTENKTEMAn		
	ENDISTEnKTEMAn		
AnDEEKLMNOOSY:	MEKONDOLEYAnS		
AnEKNNOOPRSYY:	KONPREYAnSYON		
BDEEEGGLNNNV:	VLENGBENDENG		
BDEEKNNOORST:	DEKONSTONBRE		
BDEIIILNOPST:	DISPONIBLITE		


