Tirages de 13 jetons de AAABEFILOnSTYZ Ã  EEIILNNOSSTTY - Page 1/1

AAABEFILOnSTYZ:	ALFABETIZASYOn	ADDEEFIIIKSTT:	SETIFIKADETID
AAABEKLNOSSWY:	LASKAWOBASYEN	ADEEEGNOnRSTYZ:	DEZENTEGRASYOn
AAAEEKNPRTTWW:	PWENTARAKETWA	ADEEEnGNORSTYZ:	DEZEnTEGRASYON
AAAEEnKPRTTWWZ:	PWEnTARAKETWAZ	ADEEEnIKMNNSTT:	EnDISTENKTEMAN
AABDENOOPSWYZ:	DEZAPWOBASYON		ENDISTEnKTEMAN
AABEELMNNNRTT:	TRANBLEMANNTE	ADEEEnIKMRTVYZ:	KATREVEnDIZYEM
AADDEINORSTYZ:	DEZIDRATASYON	ADEEFKNNOORSY:	KONFEDERASYON
AADEIKKMMNORT:	DEMOKRATIKMAN	ADEEFMNNOOSYZ:	DEZENFOMASYON
AADEIKMNOnOnSTY:	DEKOnTAMINASYOn	ADEEINOPRSSYY:	DEPRESIYASYON
AADEIKMOnOuSTYZ:	DEMAKOuTIZASYOn	ADEEKLMNNOOSY:	MEKONDOLEYANS
AADEIKNNORSVY:	REVANDIKASYON	ADEEnIIILRSTYZ:	EnDISTRIYALIZE
AADEIMNNSSWYZ:	SWASANNDIZYEM	ADEENOORRSTYY:	DETERYORASYON
AADEKMNNOORSY:	REKOMANDASYON	ADEIKKNOOnRSTY:	AKDEKONTRISYOn
AADFIIIKNOnSTY:	IDANTIFIKASYOn		AKDEKOnTRISYON
AADFIIIMNRSTT:	ADMINISTRATIF	ADEINNNOOSSYY:	DENONSIYASYON
AADIILOOnPSSYZ:	ALADISPOZISYOn	ADEMNNOORSSTY:	DEMONSTRASYON
AADIIMNOnRSSTY:	ADMINISTRASYOn	ADIKKNNOORSTY:	KONTRADIKSYON
AADIKMNNOOSTY:	DOKIMANTASYON	AEEIIILPRSTTY:	ESPIRITYALITE
AADILMNOOnSYYZ:	MOnDYALIZASYON	AEEIILOnRSSTYZ:	ESTERILIZASYOn
	MONDYALIZASYOn	AEEIKMNNOSSTY:	EKSTEMINASYON
AAEEIJMNNRRST:	ANREJISTREMAN	AEEIMNOPRSTTY:	REPATIMYENTOS
AAEIIKKKRRSTT:	KARAKTERISTIK	AEFIIKKNORSTY:	REKTIFIKASYON
AAEIIKMMNSSTT:	SISTEMATIKMAN	AEIIKMNNNORSY:	ENKRIMINASYON
AAEKLNOPSSTWY:	EKSPLWATASYON	AEIINOPPRSSTY:	PRESIPITASYON
AAFGIIKNORSTY:	GRATIFIKASYON	AEINNOOPSVWYZ:	ENPWOVIZASYON
AAFIIKKLNOSSY:	KLASIFIKASYON	AEKNNNOOPRSYY:	KONPREYANSYON
AAFIIKLNNOPSY:	PLANIFIKASYON	AFIIIKMNOSSTY:	MISTIFIKASYON
AAIIKMNOPRTTY:	PATRIYOTIKMAN	AIIIKLLMOnPSTY:	MILTIPLIKASYOn
AAIINOPRSTVYZ:	PRIVATIZASYON	AnDEEEIKMNNSTT:	ENDISTENKTEMAn
AAIKMNNNOOSTY:	KONTAMINASYON	BDEEIIILOnSYZZ:	DESIZYOnBILIZE
AAIMNNORSSTYY:	MANSTRIYASYON	DEIINNOOPSSYZ:	ENDISPOZISYON
AAINNOPRRSSTY:	TRANSPIRASYON	DEIKNNOOOPSYZ:	DEKONPOZISYON
AAKNNNOORSSTY:	KONSANTRASYON	EEEGMNNNNNOnPR:	GRENNPOnMENNEN
AAKNNNOORSTVY:	KONTRAVANSYON	EEEnGMNNNNNOPR:	GREnNPONMENNEN
AAnChIIINOPPRTT:	OPIPIRITChANTAn		GRENNPONMENNEn
	OPIPIRITChAnTAN		GRENNPONMEnNEN
AAnDEFIIOnRSSYY:	DIFERAnSIYASYOn	EEEnGMNNNNOPRW:	GREnNPWOMENNEN
AAnDFIIIKNOSTY:	IDAnTIFIKASYON		GRENNPWOMENNEn
AAnEEIJLLOnSVYZ:	LEVAnJELIZASYOn		GRENNPWOMEnNEN
AAnIIKLLNOOSTY:	AnTIKOLONYALIS	EEIILNNOSSTTY:	ENSTITISYONEL
ABBDEILNOOOnPT:	BOnBADOPOLITEN		
ABBDEnILNOOOPT:	BONBADOPOLITEn		
ABDEEIKLNNOSY:	LABENEDIKSYON		
ABDEIILMOOnSYZ:	DEMOBILIZASYOn		
ABEEIIKLOnRSST:	RESKOnSABILITE		
ABEEIILOnPRSST:	RESPOnSABILITE		
ABEEILNOPRSST:	RESPONSABLITE		
ABEnIIINORTTVY:	RIVATIBONITYEn		
ABFIIKNNOOSYZ:	ZONBIFIKASYON		
ADDEEEENNNPST:	ENTEDEPENDANS		


