Mots de 15 lettres de ABANDONNASSIONS à AIGUILLONNEMENT - Page 1/61

ABANDONNASSIONS	ACCOMPLISSEMENT	ADJECTIVISERAIS	AFFOURCHASSIONS
ABANDONNATAIRES	ACCOURCISSAIENT	ADJECTIVISERAIT	AFFOURCHERAIENT
ABANDONNATRICES	ACCOURCISSEMENT	ADJECTIVISERENT	AFFOURRAGEAIENT
ABANDONNERAIENT	ACCOUTUMASSIONS	ADJECTIVISERIEZ	AFFOURRAGEASSES
ABASOURDIRAIENT	ACCOUTUMERAIENT	ADJECTIVISERONS	AFFOURRAGEMENTS
ABASOURDISSANTE	ACCREDITASSIONS	ADJECTIVISERONT	AFFOURRAGERIONS
ABASOURDISSANTS	ACCREDITERAIENT	ADMINISTRASSENT	AFFRANCHIRAIENT
ABASOURDISSIONS	ACCROUPISSAIENT	ADMINISTRASSIEZ	AFFRANCHISSABLE
ABATARDISSAIENT	ACCROUPISSEMENT	ADMINISTRATEURS	AFFRANCHISSEURS
ABATARDISSEMENT	ACCUEILLERAIENT	ADMINISTRATIONS	AFFRANCHISSEUSE
ABOLITIONNISMES	ACCUEILLISSIONS	ADMINISTRATIVES	AFFRANCHISSIONS
ABOLITIONNISTES	ACCULTURASSIONS	ADMINISTRATRICE	AFFRIANDASSIONS
ABRACADABRANTES	ACCULTURERAIENT	ADMINISTRERIONS	AFFRIANDERAIENT
ABREVIATIVEMENT	ACETOCELLULOSES	ADMONESTASSIONS	AFIBRINOGENEMIE
ABROUTISSEMENTS	ACETYLCELLULOSE	ADMONESTERAIENT	AFRICANISASSENT
ABSORPTIOMETRIE	ACHALANDASSIONS	ADVERBIALISAMES	AFRICANISASSIEZ
ABSTENTIONNISME	ACHALANDERAIENT	ADVERBIALISASSE	AFRICANISATIONS
ABSTENTIONNISTE	ACHONDROPLASIES	ADVERBIALISATES	AFRICANISERIONS
ABSTRACTIVEMENT	ACHROMATISAIENT	ADVERBIALISERAI	AGENOUILLASSENT
ACAGNARDASSIONS	ACHROMATISASSES	ADVERBIALISERAS	AGENOUILLASSIEZ
ACAGNARDERAIENT	ACHROMATISERAIS	ADVERBIALISEREZ	AGENOUILLEMENTS
ACANTHOCEPHALES	ACHROMATISERAIT	ADVERBIALISIONS	AGENOUILLERIONS
ACCASTILLASSENT	ACHROMATISERENT	AEROBIOLOGIQUES	AGGLOMERASSIONS
ACCASTILLASSIEZ	ACHROMATISERIEZ	AEROCONDENSEURS	AGGLOMERERAIENT
ACCASTILLERIONS	ACHROMATISERONS	AERODYNAMICIENS	AGGLUTINASSIONS
ACCELEROGRAPHES	ACHROMATISERONT	AEROGENERATEURS	AGGLUTINERAIENT
ACCESSOIRISAMES	ACHROMATOPSIQUE	AEROGENERATRICE	AGRAMMATICALITE
ACCESSOIRISASSE	ACIPENSERIFORME	AEROREFRIGERANT	AGRANDISSEMENTS
ACCESSOIRISATES	ACQUIESCASSIONS	AEROTRANSPORTEE	AGRANULOCYTOSES
ACCESSOIRISERAI	ACQUIESCERAIENT	AEROTRANSPORTES	AGREMENTASSIONS
ACCESSOIRISERAS	ACROBATIQUEMENT	AFFAIBLISSAIENT	AGREMENTERAIENT
ACCESSOIRISEREZ	ACROPARESTHESIE	AFFAIBLISSANTES	AGROALIMENTAIRE
ACCESSOIRISIONS	ACTINOMETRIQUES	AFFAIBLISSEMENT	AGROBIOLOGIQUES
ACCIDENTASSIONS	ACTINOPTERYGIEN	AFFECTIONNAIENT	AGROBIOLOGISTES
ACCIDENTERAIENT	ACTINOTHERAPIES	AFFECTIONNASSES	AGROECOLOGIQUES*
ACCIDENTOLOGIES	ACTUALISASSIONS	AFFECTIONNERAIS	AGROECOSYSTEMES
ACCIDENTOLOGUES	ACTUALISATRICES	AFFECTIONNERAIT	AGROFORESTERIES
ACCIPITRIFORMES	ACTUALISERAIENT	AFFECTIONNERENT	AGROFORESTIERES
ACCLIMATASSIONS	ADDITIONNASSENT	AFFECTIONNERIEZ	AGUERRISSEMENTS
ACCLIMATERAIENT	ADDITIONNASSIEZ	AFFECTIONNERONS	AIGUILLETASSENT
ACCOMMODASSIONS	ADDITIONNERIONS	AFFECTIONNERONT	AIGUILLETASSIEZ
ACCOMMODATRICES	ADENOCARCINOMES	AFFECTUEUSEMENT	AIGUILLETERIONS*
ACCOMMODERAIENT	ADENOIDECTOMIES	AFFERMISSEMENTS	AIGUILLETTERAIS
ACCOMPAGNASSENT	ADIPOSOGENITALE*	AFFIRMATIVEMENT	AIGUILLETTERAIT
ACCOMPAGNASSIEZ	ADIPOSOGENITAUX*	AFFOUAGEASSIONS	AIGUILLETTERIEZ
ACCOMPAGNATEURS	ADJECTIVASSIONS	AFFOUILLASSIONS	AIGUILLETTERONS
ACCOMPAGNATRICE	ADJECTIVERAIENT	AFFOUILLERAIENT	AIGUILLETTERONT
ACCOMPAGNEMENTS	ADJECTIVISAIENT	AFFOURAGEASSENT	AIGUILLONNAIENT
ACCOMPAGNERIONS	ADJECTIVISASSES	AFFOURAGEASSIEZ	AIGUILLONNASSES
ACCOMPLISSAIENT	ADJECTIVISATION	AFFOURAGERAIENT	AIGUILLONNEMENT


Mots de 15 lettres de AIGUILLONNERAIS à ANTIMACONNIQUES - Page 2/61

AIGUILLONNERAIS	AMBITIONNASSENT	ANATHEMATISIONS	ANTIACRIDIENNES
AIGUILLONNERAIT	AMBITIONNASSIEZ	ANATHEMISASSENT	ANTIALCOOLIQUES
AIGUILLONNERENT	AMBITIONNERIONS	ANATHEMISASSIEZ	ANTIALCOOLISMES
AIGUILLONNERIEZ	AMERICANISAIENT	ANATHEMISERIONS	ANTIALLERGIQUES
AIGUILLONNERONS	AMERICANISASSES	ANATOMISASSIONS	ANTIAMERICAINES
AIGUILLONNERONT	AMERICANISATION	ANATOMISERAIENT	ANTIANGIOGENESE
ALAMBIQUASSIONS	AMERICANISERAIS	ANDERLECHTOISES	ANTIARYTHMIQUES
ALAMBIQUERAIENT	AMERICANISERAIT	ANDROGENETIQUES	ANTIASTHMATIQUE
ALANGUISSEMENTS	AMERICANISERENT	ANEANTISSEMENTS	ANTIAUTORITAIRE
ALCALIMETRIQUES	AMERICANISERIEZ	ANECDOTISASSENT	ANTIAVORTEMENTS
ALCALINISASSENT	AMERICANISERONS	ANECDOTISASSIEZ	ANTIBACTERIENNE
ALCALINISASSIEZ	AMERICANISERONT	ANECDOTISERIONS	ANTIBIOTHERAPIE
ALCALINISATIONS	AMERINDIANISMES	ANESTHESIASSENT	ANTIBOURGEOISES
ALCALINISERIONS	AMEUBLISSEMENTS	ANESTHESIASSIEZ	ANTIBROUILLAGES
ALCALINOTERREUX	AMEULONNASSIONS	ANESTHESIERIONS	ANTIBROUILLARDS
ALCOOLIFICATION	AMEULONNERAIENT	ANESTHESIOLOGIE	ANTICANCEREUSES
ALCOOLISASSIONS	AMMONIFICATIONS	ANGIOGRAPHIQUES	ANTICAPILLAIRES
ALCOOLISERAIENT	AMMONIOTELIQUES	ANGIONEUROTIQUE	ANTICAPITALISTE
ALEXANDRINISMES	AMOINDRISSAIENT	ANGLICISASSIONS	ANTICHRETIENNES
ALGODYSTROPHIES	AMOINDRISSEMENT	ANGLICISERAIENT	ANTICOAGULANTES
ALLANTOIDIENNES	AMONCELLERAIENT	ANHYPOTHETIQUES	ANTICOMMUNISMES
ALLEGORIQUEMENT	AMORDANCASSIONS	ANIMALISASSIONS	ANTICOMMUNISTES
ALLEGORISASSENT	AMORDANCERAIENT	ANIMALISERAIENT	ANTICOMMUTATIFS
ALLEGORISASSIEZ	AMOURACHASSIONS	ANKYLOSTOMIASES	ANTICOMMUTATIVE
ALLEGORISERIONS	AMOURACHERAIENT	ANNUALISASSIONS	ANTICONFORMISME
ALLERGOLOGIQUES	AMPELOGRAPHIQUE	ANNUALISERAIENT	ANTICONFORMISTE
ALLERGOLOGISTES	AMPHETAMINIQUES	ANONYMISASSIONS	ANTICORPUSCULES
ALLUVIONNASSENT	AMPHIBOLOGIQUES	ANONYMISERAIENT	ANTICRIMINALITE
ALLUVIONNASSIEZ	AMPHICTYONIQUES	ANTAGONISASSENT	ANTICYCLONIQUES
ALLUVIONNEMENTS	AMPLIFICATRICES	ANTAGONISASSIEZ	ANTIDEFLAGRANTE
ALLUVIONNERIONS	AMSTELLODAMIENS	ANTAGONISERIONS	ANTIDEFLAGRANTS
ALOURDISSEMENTS	AMSTELLODAMOISE	ANTECAMBRIENNES	ANTIDEPLACEMENT
ALPHABETISAIENT	AMYGDALECTOMIES	ANTEDILUVIENNES	ANTIDEPRESSEURS
ALPHABETISASSES	ANAGRAMMATIQUES	ANTEPENULTIEMES	ANTIDIABETIQUES
ALPHABETISATION	ANAGRAMMATISMES	ANTEPREDICATIFS	ANTIDIARRHEIQUE
ALPHABETISERAIS	ANAGRAMMATISTES	ANTEPREDICATIVE	ANTIDIPHTERIQUE
ALPHABETISERAIT	ANALPHABETISMES	ANTHELMINTHIQUE	ANTIDIURETIQUES
ALPHABETISERENT	ANAPHRODISIAQUE	ANTHROPISASSENT	ANTIDREYFUSARDE
ALPHABETISERIEZ	ANAPHYLACTIQUES	ANTHROPISASSIEZ	ANTIDREYFUSARDS
ALPHABETISERONS	ANASTIGMATIQUES	ANTHROPISATIONS	ANTIECONOMIQUES
ALPHABETISERONT	ANASTIGMATISMES	ANTHROPISERIONS	ANTIEFFRACTIONS
ALPHABETISEUSES	ANASTOMOSASSENT	ANTHROPOGENESES	ANTIEMETISANTES
ALPHABLOQUANTES	ANASTOMOSASSIEZ	ANTHROPOGRAPHIE	ANTIEPILEPTIQUE
ALPHANUMERIQUES	ANASTOMOSERIONS	ANTHROPOLOGIQUE	ANTIEUROPEENNES
ALTERNATIVEMENT	ANATHEMATISAMES	ANTHROPOLOGISTE	ANTIGRAVITATION
ALTILIGERIENNES	ANATHEMATISASSE	ANTHROPOMETRIES	ANTIHYGIENIQUES
ALTOSEQUANAISES	ANATHEMATISATES	ANTHROPOMORPHES	ANTIINFECTIEUSE*
ALUMINOSILICATE	ANATHEMATISERAI	ANTHROPOPHAGIES	ANTILIBERALISME
ALUMINOTHERMIES	ANATHEMATISERAS	ANTHROPOSOPHIES	ANTILOGARITHMES
AMAIGRISSEMENTS	ANATHEMATISEREZ	ANTHROPOZOIQUES	ANTIMACONNIQUES


Mots de 15 lettres de ANTIMICROBIENNE à ASSOUVISSEMENTS - Page 3/61

ANTIMICROBIENNE	APOSTASIASSIONS	APPROVISIONNERA	ARSOUILLASSIONS
ANTIMIGRAINEUSE	APOSTASIERAIENT	APPROVISIONNEUR	ARSOUILLERAIENT
ANTIMILITARISME	APOSTILLASSIONS	APPROVISIONNIEZ	ARTERIOGRAPHIES
ANTIMILITARISTE	APOSTILLERAIENT	APPROVISIONNONS	ARTERIOSCLEREUX
ANTIMINISTERIEL	APOSTOLIQUEMENT	AQUARELLASSIONS	ARTERIOSCLEROSE
ANTIMONARCHIQUE	APOSTROPHASSENT	AQUARELLERAIENT	ARTIFICIALISAIS
ANTIMONARCHISTE	APOSTROPHASSIEZ	ARACHNOIDIENNES	ARTIFICIALISAIT
ANTIMONDIALISTE	APOSTROPHERIONS	ARBORICULTRICES	ARTIFICIALISANT
ANTINAUPATHIQUE	APPAREILLASSENT	ARCHANTHROPIENS	ARTIFICIALISEES
ANTINEVRALGIQUE	APPAREILLASSIEZ	ARCHEOBACTERIES	ARTIFICIALISENT
ANTIPALUDEENNES	APPAREILLEMENTS	ARCHICHAMBELLAN	ARTIFICIALISERA
ANTIPARASITAIRE	APPAREILLERIONS	ARCHICHANCELIER	ARTIFICIALISIEZ
ANTIPARASITAMES	APPARENTASSIONS	ARCHICHLAMYDEES	ARTIFICIALISONS
ANTIPARASITASSE	APPARENTERAIENT	ARCHICONFRERIES	ARYTENOIDIENNES
ANTIPARASITATES	APPARTIENDRIONS	ARCHIDIOCESAINE	ASCENSIONNAIENT
ANTIPARASITERAI	APPAUVRISSAIENT	ARCHIDIOCESAINS	ASCENSIONNASSES
ANTIPARASITERAS	APPAUVRISSEMENT	ARCHIEPISCOPALE	ASCENSIONNELLES
ANTIPARASITEREZ	APPENDICECTOMIE	ARCHIEPISCOPATS	ASCENSIONNERAIS
ANTIPARASITIONS	APPENDICULAIRES	ARCHIEPISCOPAUX	ASCENSIONNERAIT
ANTIPATRIOTIQUE	APPERTISASSIONS	ARCHIMANDRITATS	ASCENSIONNERENT
ANTIPATRIOTISME	APPERTISERAIENT	ARCHITECTONIQUE	ASCENSIONNERIEZ
ANTIPERNICIEUSE	APPESANTIRAIENT	ARCHITECTURALES	ASCENSIONNERONS
ANTIPERSONNELLE	APPESANTISSIONS	ARCHITECTURAMES	ASCENSIONNERONT
ANTIPERSPIRANTE	APPLAUDISSAIENT	ARCHITECTURASSE	ASCENSIONNISTES
ANTIPERSPIRANTS	APPLAUDISSEMENT	ARCHITECTURATES	ASSAINISSEMENTS
ANTIPRURIGINEUX	APPLAUDISSEUSES	ARCHITECTURERAI	ASSAISONNASSENT
ANTIPSYCHIATRES	APPOINTISSAIENT	ARCHITECTURERAS	ASSAISONNASSIEZ
ANTIPSYCHIATRIE	APPRECIABILITES	ARCHITECTUREREZ	ASSAISONNEMENTS
ANTIPSYCHOTIQUE	APPREHENDASSENT	ARCHITECTURIONS	ASSAISONNERIONS
ANTIRACHITIQUES	APPREHENDASSIEZ	ARGENTEUILLAISE	ASSARMENTASSENT
ANTIRATIONNELLE	APPREHENDERIONS	ARGUMENTASSIONS	ASSARMENTASSIEZ
ANTIRELIGIEUSES	APPRIVOISASSENT	ARGUMENTATRICES	ASSARMENTERIONS
ANTIREPUBLICAIN	APPRIVOISASSIEZ	ARGUMENTERAIENT	ASSASSINASSIONS
ANTIRETROVIRALE	APPRIVOISEMENTS	ARISTOCRATIQUES	ASSASSINERAIENT
ANTIRETROVIRAUX	APPRIVOISERIONS	ARISTOCRATISMES	ASSERMENTASSENT
ANTISCORBUTIQUE	APPROBATIVEMENT	ARISTOLOCHIACEE	ASSERMENTASSIEZ
ANTISOVIETIQUES	APPROFONDIRIONS	ARISTOPHANESQUE	ASSERMENTATIONS
ANTISPASMODIQUE	APPROFONDISSAIS	ARISTOTELICIENS	ASSERMENTERIONS
ANTISYMETRIQUES	APPROFONDISSAIT	ARITHMETICIENNE	ASSERVISSEMENTS
ANTITERRORISMES	APPROFONDISSANT	AROMATHERAPEUTE	ASSOMBRISSAIENT
ANTITERRORISTES	APPROFONDISSENT	AROMATISASSIONS	ASSOMBRISSEMENT
ANTITHYROIDIENS	APPROFONDISSIEZ	AROMATISERAIENT	ASSOMPTIONNISTE
ANTITUBERCULEUX	APPROFONDISSONS	ARRAISONNASSENT	ASSOUPISSEMENTS
ANTIVARIOLIQUES	APPROPRIASSIONS	ARRAISONNASSIEZ	ASSOUPLISSAIENT
ANTIVENERIENNES	APPROPRIERAIENT	ARRAISONNEMENTS	ASSOUPLISSANTES
APERCEPTIBILITE	APPROVISIONNAIS	ARRAISONNERIONS	ASSOUPLISSEMENT
APIGEONNASSIONS	APPROVISIONNAIT	ARRERAGEASSIONS	ASSOURDISSAIENT
APIGEONNERAIENT	APPROVISIONNANT	ARRONDISSEMENTS	ASSOURDISSANTES
APOLIPOPROTEINE	APPROVISIONNEES	ARSENIOSULFURES	ASSOURDISSEMENT
APOLLINARIENNES	APPROVISIONNENT	ARSONVALISATION	ASSOUVISSEMENTS


Mots de 15 lettres de ASSUJETTIRAIENT à AUTOPROPULSIONS - Page 4/61

ASSUJETTIRAIENT	AUTOANALYSAIENT	AUTODIDACTISMES	AUTOGRAPHIERAIT
ASSUJETTISSANTE	AUTOANALYSASSES	AUTODIRECTRICES	AUTOGRAPHIERENT
ASSUJETTISSANTS	AUTOANALYSERAIS	AUTODISCIPLINES	AUTOGRAPHIERIEZ
ASSUJETTISSIONS	AUTOANALYSERAIT	AUTODISSOLURENT	AUTOGRAPHIERONS
ASTACICULTRICES	AUTOANALYSERENT	AUTODISSOLUSSES	AUTOGRAPHIERONT
ASTREIGNISSIONS	AUTOANALYSERIEZ	AUTODISSOLUTION	AUTOLIMITATIONS
ASTRONAUTICIENS	AUTOANALYSERONS	AUTODISSOLVIONS	AUTOLUBRIFIANTE
ASTROPARTICULES	AUTOANALYSERONT	AUTODISSOUDRAIS	AUTOLUBRIFIANTS
ASTROPHYSICIENS	AUTOBIOGRAPHIES	AUTODISSOUDRAIT	AUTOMATICIENNES
ASYMPTOMATIQUES	AUTOCASTRATIONS	AUTODISSOUDRIEZ	AUTOMATIQUEMENT
ATHEROSCLEREUSE	AUTOCATALYTIQUE	AUTODISSOUDRONS	AUTOMATISASSENT
ATHEROSCLEROSES	AUTOCELEBRATION	AUTODISSOUDRONT	AUTOMATISASSIEZ
ATRACTYLIGENINE	AUTOCENSURAIENT	AUTOELEVATRICES	AUTOMATISATIONS
ATTENDRISSAIENT	AUTOCENSURASSES	AUTOENTREPRISES	AUTOMATISERIONS
ATTENDRISSANTES	AUTOCENSURERAIS	AUTOEVALUASSENT	AUTOMEDICATIONS
ATTENDRISSEMENT	AUTOCENSURERAIT	AUTOEVALUASSIEZ	AUTOMEDIQUAIENT
ATTENTIONNELLES	AUTOCENSURERENT	AUTOEVALUATIONS	AUTOMEDIQUASSES
ATTERRISSEMENTS	AUTOCENSURERIEZ	AUTOEVALUERIONS	AUTOMEDIQUERAIS
ATTIEDISSEMENTS	AUTOCENSURERONS	AUTOEXCITATEURS	AUTOMEDIQUERAIT
AUDIOCONFERENCE	AUTOCENSURERONT	AUTOEXCITATRICE	AUTOMEDIQUERENT
AUDIOFREQUENCES	AUTOCOMMUTATEUR	AUTOFECONDAIENT	AUTOMEDIQUERIEZ
AUDIOGUIDASSENT	AUTOCOMPLETIONS*	AUTOFECONDASSES	AUTOMEDIQUERONS
AUDIOGUIDASSIEZ	AUTOCONCURRENCE	AUTOFECONDATION	AUTOMEDIQUERONT
AUDIOGUIDERIONS	AUTOCONDUCTIONS	AUTOFECONDERAIS	AUTOMOBILISABLE
AUDIONUMERIQUES	AUTOCORRECTIONS	AUTOFECONDERAIT	AUTOMUTILASSENT
AUDITIONNASSENT	AUTOCORRECTIVES	AUTOFECONDERENT	AUTOMUTILASSIEZ
AUDITIONNASSIEZ	AUTOCRITIQUAMES	AUTOFECONDERIEZ	AUTOMUTILATIONS
AUDITIONNERIONS	AUTOCRITIQUASSE	AUTOFECONDERONS	AUTOMUTILERIONS
AUSTRALASIENNES	AUTOCRITIQUATES	AUTOFECONDERONT	AUTONETTOYANTES
AUSTRONESIENNES	AUTOCRITIQUERAI	AUTOFINANCAIENT	AUTONOMISASSENT
AUTHENTIFIAIENT	AUTOCRITIQUERAS	AUTOFINANCASSES	AUTONOMISASSIEZ
AUTHENTIFIASSES	AUTOCRITIQUEREZ	AUTOFINANCEMENT	AUTONOMISATIONS
AUTHENTIFIERAIS	AUTOCRITIQUIONS	AUTOFINANCERAIS	AUTONOMISERIONS
AUTHENTIFIERAIT	AUTODESTRUCTEUR	AUTOFINANCERAIT	AUTOPATROUILLES*
AUTHENTIFIERENT	AUTODESTRUCTIFS	AUTOFINANCERENT	AUTOPERSUASIONS
AUTHENTIFIERIEZ	AUTODESTRUCTION	AUTOFINANCERIEZ	AUTOPROCLAMAMES
AUTHENTIFIERONS	AUTODESTRUCTIVE	AUTOFINANCERONS	AUTOPROCLAMASSE
AUTHENTIFIERONT	AUTODETERMINAIS	AUTOFINANCERONT	AUTOPROCLAMATES
AUTHENTIQUAIENT	AUTODETERMINAIT	AUTOFLAGELLAMES	AUTOPROCLAMERAI
AUTHENTIQUASSES	AUTODETERMINANT	AUTOFLAGELLASSE	AUTOPROCLAMERAS
AUTHENTIQUEMENT	AUTODETERMINEES	AUTOFLAGELLATES	AUTOPROCLAMEREZ
AUTHENTIQUERAIS	AUTODETERMINENT	AUTOFLAGELLERAI	AUTOPROCLAMIONS
AUTHENTIQUERAIT	AUTODETERMINERA	AUTOFLAGELLERAS	AUTOPRODUCTIONS
AUTHENTIQUERENT	AUTODETERMINIEZ	AUTOFLAGELLEREZ	AUTOPRODUIRIONS
AUTHENTIQUERIEZ	AUTODETERMINONS	AUTOFLAGELLIONS	AUTOPRODUISIMES
AUTHENTIQUERONS	AUTODETRUIRIONS	AUTOFORMASSIONS*	AUTOPRODUISIONS
AUTHENTIQUERONT	AUTODETRUISIMES	AUTOFORMERAIENT*	AUTOPRODUISISSE
AUTOACCUSATEURS	AUTODETRUISIONS	AUTOGRAPHIAIENT	AUTOPRODUISITES
AUTOACCUSATIONS	AUTODETRUISISSE	AUTOGRAPHIASSES	AUTOPROPULSEURS
AUTOACCUSATRICE	AUTODETRUISITES	AUTOGRAPHIERAIS	AUTOPROPULSIONS


Mots de 15 lettres de AUTOPUBLICATION à BOURGEONNERIONS - Page 5/61

AUTOPUBLICATION	BALADODIFFUSION	BIDOUILLASSIONS	BLACKBOULERIONS
AUTOREALISATEUR*	BALKANISASSIONS	BIDOUILLERAIENT	BLACKLISTASSENT
AUTOREGULASSENT	BALKANISERAIENT	BIENVEILLAMMENT	BLACKLISTASSIEZ
AUTOREGULASSIEZ	BALNEOTHERAPIES	BIGOPHONASSIONS	BLACKLISTERIONS
AUTOREGULATEURS	BALUCHITHERIUMS	BIGOPHONERAIENT	BLANCHISSEMENTS
AUTOREGULATIONS	BANCARISASSIONS	BIHEBDOMADAIRES	BLASPHEMASSIONS
AUTOREGULATRICE	BANCARISERAIENT	BINAURICULAIRES	BLASPHEMATOIRES
AUTOREGULERIONS	BANQUEROUTIERES	BIOACCUMULATION	BLASPHEMATRICES
AUTOREPARATIONS	BANQUETTERAIENT	BIOASTRONOMIQUE	BLASPHEMERAIENT
AUTOREPLIQUAMES	BARAGOUINASSENT	BIOCLIMATOLOGIE	BLENNORRAGIQUES
AUTOREPLIQUASSE	BARAGOUINASSIEZ	BIOCOMBUSTIBLES	BLEPHAROPLASTIE
AUTOREPLIQUATES	BARAGOUINERIONS	BIODEGRADASSENT	BLEPHAROSPASMES
AUTOREPLIQUERAI	BARBARISASSIONS	BIODEGRADASSIEZ	BLISTERISASSENT
AUTOREPLIQUERAS	BARBARISERAIENT	BIODEGRADATIONS	BLISTERISASSIEZ
AUTOREPLIQUEREZ	BARBITUROMANIES	BIODEGRADERIONS	BLISTERISERIONS
AUTOREPLIQUIONS	BARBOUILLASSENT	BIOELECTRICITES	BOISBRIANNAISES*
AUTORITAIREMENT	BARBOUILLASSIEZ	BIOELECTRONIQUE	BONDERISASSIONS
AUTOSAISIRAIENT	BARBOUILLERIONS	BIOENERGETIQUES	BONDERISERAIENT
AUTOSAISISSIONS	BARGUIGNASSIONS	BIOGEOCHIMIQUES	BONIMENTASSIONS
AUTOSATISFAITES	BARGUIGNERAIENT	BIOGEOGRAPHIQUE	BONIMENTERAIENT
AUTOSUBSISTANCE	BAROTRAUMATIQUE	BIOGRAPHIASSENT	BORDELISASSIONS
AUTOSUFFISANCES	BAROTRAUMATISME	BIOGRAPHIASSIEZ	BORDELISERAIENT
AUTOSUFFISANTES	BARREAUDASSIONS*	BIOGRAPHIERIONS	BOTHRIOCEPHALES
AUTOSUGGESTIONS	BARREAUDERAIENT*	BIOLOGISASSIONS	BOUCHARDASSIONS
AUTOTRANSFUSION	BARRICADASSIONS	BIOLOGISERAIENT	BOUCHARDERAIENT
AUTOVACCINATION	BARRICADERAIENT	BIOLUMINESCENCE	BOUCHONNASSIONS
AVANTAGEASSIONS	BASOCELLULAIRES	BIOLUMINESCENTE	BOUCHONNERAIENT
AVANTAGEUSEMENT	BASSETERRIENNES	BIOLUMINESCENTS	BOUFFONNASSIONS
AVENTUREUSEMENT	BASTIONNASSIONS	BIOMETEOROLOGIE	BOUFFONNERAIENT
AVITAILLASSIONS	BASTIONNERAIENT	BIOMETRICIENNES	BOUGAINVILLIERS
AVITAILLERAIENT	BATHYPELAGIQUES	BIOMOLECULAIRES	BOUILLONNASSENT
AXIOMATISASSENT	BAUDELAIRIENNES	BIOPHYSICIENNES	BOUILLONNASSIEZ
AXIOMATISASSIEZ	BECHEVETASSIONS	BIOSOURCASSIONS*	BOUILLONNEMENTS
AXIOMATISATIONS	BECHEVETERAIENT	BIOSOURCERAIENT*	BOUILLONNERIONS
AXIOMATISERIONS	BECHEVETTERIONS	BIOSPELEOLOGIES	BOUILLOTASSIONS*
AZERBAIDJANAISE	BECQUETTERAIENT	BIOSTATISTICIEN	BOUILLOTERAIENT*
AZIDOTHYMIDINES	BEETHOVENIENNES	BIOSTATISTIQUES	BOUILLOTTASSENT
BACTERIOLOGIQUE	BENEFICIASSIONS	BIOSURVEILLANCE	BOUILLOTTASSIEZ
BACTERIOLOGISTE	BENEFICIERAIENT	BIOSYNTHETIQUES	BOUILLOTTERIONS
BACTERIOLYSINES	BENZODIAZEPINES	BIOTECHNOLOGIES	BOULANGEASSIONS
BADIGEONNASSENT	BETASTIMULANTES	BIOTYPOLOGIQUES	BOULEVERSASSENT
BADIGEONNASSIEZ	BIBERONNASSIONS	BIPOLARISATIONS	BOULEVERSASSIEZ
BADIGEONNERIONS	BIBERONNERAIENT	BISSAOGUINEENNE*	BOULEVERSEMENTS
BAFOUILLASSIONS	BIBLIOGRAPHIQUE	BISSAUGUINEENNE	BOULEVERSERIONS
BAFOUILLERAIENT	BIBLIOMETRIQUES	BISTOURNASSIONS	BOURDONNASSIONS
BAGUENAUDASSENT	BIBLIOPHILIQUES	BISTOURNERAIENT	BOURDONNERAIENT
BAGUENAUDASSIEZ	BIBLIOTHECAIRES	BIVOUAQUASSIONS	BOURGEONNASSENT
BAGUENAUDERIONS	BICULTURALISMES	BIVOUAQUERAIENT	BOURGEONNASSIEZ
BAILLONNASSIONS	BIDIMENSIONNELS	BLACKBOULASSENT	BOURGEONNEMENTS
BAILLONNERAIENT	BIDIRECTIONNELS	BLACKBOULASSIEZ	BOURGEONNERIONS


Mots de 15 lettres de BOURLINGUASSENT à CAPARACONNASSES - Page 6/61

BOURLINGUASSENT	BRILLANTINERENT	BUNKERISERAIENT	CALORIFICATIONS
BOURLINGUASSIEZ	BRILLANTINERIEZ	BUREAUCRATIQUES	CALORIFUGEAIENT
BOURLINGUERIONS	BRILLANTINERONS	BUREAUCRATISAIS	CALORIFUGEASSES
BOURRASSASSIONS	BRILLANTINERONT	BUREAUCRATISAIT	CALORIFUGERIONS
BOURRASSERAIENT	BRILLANTISSIMES	BUREAUCRATISANT	CALORIMETRIQUES
BOURRELLERAIENT	BRINGUEBALAIENT	BUREAUCRATISEES	CAMBRIOLASSIONS
BOURSICOTASSENT	BRINGUEBALANTES	BUREAUCRATISENT	CAMBRIOLERAIENT
BOURSICOTASSIEZ	BRINGUEBALASSES	BUREAUCRATISERA	CANADIANISAIENT
BOURSICOTERIONS	BRINGUEBALEMENT	BUREAUCRATISIEZ	CANADIANISASSES
BOURSOUFFLAIENT	BRINGUEBALERAIS	BUREAUCRATISMES	CANADIANISERAIS
BOURSOUFFLASSES	BRINGUEBALERAIT	BUREAUCRATISONS	CANADIANISERAIT
BOURSOUFFLEMENT	BRINGUEBALERENT	BUREAUTICIENNES	CANADIANISERENT
BOURSOUFFLERAIS	BRINGUEBALERIEZ	BYZANTINOLOGIES	CANADIANISERIEZ
BOURSOUFFLERAIT	BRINGUEBALERONS	BYZANTINOLOGUES	CANADIANISERONS
BOURSOUFFLERENT	BRINGUEBALERONT	CABLOOPERATEURS*	CANADIANISERONT
BOURSOUFFLERIEZ	BRINQUEBALAIENT	CACHETONNASSENT	CANCERISASSIONS
BOURSOUFFLERONS	BRINQUEBALANTES	CACHETONNASSIEZ	CANCERISERAIENT
BOURSOUFFLERONT	BRINQUEBALASSES	CACHETONNERIONS	CANCEROLOGIQUES
BOURSOUFLASSENT	BRINQUEBALEMENT	CADENASSASSIONS	CANDIDATASSIONS
BOURSOUFLASSIEZ	BRINQUEBALERAIS	CADENASSERAIENT	CANDIDATERAIENT
BOURSOUFLEMENTS	BRINQUEBALERAIT	CAFOUILLASSIONS	CANNIBALISAIENT
BOURSOUFLERIONS	BRINQUEBALERENT	CAFOUILLERAIENT	CANNIBALISASSES
BOUSTIFAILLAMES	BRINQUEBALERIEZ	CAILLASSASSIONS	CANNIBALISATION
BOUSTIFAILLASSE	BRINQUEBALERONS	CAILLASSERAIENT	CANNIBALISERAIS
BOUSTIFAILLATES	BRINQUEBALERONT	CAILLEBOTTAIENT	CANNIBALISERAIT
BOUSTIFAILLERAI	BRIQUETTERAIENT	CAILLEBOTTASSES	CANNIBALISERENT
BOUSTIFAILLERAS	BRONCHIECTASIES	CAILLEBOTTERAIS	CANNIBALISERIEZ
BOUSTIFAILLEREZ	BRONCHOGRAPHIES	CAILLEBOTTERAIT	CANNIBALISERONS
BOUSTIFAILLIONS	BROUILLARDEUSES	CAILLEBOTTERENT	CANNIBALISERONT
BRACHYCEPHALIES	BROUILLASSERAIT	CAILLEBOTTERIEZ	CANTONALISAIENT
BRANCARDASSIONS	BROUILLONNAIENT	CAILLEBOTTERONS	CANTONALISASSES
BRANCARDERAIENT	BROUILLONNASSES	CAILLEBOTTERONT	CANTONALISATION
BRANDEBOURGEOIS	BROUILLONNERAIS	CAILLETTERAIENT	CANTONALISERAIS
BRANDILLASSIONS	BROUILLONNERAIT	CAILLOUTASSIONS	CANTONALISERAIT
BRANDILLERAIENT	BROUILLONNERENT	CAILLOUTERAIENT	CANTONALISERENT
BRATISLAVIENNES	BROUILLONNERIEZ	CALAMISTRASSENT	CANTONALISERIEZ
BRAZZAVILLOISES	BROUILLONNERONS	CALAMISTRASSIEZ	CANTONALISERONS
BREDOUILLASSENT	BROUILLONNERONT	CALAMISTRERIONS	CANTONALISERONT
BREDOUILLASSIEZ	BROUSSAILLEUSES	CALEIDOSCOPIQUE	CAOUTCHOUTAIENT
BREDOUILLEMENTS	BRUTALISASSIONS	CALFEUTRASSIONS	CAOUTCHOUTASSES
BREDOUILLERIONS	BRUTALISERAIENT	CALFEUTRERAIENT	CAOUTCHOUTERAIS
BRETAILLASSIONS	BUCCORHODANIENS	CALLIGRAPHIAMES	CAOUTCHOUTERAIT
BRETAILLERAIENT	BUCHERONNASSENT	CALLIGRAPHIASSE	CAOUTCHOUTERENT
BRETTELLERAIENT	BUCHERONNASSIEZ	CALLIGRAPHIATES	CAOUTCHOUTERIEZ
BRILLANTASSIONS	BUCHERONNERIONS	CALLIGRAPHIERAI	CAOUTCHOUTERONS
BRILLANTERAIENT	BUDGETISASSIONS	CALLIGRAPHIERAS	CAOUTCHOUTERONT
BRILLANTINAIENT	BUDGETISERAIENT	CALLIGRAPHIEREZ	CAOUTCHOUTEUSES
BRILLANTINASSES	BUISSONNASSIONS	CALLIGRAPHIIONS	CAOUTCHOUTIERES
BRILLANTINERAIS	BUISSONNERAIENT	CALLIGRAPHIQUES	CAPARACONNAIENT
BRILLANTINERAIT	BUNKERISASSIONS	CALOMNIEUSEMENT	CAPARACONNASSES


Mots de 15 lettres de CAPARACONNERAIS à CHAMBARDERAIENT - Page 7/61

CAPARACONNERAIS	CARAMBOUILLIONS	CARTOUCHERAIENT	CAUCHEMARDERAIT
CAPARACONNERAIT	CARAMELISASSENT	CARYOPHYLLACEES	CAUCHEMARDERENT
CAPARACONNERENT	CARAMELISASSIEZ	CASSETTOTHEQUES	CAUCHEMARDERIEZ
CAPARACONNERIEZ	CARAMELISATIONS	CASTELPERRONIEN	CAUCHEMARDERONS
CAPARACONNERONS	CARAMELISERIONS	CASTELROUSSINES	CAUCHEMARDERONT
CAPARACONNERONT	CARBHEMOGLOBINE	CASTILLONNAISES	CAUCHEMARDESQUE
CAPILLAROSCOPIE	CARBONATASSIONS	CASTRAMETATIONS	CAUCHEMARDEUSES
CAPILLICULTEURS	CARBONATERAIENT	CATADIOPTRIQUES	CAUCHEMARESQUES
CAPILLICULTRICE	CARBONISASSIONS	CATALOGUASSIONS	CAUSTIFICATIONS
CAPILLICULTURES	CARBONISERAIENT	CATALOGUERAIENT	CAUTERISASSIONS
CAPILLOTRACTEES	CARBONITRURAMES	CATAPULTASSIONS	CAUTERISERAIENT
CAPITALISASSENT	CARBONITRURASSE	CATAPULTERAIENT	CAUTIONNASSIONS
CAPITALISASSIEZ	CARBONITRURATES	CATASTROPHAIENT	CAUTIONNERAIENT
CAPITALISATIONS	CARBONITRURERAI	CATASTROPHASSES	CAVALCADASSIONS
CAPITALISERIONS	CARBONITRURERAS	CATASTROPHERAIS	CAVALCADERAIENT
CAPITALISTIQUES	CARBONITRUREREZ	CATASTROPHERAIT	CENESTHOPATHIES
CAPITONNASSIONS	CARBONITRURIONS	CATASTROPHERENT	CENTRAFRICAINES
CAPITONNERAIENT	CARCAILLASSIONS	CATASTROPHERIEZ	CENTRALISASSENT
CAPITULAIREMENT	CARCAILLERAIENT	CATASTROPHERONS	CENTRALISASSIEZ
CAPORALISASSENT	CARCASSONNAISES	CATASTROPHERONT	CENTRALISATEURS
CAPORALISASSIEZ	CARCINOLOGIQUES	CATASTROPHIQUES	CENTRALISATIONS
CAPORALISERIONS	CARCINOMATEUSES	CATASTROPHISMES	CENTRALISATRICE
CAPRICIEUSEMENT	CARDIOMYOPATHIE	CATASTROPHISTES	CENTRALISERIONS
CAPRIMULGIFORME	CARDIOTHYREOSES	CATECHISASSIONS	CENTRAMERICAINE
CAPUCHONNASSENT	CARDIOTRAININGS	CATECHISERAIENT	CENTRAMERICAINS
CAPUCHONNASSIEZ	CARICATURASSENT	CATEGORIQUEMENT	CENTRIFUGATIONS
CAPUCHONNERIONS	CARICATURASSIEZ	CATEGORISASSENT	CENTRIFUGEAIENT
CARABISTOUILLES	CARICATURERIONS	CATEGORISASSIEZ	CENTRIFUGEASSES
CARACTERISAIENT	CARILLONNASSENT	CATEGORISATIONS	CENTRIFUGERIONS
CARACTERISASSES	CARILLONNASSIEZ	CATEGORISERIONS	CEPHALOSPORINES
CARACTERISATION	CARILLONNEMENTS	CATHETERISAIENT	CERCOPITHECIDES
CARACTERISERAIS	CARILLONNERIONS	CATHETERISASSES	CEREALICULTEURS*
CARACTERISERAIT	CAROLOMACERIENS	CATHETERISERAIS	CEREALICULTRICE*
CARACTERISERENT	CAROLOREGIENNES	CATHETERISERAIT	CEREALICULTURES
CARACTERISERIEZ	CARPENTRASSIENS	CATHETERISERENT	CEREBROSPINALES
CARACTERISERONS	CARTELLISASSENT	CATHETERISERIEZ	CEREMONIALISMES
CARACTERISERONT	CARTELLISASSIEZ	CATHETERISERONS	CERTIFICATRICES
CARACTERISTIQUE	CARTELLISATIONS	CATHETERISERONT	CERVICARTHROSES
CARACTEROLOGIES	CARTELLISERIONS	CATHOLICISAIENT	CESALPINIOIDEES
CARAMBOLASSIONS	CARTILAGINEUSES	CATHOLICISANTES	CHALCOGRAPHIQUE
CARAMBOLERAIENT	CARTOGRAPHIAMES	CATHOLICISASSES	CHALCOLITHIQUES
CARAMBOUILLAGES	CARTOGRAPHIASSE	CATHOLICISERAIS	CHALENGEASSIONS*
CARAMBOUILLAMES	CARTOGRAPHIATES	CATHOLICISERAIT	CHALEUREUSEMENT
CARAMBOUILLASSE	CARTOGRAPHIERAI	CATHOLICISERENT	CHALLENGEASSENT
CARAMBOUILLATES	CARTOGRAPHIERAS	CATHOLICISERIEZ	CHALLENGEASSIEZ
CARAMBOUILLERAI	CARTOGRAPHIEREZ	CATHOLICISERONS	CHALLENGERAIENT
CARAMBOUILLERAS	CARTOGRAPHIIONS	CATHOLICISERONT	CHAMAILLASSIONS
CARAMBOUILLEREZ	CARTOGRAPHIQUES	CAUCHEMARDAIENT	CHAMAILLERAIENT
CARAMBOUILLEURS	CARTOMANCIENNES	CAUCHEMARDASSES	CHAMBARDASSIONS
CARAMBOUILLEUSE	CARTOUCHASSIONS	CAUCHEMARDERAIS	CHAMBARDERAIENT


Mots de 15 lettres de CHAMBOULASSIONS à CIRCONVOLUTIVES - Page 8/61

CHAMBOULASSIONS	CHARPENTERAIENT	CHLOROFORMERONT	CHRONOMETRAIENT
CHAMBOULERAIENT	CHARRIOTASSIONS	CHLOROMETRIQUES	CHRONOMETRASSES
CHAMBRANLASSENT	CHARRIOTERAIENT	CHLOROPHYLLIENS	CHRONOMETRERAIS
CHAMBRANLASSIEZ	CHARTERISASSENT	CHLORPROMAZINES	CHRONOMETRERAIT
CHAMBRANLERIONS	CHARTERISASSIEZ	CHOLECALCIFEROL	CHRONOMETRERENT
CHAMPAGNISAIENT	CHARTERISERIONS	CHOLECYSTOTOMIE	CHRONOMETRERIEZ
CHAMPAGNISASSES	CHATAIGNASSIONS	CHOLESTEROLEMIE	CHRONOMETRERONS
CHAMPAGNISATION	CHATAIGNERAIENT	CHOLINESTERASES	CHRONOMETRERONT
CHAMPAGNISERAIS	CHATELLERAUDAIS	CHONDRICHTHYENS	CHRONOMETREUSES
CHAMPAGNISERAIT	CHATELPERRONIEN	CHONDROSARCOMES	CHRONOMETRIQUES
CHAMPAGNISERENT	CHATOUILLASSENT	CHOREGRAPHIAMES	CHRYSANTHEMIQUE
CHAMPAGNISERIEZ	CHATOUILLASSIEZ	CHOREGRAPHIASSE	CHRYSELEPHANTIN
CHAMPAGNISERONS	CHATOUILLEMENTS	CHOREGRAPHIATES	CHRYSOBALANACEE*
CHAMPAGNISERONT	CHATOUILLERIONS	CHOREGRAPHIERAI	CHRYSOMONADALES
CHAMPARDENNAISE	CHEMORECEPTEURS	CHOREGRAPHIERAS	CHRYSOTHERAPIES
CHAMPIGNONNEURS	CHEMORECEPTRICE	CHOREGRAPHIEREZ	CHURRIGUERESQUE
CHAMPIGNONNEUSE	CHEVAUCHASSIONS	CHOREGRAPHIIONS	CICATRISASSIONS
CHAMPIGNONNIERE	CHEVAUCHERAIENT	CHOREGRAPHIQUES	CICATRISERAIENT
CHAMPIGNONNISTE	CHEVRETTASSIONS	CHOROGRAPHIQUES	CINEMATOGRAPHES
CHAMPLEVASSIONS	CHEVRETTERAIENT	CHOUCHOUTASSENT	CINEMATOGRAPHIA
CHAMPLEVERAIENT	CHEVRONNASSIONS	CHOUCHOUTASSIEZ	CINEMATOGRAPHIE
CHANCELLERAIENT	CHEVRONNERAIENT	CHOUCHOUTERIONS	CINETHEODOLITES
CHANFREINASSENT	CHICOUTIMIENNES	CHREMATISTIQUES	CINQUANTENAIRES
CHANFREINASSIEZ	CHIFFONNASSIONS	CHRISTIANISAMES	CIRCONFERENTIEL
CHANFREINERIONS	CHIFFONNERAIENT	CHRISTIANISASSE	CIRCONLOCUTIONS
CHANSONNASSIONS	CHIMIORECEPTEUR	CHRISTIANISATES	CIRCONSCRIPTION
CHANSONNERAIENT	CHIMIOSYNTHESES	CHRISTIANISERAI	CIRCONSCRIRIONS
CHANTONNASSIONS	CHIMIOTACTISMES	CHRISTIANISERAS	CIRCONSCRIVIMES
CHANTONNERAIENT	CHIMIOTHERAPIES	CHRISTIANISEREZ	CIRCONSCRIVIONS
CHANTOURNASSENT	CHIMIOTROPISMES	CHRISTIANISIONS	CIRCONSCRIVISSE
CHANTOURNASSIEZ	CHIQUETTERAIENT*	CHRISTOLOGIQUES	CIRCONSCRIVITES
CHANTOURNEMENTS	CHIROGRAPHAIRES	CHRISTOPHIENNES	CIRCONSPECTIONS
CHANTOURNERIONS	CHIROGRAPHIAMES	CHROMATIQUEMENT	CIRCONSTANCIAIS
CHAPEAUTASSIONS	CHIROGRAPHIASSE	CHROMATISASSENT	CIRCONSTANCIAIT
CHAPEAUTERAIENT	CHIROGRAPHIATES	CHROMATISASSIEZ	CIRCONSTANCIANT
CHAPERONNASSENT	CHIROGRAPHIERAI	CHROMATISERIONS	CIRCONSTANCIEES
CHAPERONNASSIEZ	CHIROGRAPHIERAS	CHROMATOGRAMMES	CIRCONSTANCIELS
CHAPERONNERIONS	CHIROGRAPHIEREZ	CHROMATOGRAPHES	CIRCONSTANCIENT
CHAPTALISASSENT	CHIROGRAPHIIONS	CHROMATOGRAPHIE	CIRCONSTANCIERA
CHAPTALISASSIEZ	CHIROMANCIENNES	CHROMODYNAMIQUE	CIRCONSTANCIIEZ
CHAPTALISATIONS	CHIROPRACTRICES	CHROMOPROTEINES	CIRCONSTANCIONS
CHAPTALISERIONS	CHIROPRATICIENS	CHROMOSPHERIQUE	CIRCONVALLATION
CHARADRIIFORMES	CHLORAMPHENICOL	CHROMOTHERAPIES	CIRCONVIENDRAIS
CHARBONNASSIONS	CHLOROFORMAIENT	CHRONICISASSENT	CIRCONVIENDRAIT
CHARBONNERAIENT	CHLOROFORMASSES	CHRONICISASSIEZ	CIRCONVIENDRIEZ
CHARDONNASSIONS	CHLOROFORMERAIS	CHRONICISERIONS	CIRCONVIENDRONS
CHARDONNERAIENT	CHLOROFORMERAIT	CHRONIQUASSIONS	CIRCONVIENDRONT
CHARLATANESQUES	CHLOROFORMERENT	CHRONIQUERAIENT	CIRCONVINSSIONS
CHARLEVOISIENNE	CHLOROFORMERIEZ	CHRONOBIOLOGIES	CIRCONVOLUTIONS
CHARPENTASSIONS	CHLOROFORMERONS	CHRONOGRAPHIQUE	CIRCONVOLUTIVES


Mots de 15 lettres de CIRCULARISAIENT à COMPLEMENTAIENT - Page 9/61

CIRCULARISAIENT	CLOCHARDISERAIS	COLLECTIVISASSE	COMMUNALISASSES
CIRCULARISASSES	CLOCHARDISERAIT	COLLECTIVISATES	COMMUNALISATION
CIRCULARISERAIS	CLOCHARDISERENT	COLLECTIVISERAI	COMMUNALISERAIS
CIRCULARISERAIT	CLOCHARDISERIEZ	COLLECTIVISERAS	COMMUNALISERAIT
CIRCULARISERENT	CLOCHARDISERONS	COLLECTIVISEREZ	COMMUNALISERENT
CIRCULARISERIEZ	CLOCHARDISERONT	COLLECTIVISIONS	COMMUNALISERIEZ
CIRCULARISERONS	CLOISONNASSIONS	COLLETAILLAIENT	COMMUNALISERONS
CIRCULARISERONT	CLOISONNERAIENT	COLLETAILLASSES	COMMUNALISERONT
CIRCUMSTELLAIRE	COARTICULATIONS	COLLETAILLERAIS	COMMUNAUTARISAI
CIRCUMTERRESTRE	COBALTOTHERAPIE	COLLETAILLERAIT	COMMUNAUTARISAS
CISJORDANIENNES	COBELLIGERANTES	COLLETAILLERENT	COMMUNAUTARISAT
CIVILISATIONNEL	COCCOLITHOPHORE	COLLETAILLERIEZ	COMMUNAUTARISEE
CLAIRONNASSIONS	COCCOLITOPHORES	COLLETAILLERONS	COMMUNAUTARISER
CLAIRONNERAIENT	COCHINCHINOISES	COLLETAILLERONT	COMMUNAUTARISES
CLAIRSEMASSIONS	COCONTRACTANTES	COLOCALISATIONS	COMMUNAUTARISEZ
CLAIRSEMERAIENT	CODEMANDERESSES	COLOMBICULTURES	COMMUNAUTARISME
CLANDESTINEMENT	CODETIENDRAIENT	COLORIMETRIQUES	COMMUNAUTARISTE
CLAQUEMURASSENT	CODEVELOPPEMENT	COMBUSTIBILITES	COMMUNICABILITE
CLAQUEMURASSIEZ	CODIRIGEASSIONS	COMMANDITASSENT	COMMUNICATRICES
CLAQUEMURERIONS	COELIOCHIRURGIE	COMMANDITASSIEZ	COMMUNIQUASSENT
CLAQUETTERAIENT	COELIOSCOPIQUES	COMMANDITERIONS	COMMUNIQUASSIEZ
CLARIFICATRICES	COFINANCASSIONS	COMMEMORASSIONS	COMMUNIQUERIONS
CLASSIFIASSIONS	COFINANCERAIENT	COMMEMORERAIENT	COMPAGNONNIQUES
CLASSIFICATEURS	COGESTIONNAIRES	COMMERCIALEMENT	COMPARAISSAIENT
CLASSIFICATIONS	COGNOSCIBILITES	COMMERCIALISAIS	COMPARAITRAIENT
CLASSIFICATOIRE	COLLABORASSIONS	COMMERCIALISAIT	COMPARATIVEMENT
CLASSIFICATRICE	COLLABORATRICES	COMMERCIALISANT	COMPARTIMENTAGE
CLASSIFIERAIENT	COLLABORERAIENT	COMMERCIALISEES	COMPARTIMENTAIS
CLAUDIQUASSIONS	COLLATERALEMENT	COMMERCIALISENT	COMPARTIMENTAIT
CLAUDIQUERAIENT	COLLATIONNAIENT	COMMERCIALISERA	COMPARTIMENTANT
CLAUSTROPHOBIES	COLLATIONNASSES	COMMERCIALISIEZ	COMPARTIMENTEES
CLERICALISAIENT	COLLATIONNEMENT	COMMERCIALISONS	COMPARTIMENTENT
CLERICALISASSES	COLLATIONNERAIS	COMMISSIONNAIRE	COMPARTIMENTERA
CLERICALISERAIS	COLLATIONNERAIT	COMMISSIONNAMES	COMPARTIMENTIEZ
CLERICALISERAIT	COLLATIONNERENT	COMMISSIONNASSE	COMPARTIMENTONS
CLERICALISERENT	COLLATIONNERIEZ	COMMISSIONNATES	COMPASSIONNELLE
CLERICALISERIEZ	COLLATIONNERONS	COMMISSIONNERAI	COMPENETRASSENT
CLERICALISERONS	COLLATIONNERONT	COMMISSIONNERAS	COMPENETRASSIEZ
CLERICALISERONT	COLLECTIONNAMES	COMMISSIONNEREZ	COMPENETRATIONS
CLIMATISASSIONS	COLLECTIONNASSE	COMMISSIONNIONS	COMPENETRERIONS
CLIMATISERAIENT	COLLECTIONNATES	COMMISSUROTOMIE	COMPETITIONNAIS
CLIMATOLOGIQUES	COLLECTIONNERAI	COMMOTIONNAIENT	COMPETITIONNAIT
CLIMATOLOGISTES	COLLECTIONNERAS	COMMOTIONNASSES	COMPETITIONNANT
CLIMATOTHERAPIE	COLLECTIONNEREZ	COMMOTIONNERAIS	COMPETITIONNENT
CLINORHOMBIQUES	COLLECTIONNEURS	COMMOTIONNERAIT	COMPETITIONNERA
CLIQUETTERAIENT	COLLECTIONNEUSE	COMMOTIONNERENT	COMPETITIONNIEZ
CLITORIDECTOMIE	COLLECTIONNIONS	COMMOTIONNERIEZ	COMPETITIONNONS
CLOCHARDISAIENT	COLLECTIONNISME	COMMOTIONNERONS	COMPLANTASSIONS
CLOCHARDISASSES	COLLECTIONNITES	COMMOTIONNERONT	COMPLANTERAIENT
CLOCHARDISATION	COLLECTIVISAMES	COMMUNALISAIENT	COMPLEMENTAIENT


Mots de 15 lettres de COMPLEMENTAIRES à CONSTRUCTIVISME - Page 10/61

COMPLEMENTAIRES	COMPULSIONNELLE	CONDESCENDRIONS	CONGESTIONNIONS
COMPLEMENTARITE	CONCATENASSIONS	CONDITIONNAIENT	CONGLOMERASSENT
COMPLEMENTASSES	CONCATENERAIENT	CONDITIONNALITE	CONGLOMERASSIEZ
COMPLEMENTATION	CONCELEBRASSENT	CONDITIONNASSES	CONGLOMERATIONS
COMPLEMENTERAIS	CONCELEBRASSIEZ	CONDITIONNELLES	CONGLOMERERIONS
COMPLEMENTERAIT	CONCELEBRATIONS	CONDITIONNEMENT	CONGLUTINASSENT
COMPLEMENTERENT	CONCELEBRERIONS	CONDITIONNERAIS	CONGLUTINASSIEZ
COMPLEMENTERIEZ	CONCENTRASSIONS	CONDITIONNERAIT	CONGLUTINATIONS
COMPLEMENTERONS	CONCENTRERAIENT	CONDITIONNERENT	CONGLUTINATIVES
COMPLEMENTERONT	CONCEPTUALISAIS	CONDITIONNERIEZ	CONGLUTINERIONS
COMPLEXIFIAIENT	CONCEPTUALISAIT	CONDITIONNERONS	CONGRATULASSENT
COMPLEXIFIASSES	CONCEPTUALISANT	CONDITIONNERONT	CONGRATULASSIEZ
COMPLEXIFIERAIS	CONCEPTUALISEES	CONDITIONNEUSES	CONGRATULATIONS
COMPLEXIFIERAIT	CONCEPTUALISENT	CONDUCTIBILITES	CONGRATULERIONS
COMPLEXIFIERENT	CONCEPTUALISERA	CONDUCTIMETRIES	CONJECTURASSENT
COMPLEXIFIERIEZ	CONCEPTUALISIEZ	CONFECTIONNAMES	CONJECTURASSIEZ
COMPLEXIFIERONS	CONCEPTUALISMES	CONFECTIONNASSE	CONJECTURERIONS
COMPLEXIFIERONT	CONCEPTUALISONS	CONFECTIONNATES	CONJOIGNISSIONS
COMPLIMENTAIENT	CONCEPTUALISTES	CONFECTIONNERAI	CONJONCTURELLES
COMPLIMENTASSES	CONCESSIONNAIRE	CONFECTIONNERAS	CONJONCTURISTES
COMPLIMENTERAIS	CONCHYLICULTEUR	CONFECTIONNEREZ	CONNECTABILITES
COMPLIMENTERAIT	CONCHYLICULTURE	CONFECTIONNEURS	CONNECTICIENNES
COMPLIMENTERENT	CONCHYLIOLOGIES	CONFECTIONNEUSE	CONNEXIONNISMES
COMPLIMENTERIEZ	CONCITOYENNETES	CONFECTIONNIONS	CONNEXIONNISTES
COMPLIMENTERONS	CONCRETIONNAMES	CONFEDERALISMES	CONSCIENCIEUSES
COMPLIMENTERONT	CONCRETIONNASSE	CONFEDERALISTES	CONSCIENTISAMES
COMPLIMENTEUSES	CONCRETIONNATES	CONFEDERASSIONS	CONSCIENTISASSE
COMPLIQUASSIONS	CONCRETIONNERAI	CONFEDERERAIENT	CONSCIENTISATES
COMPLIQUERAIENT	CONCRETIONNERAS	CONFESSIONNELLE	CONSCIENTISERAI
COMPONENTIELLES	CONCRETIONNEREZ	CONFIDENTIALITE	CONSCIENTISERAS
COMPORTEMENTALE	CONCRETIONNIONS	CONFIDENTIELLES	CONSCIENTISEREZ
COMPORTEMENTAUX	CONCRETISASSENT	CONFIGURASSIONS	CONSCIENTISIONS
COMPOUNDASSIONS	CONCRETISASSIEZ	CONFIGURERAIENT	CONSECUTIVEMENT
COMPOUNDERAIENT	CONCRETISATIONS	CONFISQUASSIONS	CONSEILLASSIONS
COMPREHENSIBLES	CONCRETISERIONS	CONFISQUERAIENT	CONSEILLERAIENT
COMPRESSASSIONS	CONCURRENCAIENT	CONFLICTUALITES	CONSIDERASSIONS
COMPRESSERAIENT	CONCURRENCASSES	CONFORMATIONNEL	CONSIDERERAIENT
COMPRESSIBILITE	CONCURRENCERAIS	CONFORTABLEMENT	CONSOLIDASSIONS
COMPROMETTAIENT	CONCURRENCERAIT	CONFRATERNELLES	CONSOLIDERAIENT
COMPROMETTANTES	CONCURRENCERENT	CONFRONTASSIONS	CONSOMMABILITES
COMPROMETTRIONS	CONCURRENCERIEZ	CONFRONTERAIENT	CONSTANTINIENNE
COMPROMISSOIRES	CONCURRENCERONS	CONFUSIONNELLES	CONSTANTINOISES
COMPTABILISABLE	CONCURRENCERONT	CONFUSIONNISMES	CONSTELLASSIONS
COMPTABILISAMES	CONCURRENTIELLE	CONGENITALEMENT	CONSTELLERAIENT
COMPTABILISASSE	CONCUSSIONNAIRE	CONGESTIONNAMES	CONSTERNASSIONS
COMPTABILISATES	CONDESCENDAIENT	CONGESTIONNASSE	CONSTERNERAIENT
COMPTABILISERAI	CONDESCENDANCES	CONGESTIONNATES	CONSTITUASSIONS
COMPTABILISERAS	CONDESCENDANTES	CONGESTIONNERAI	CONSTITUERAIENT
COMPTABILISEREZ	CONDESCENDIRENT	CONGESTIONNERAS	CONSTITUTIONNEL
COMPTABILISIONS	CONDESCENDISSES	CONGESTIONNEREZ	CONSTRUCTIVISME


Mots de 15 lettres de CONSTRUCTIVISTE à CONTREPASSERONT - Page 11/61

CONSTRUCTIVISTE	CONTINGENTERONS	CONTRATTAQUATES*	CONTRECOLLERAIT
CONSTRUISISSENT	CONTINGENTERONT	CONTRATTAQUERAI*	CONTRECOLLERENT
CONSTRUISISSIEZ	CONTINUELLEMENT	CONTRATTAQUERAS*	CONTRECOLLERIEZ
CONSUBSTANTIELS	CONTORSIONNAMES	CONTRATTAQUEREZ*	CONTRECOLLERONS
CONTACTOLOGISTE	CONTORSIONNASSE	CONTRATTAQUIONS*	CONTRECOLLERONT
CONTAGIONNAIENT	CONTORSIONNATES	CONTREBALANCAIS	CONTREFACTRICES
CONTAGIONNASSES	CONTORSIONNERAI	CONTREBALANCAIT	CONTREFAISAIENT
CONTAGIONNERAIS	CONTORSIONNERAS	CONTREBALANCANT	CONTREFAISANTES
CONTAGIONNERAIT	CONTORSIONNEREZ	CONTREBALANCEES	CONTREFICHAIENT
CONTAGIONNERENT	CONTORSIONNIONS	CONTREBALANCENT	CONTREFICHASSES
CONTAGIONNERIEZ	CONTORSIONNISTE	CONTREBALANCERA	CONTREFICHERAIS
CONTAGIONNERONS	CONTOURNASSIONS	CONTREBALANCIEZ	CONTREFICHERAIT
CONTAGIONNERONT	CONTOURNERAIENT	CONTREBALANCONS	CONTREFICHERENT
CONTAINERISAMES	CONTRACTASSIONS	CONTREBANDIERES	CONTREFICHERIEZ
CONTAINERISASSE	CONTRACTERAIENT	CONTREBASSISTES	CONTREFICHERONS
CONTAINERISATES	CONTRACTUALISAI	CONTREBATTAIENT	CONTREFICHERONT
CONTAINERISERAI	CONTRACTUALISAS	CONTREBATTERIES	CONTREFOUTAIENT
CONTAINERISERAS	CONTRACTUALISAT	CONTREBATTIRENT	CONTREFOUTIRENT
CONTAINERISEREZ	CONTRACTUALISEE	CONTREBATTISSES	CONTREFOUTISSES
CONTAINERISIONS	CONTRACTUALISER	CONTREBATTRIONS	CONTREFOUTRIONS
CONTAMINASSIONS	CONTRACTUALISES	CONTREBOUTAIENT	CONTREMAITRESSE
CONTAMINATRICES	CONTRACTUALISEZ	CONTREBOUTASSES	CONTREMANDAIENT
CONTAMINERAIENT	CONTRACTUALITES	CONTREBOUTERAIS	CONTREMANDASSES
CONTEMPLASSIONS	CONTRACTURAIENT	CONTREBOUTERAIT	CONTREMANDERAIS
CONTEMPLATRICES	CONTRACTURASSES	CONTREBOUTERENT	CONTREMANDERAIT
CONTEMPLERAIENT	CONTRACTURERAIS	CONTREBOUTERIEZ	CONTREMANDERENT
CONTEMPORANEITE	CONTRACTURERAIT	CONTREBOUTERONS	CONTREMANDERIEZ
CONTENEURISAMES	CONTRACTURERENT	CONTREBOUTERONT	CONTREMANDERONS
CONTENEURISASSE	CONTRACTURERIEZ	CONTREBRAQUAMES	CONTREMANDERONT
CONTENEURISATES	CONTRACTURERONS	CONTREBRAQUASSE	CONTREMANIFESTA*
CONTENEURISERAI	CONTRACTURERONT	CONTREBRAQUATES	CONTREMANIFESTE*
CONTENEURISERAS	CONTRACYCLIQUES	CONTREBRAQUERAI	CONTREMARQUAMES
CONTENEURISEREZ	CONTRADICTOIRES	CONTREBRAQUERAS	CONTREMARQUASSE
CONTENEURISIONS	CONTRADICTRICES	CONTREBRAQUEREZ	CONTREMARQUATES
CONTEXTUALISAIS	CONTRAIGNISSENT	CONTREBRAQUIONS	CONTREMARQUERAI
CONTEXTUALISAIT	CONTRAIGNISSIEZ	CONTREBUTASSENT	CONTREMARQUERAS
CONTEXTUALISANT	CONTRAINDRAIENT	CONTREBUTASSIEZ	CONTREMARQUEREZ
CONTEXTUALISEES	CONTRAPONTIQUES	CONTREBUTEMENTS	CONTREMARQUIONS
CONTEXTUALISENT	CONTRAPONTISTES	CONTREBUTERIONS	CONTREMPREINTES*
CONTEXTUALISERA	CONTRAPOSITIONS	CONTRECARRAIENT	CONTREPAREMENTS
CONTEXTUALISIEZ	CONTRAPUNTIQUES	CONTRECARRASSES	CONTREPARTISTES
CONTEXTUALISONS	CONTRAPUNTISTES	CONTRECARRERAIS	CONTREPASSAIENT*
CONTINENTALITES	CONTRARIASSIONS	CONTRECARRERAIT	CONTREPASSASSES*
CONTINGENTAIENT	CONTRARIERAIENT	CONTRECARRERENT	CONTREPASSATION*
CONTINGENTASSES	CONTRAROTATIVES	CONTRECARRERIEZ	CONTREPASSERAIS*
CONTINGENTEMENT	CONTRASSURANCES*	CONTRECARRERONS	CONTREPASSERAIT*
CONTINGENTERAIS	CONTRASTASSIONS	CONTRECARRERONT	CONTREPASSERENT*
CONTINGENTERAIT	CONTRASTERAIENT	CONTRECOLLAIENT	CONTREPASSERIEZ*
CONTINGENTERENT	CONTRATTAQUAMES*	CONTRECOLLASSES	CONTREPASSERONS*
CONTINGENTERIEZ	CONTRATTAQUASSE*	CONTRECOLLERAIS	CONTREPASSERONT*


Mots de 15 lettres de CONTREPAULETTES à COURTELINESQUES - Page 12/61

CONTREPAULETTES*	CONTRINDIQUAMES*	CONVIVIALISATES	CORRESPONDRIONS
CONTREPETTERIES	CONTRINDIQUASSE*	CONVIVIALISERAI	CORROBORASSIONS
CONTREPLAQUAMES	CONTRINDIQUATES*	CONVIVIALISERAS	CORROBORERAIENT
CONTREPLAQUASSE	CONTRINDIQUERAI*	CONVIVIALISEREZ	CORRUPTIBILITES
CONTREPLAQUATES	CONTRINDIQUERAS*	CONVIVIALISIONS	CORTICOSTEROIDE
CONTREPLAQUERAI	CONTRINDIQUEREZ*	CONVULSIONNAIRE	CORTICOSTERONES
CONTREPLAQUERAS	CONTRINDIQUIONS*	CONVULSIONNAMES	CORTICOSURRENAL
CONTREPLAQUEREZ	CONTRISTASSIONS	CONVULSIONNASSE	CORTICOTHERAPIE
CONTREPLAQUIONS	CONTRISTERAIENT	CONVULSIONNATES	CORTICOTROPHINE
CONTREPOINTISTE	CONTROFFENSIVES*	CONVULSIONNERAI	COSMETIQUASSENT
CONTREPRODUCTIF*	CONTROLABILITES	CONVULSIONNERAS	COSMETIQUASSIEZ
CONTREPUBLICITE	CONTROLATERALES	CONVULSIONNEREZ	COSMETIQUERIONS
CONTREREACTIONS*	CONTROUVASSIONS	CONVULSIONNIONS	COSMETOLOGIQUES
CONTRESIGNAIENT	CONTROUVERAIENT	COORDONNASSIONS	COSMOGRAPHIQUES
CONTRESIGNASSES	CONTROVERSABLES	COORDONNATRICES	COSMOPOLITISMES
CONTRESIGNERAIS	CONTROVERSAIENT	COORDONNERAIENT	COSOUVERAINETES*
CONTRESIGNERAIT	CONTROVERSASSES	COORGANISASSENT	COSTARMORICAINE
CONTRESIGNERENT	CONTROVERSERAIS	COORGANISASSIEZ	COSTARMORICAINS
CONTRESIGNERIEZ	CONTROVERSERAIT	COORGANISATEURS	COUCHAILLASSENT
CONTRESIGNERONS	CONTROVERSERENT	COORGANISATRICE	COUCHAILLASSIEZ
CONTRESIGNERONT	CONTROVERSERIEZ	COORGANISERIONS	COUCHAILLERIONS
CONTRESPIONNAGE*	CONTROVERSERONS	COPARTAGEASSENT	COUILLONNASSENT
CONTRETIRASSENT*	CONTROVERSERONT	COPARTAGEASSIEZ	COUILLONNASSIEZ
CONTRETIRASSIEZ*	CONTROVERSISTES	COPARTAGERAIENT	COUILLONNERIONS
CONTRETIRERIONS*	CONTUSIONNAIENT	COPARTICIPANTES	COUPAILLASSIONS
CONTRETRANSFERT*	CONTUSIONNASSES	COPARTICIPATION	COUPAILLERAIENT
CONTRETYPASSENT	CONTUSIONNERAIS	COPERMUTASSIONS	COUPEROSASSIONS
CONTRETYPASSIEZ	CONTUSIONNERAIT	COPERMUTERAIENT	COUPEROSERAIENT
CONTRETYPERIONS	CONTUSIONNERENT	COPOSSEDASSIONS	COURAILLASSIONS
CONTREVALLATION	CONTUSIONNERIEZ	COPOSSEDERAIENT	COURAILLERAIENT
CONTREVENTAIENT	CONTUSIONNERONS	COPRESIDASSIONS	COURBATTURAIENT
CONTREVENTASSES	CONTUSIONNERONT	COPRESIDERAIENT	COURBATTURASSES
CONTREVENTEMENT	CONVAINQUISSENT	COPRODUISISSENT	COURBATTURERAIS
CONTREVENTERAIS	CONVAINQUISSIEZ	COPRODUISISSIEZ	COURBATTURERAIT
CONTREVENTERAIT	CONVENTIONNAMES	COPROPRIETAIRES	COURBATTURERENT
CONTREVENTERENT	CONVENTIONNASSE	CORACIADIFORMES	COURBATTURERIEZ
CONTREVENTERIEZ	CONVENTIONNATES	COREALISATRICES	COURBATTURERONS
CONTREVENTERONS	CONVENTIONNELLE	COREDIGEASSIONS*	COURBATTURERONT
CONTREVENTERONT	CONVENTIONNERAI	CORELIGIONNAIRE	COURBATURASSENT
CONTREVIENDRAIS	CONVENTIONNERAS	CORNOUAILLAISES	COURBATURASSIEZ
CONTREVIENDRAIT	CONVENTIONNEREZ	CORONAROGRAPHIE	COURBATURERIONS
CONTREVIENDRIEZ	CONVENTIONNIONS	CORONAROPATHIES	COURBEVOISIENNE
CONTREVIENDRONS	CONVERGEASSIONS	CORRECTIONNELLE	COURCAILLASSENT
CONTREVIENDRONT	CONVERSATIONNEL	CORRELATIONNELS	COURCAILLASSIEZ
CONTREVINSSIONS	CONVERTIBILITES	CORRELATIVEMENT	COURCAILLERIONS
CONTREXPERTISES*	CONVERTISSABLES	CORRESPONDAIENT	COURROUCASSIONS
CONTREXTENSIONS*	CONVERTISSAIENT	CORRESPONDANCES	COURROUCERAIENT
CONTRIBUASSIONS	CONVERTISSEMENT	CORRESPONDANTES	COURTAUDASSIONS
CONTRIBUERAIENT	CONVIVIALISAMES	CORRESPONDIRENT	COURTAUDERAIENT
CONTRINDICATION*	CONVIVIALISASSE	CORRESPONDISSES	COURTELINESQUES


Mots de 15 lettres de COURTRAISIENNES à DEBOULONNASSENT - Page 13/61

COURTRAISIENNES	CRISTALLISERAIS	CRYPTOGRAPHIONS	DEBAILLONNERAIT
COVOITURASSIONS	CRISTALLISERAIT	CRYPTOGRAPHIQUE	DEBAILLONNERENT
COVOITURERAIENT	CRISTALLISERENT	CRYPTOZOOLOGIES	DEBAILLONNERIEZ
CRACHOUILLAIENT	CRISTALLISERIEZ	CULPABILISAIENT	DEBAILLONNERONS
CRACHOUILLASSES	CRISTALLISERONS	CULPABILISANTES	DEBAILLONNERONT
CRACHOUILLERAIS	CRISTALLISERONT	CULPABILISASSES	DEBALLONNASSENT
CRACHOUILLERAIT	CRISTALLOCHIMIE	CULPABILISATEUR	DEBALLONNASSIEZ
CRACHOUILLERENT	CRISTALLOGENESE	CULPABILISATION	DEBALLONNERIONS
CRACHOUILLERIEZ	CRISTALLOGENIES	CULPABILISERAIS	DEBALOURDASSENT
CRACHOUILLERONS	CRISTALLOGRAPHE	CULPABILISERAIT	DEBALOURDASSIEZ
CRACHOUILLERONT	CRISTALLOMANCIE	CULPABILISERENT	DEBALOURDERIONS
CRAMPONNASSIONS	CRISTALLOMETRIE	CULPABILISERIEZ	DEBANALISASSENT
CRAMPONNERAIENT	CRITICAILLAIENT	CULPABILISERONS	DEBANALISASSIEZ
CRAPAHUTASSIONS	CRITICAILLASSES	CULPABILISERONT	DEBANALISATIONS
CRAPAHUTERAIENT	CRITICAILLERAIS	CUNICULICULTURE	DEBANALISERIONS
CRAQUELLERAIENT	CRITICAILLERAIT	CUPROALUMINIUMS	DEBAPTISASSIONS
CRAQUETTERAIENT	CRITICAILLERENT	CUPROAMMONIACAL	DEBAPTISERAIENT
CRATICULASSIONS	CRITICAILLERIEZ	CUPROAMMONIAQUE	DEBARBOUILLAGES
CRATICULERAIENT	CRITICAILLERONS	CUSTOMISASSIONS	DEBARBOUILLAMES
CREDIBILISAIENT	CRITICAILLERONT	CUSTOMISERAIENT	DEBARBOUILLASSE
CREDIBILISASSES	CROQUEMONSIEURS*	CYANOCOBALAMINE	DEBARBOUILLATES
CREDIBILISERAIS	CROQUIGNOLESQUE	CYBERDEPENDANCE	DEBARBOUILLERAI
CREDIBILISERAIT	CROQUIGNOLETTES	CYBERDEPENDANTE	DEBARBOUILLERAS
CREDIBILISERENT	CROSSOPTERYGIEN	CYBERDEPENDANTS	DEBARBOUILLEREZ
CREDIBILISERIEZ	CROUPIONNASSENT	CYBERNETICIENNE	DEBARBOUILLETTE
CREDIBILISERONS	CROUPIONNASSIEZ	CYBERTERRORISME	DEBARBOUILLIONS
CREDIBILISERONT	CROUPIONNERIONS	CYBERTERRORISTE	DEBAROULASSIONS
CRESSICULTRICES	CROUSTILLASSENT	CYCLOMOTORISTES	DEBAROULERAIENT
CRETINISASSIONS	CROUSTILLASSIEZ	CYPRINICULTURES	DEBARRASSASSENT
CRETINISERAIENT	CROUSTILLERIONS	CYTODIAGNOSTICS	DEBARRASSASSIEZ
CREVETTICULTEUR	CRYOALTERNATEUR	CYTOGENETICIENS	DEBARRASSERIONS
CREVETTICULTURE	CRYOCONDUCTEURS	CYTOMEGALOVIRUS	DEBECQUETASSENT
CRIMINALISAIENT	CRYOCONDUCTRICE	CYTOPATHOLOGIES	DEBECQUETASSIEZ
CRIMINALISASSES	CRYOGENISASSENT	DACTYLOGRAPHIAI	DEBECQUETERIONS
CRIMINALISATION	CRYOGENISASSIEZ	DACTYLOGRAPHIAS	DEBENZOLASSIONS
CRIMINALISERAIS	CRYOGENISATIONS	DACTYLOGRAPHIAT	DEBENZOLERAIENT
CRIMINALISERAIT	CRYOGENISERIONS	DACTYLOGRAPHIEE	DEBEQUETASSIONS
CRIMINALISERENT	CRYOPROTECTEURS	DACTYLOGRAPHIER	DEBEQUETERAIENT
CRIMINALISERIEZ	CRYOPROTECTRICE	DACTYLOGRAPHIES	DEBILLARDASSENT
CRIMINALISERONS	CRYOTEMPERATURE	DACTYLOGRAPHIEZ	DEBILLARDASSIEZ
CRIMINALISERONT	CRYOVOLCANISMES	DACTYLOLOGIQUES	DEBILLARDERIONS
CRIMINALISTIQUE	CRYPTOBIOTIQUES	DAGUERREOTYPIES	DEBLATERASSIONS
CRIMINOLOGIQUES	CRYPTOGENETIQUE	DAMASQUINASSENT	DEBLATERERAIENT
CRIMINOLOGISTES	CRYPTOGRAPHIAIS	DAMASQUINASSIEZ	DEBOSSELASSIONS
CRISTALLINIENNE	CRYPTOGRAPHIAIT	DAMASQUINERIONS	DEBOSSELERAIENT*
CRISTALLISABLES	CRYPTOGRAPHIANT	DEBAGOULASSIONS	DEBOSSELLERIONS
CRISTALLISAIENT	CRYPTOGRAPHIEES	DEBAGOULERAIENT	DEBOUILLIRAIENT
CRISTALLISANTES	CRYPTOGRAPHIENT	DEBAILLONNAIENT	DEBOUILLISSAGES
CRISTALLISASSES	CRYPTOGRAPHIERA	DEBAILLONNASSES	DEBOUILLISSIONS
CRISTALLISATION	CRYPTOGRAPHIIEZ	DEBAILLONNERAIS	DEBOULONNASSENT


Mots de 15 lettres de DEBOULONNASSIEZ à DECLERICALISAIS - Page 14/61

DEBOULONNASSIEZ	DEBUTANISERIONS	DECARBONASSIONS	DECHAUSSERAIENT
DEBOULONNEMENTS	DECACHETASSIONS	DECARBONATAIENT	DECHEVETRASSENT
DEBOULONNERIONS	DECACHETERAIENT*	DECARBONATASSES	DECHEVETRASSIEZ
DEBOUSSOLASSENT	DECACHETTERIONS	DECARBONATATION	DECHEVETRERIONS
DEBOUSSOLASSIEZ	DECADENASSAIENT	DECARBONATERAIS	DECHIFFONNAIENT
DEBOUSSOLERIONS	DECADENASSASSES	DECARBONATERAIT	DECHIFFONNASSES
DEBOUTONNASSENT	DECADENASSERAIS	DECARBONATERENT	DECHIFFONNERAIS
DEBOUTONNASSIEZ	DECADENASSERAIT	DECARBONATERIEZ	DECHIFFONNERAIT
DEBOUTONNERIONS	DECADENASSERENT	DECARBONATERONS	DECHIFFONNERENT
DEBRAGUETTAIENT	DECADENASSERIEZ	DECARBONATERONT	DECHIFFONNERIEZ
DEBRAGUETTASSES	DECADENASSERONS	DECARBONERAIENT	DECHIFFONNERONS
DEBRAGUETTERAIS	DECADENASSERONT	DECARBOXYLATION	DECHIFFONNERONT
DEBRAGUETTERAIT	DECAFEINASSIONS	DECARBURASSIONS	DECHIFFRASSIONS
DEBRAGUETTERENT	DECAFEINERAIENT	DECARBURERAIENT	DECHIFFRERAIENT
DEBRAGUETTERIEZ	DECALAMINASSENT	DECARCASSASSENT	DECHIQUETASSENT
DEBRAGUETTERONS	DECALAMINASSIEZ	DECARCASSASSIEZ	DECHIQUETASSIEZ
DEBRAGUETTERONT	DECALAMINERIONS	DECARCASSERIONS	DECHIQUETERIONS*
DEBRAILLASSIONS	DECALCARISAIENT	DECARRELASSIONS	DECHIQUETTERAIS
DEBRAILLERAIENT	DECALCARISASSES	DECARRELERAIENT*	DECHIQUETTERAIT
DEBRANCHASSIONS	DECALCARISERAIS	DECARRELLERIONS	DECHIQUETTERIEZ
DEBRANCHERAIENT	DECALCARISERAIT	DECASYLLABIQUES	DECHIQUETTERONS
DEBROUILLARDISE	DECALCARISERENT	DECAVAILLONNAIS	DECHIQUETTERONT
DEBROUILLASSENT	DECALCARISERIEZ	DECAVAILLONNAIT	DECHLORURASSENT
DEBROUILLASSIEZ	DECALCARISERONS	DECAVAILLONNANT	DECHLORURASSIEZ
DEBROUILLEMENTS	DECALCARISERONT	DECAVAILLONNEES	DECHLORURERIONS
DEBROUILLERIONS	DECALCIFIASSENT	DECAVAILLONNENT	DECHRISTIANISAI
DEBROUSSAILLAGE	DECALCIFIASSIEZ	DECAVAILLONNERA	DECHRISTIANISAS
DEBROUSSAILLAIS	DECALCIFICATION	DECAVAILLONNIEZ	DECHRISTIANISAT
DEBROUSSAILLAIT	DECALCIFIERIONS	DECAVAILLONNONS	DECHRISTIANISEE
DEBROUSSAILLANT	DECALOTTASSIONS	DECENTRALISAMES	DECHRISTIANISER
DEBROUSSAILLEES	DECALOTTERAIENT	DECENTRALISASSE	DECHRISTIANISES
DEBROUSSAILLENT	DECANILLASSIONS	DECENTRALISATES	DECHRISTIANISEZ
DEBROUSSAILLERA	DECANILLERAIENT	DECENTRALISERAI	DECIMALISASSENT
DEBROUSSAILLIEZ	DECAPELLERAIENT	DECENTRALISERAS	DECIMALISASSIEZ
DEBROUSSAILLONS	DECAPITALISAMES	DECENTRALISEREZ	DECIMALISATIONS
DEBROUSSASSIONS	DECAPITALISASSE	DECENTRALISIONS	DECIMALISERIONS
DEBROUSSERAIENT	DECAPITALISATES	DECEREBRASSIONS	DECLASSIFIAIENT
DEBUDGETISAIENT	DECAPITALISERAI	DECEREBRERAIENT	DECLASSIFIASSES
DEBUDGETISASSES	DECAPITALISERAS	DECERVELASSIONS	DECLASSIFIERAIS
DEBUDGETISATION	DECAPITALISEREZ	DECERVELERAIENT*	DECLASSIFIERAIT
DEBUDGETISERAIS	DECAPITALISIONS	DECERVELLERIONS	DECLASSIFIERENT
DEBUDGETISERAIT	DECAPSULASSIONS	DECHAPERONNAMES	DECLASSIFIERIEZ
DEBUDGETISERENT	DECAPSULERAIENT	DECHAPERONNASSE	DECLASSIFIERONS
DEBUDGETISERIEZ	DECAPUCHONNAMES	DECHAPERONNATES	DECLASSIFIERONT
DEBUDGETISERONS	DECAPUCHONNASSE	DECHAPERONNERAI	DECLAVETASSIONS
DEBUDGETISERONT	DECAPUCHONNATES	DECHAPERONNERAS	DECLAVETERAIENT*
DEBUREAUCRATISA	DECAPUCHONNERAI	DECHAPERONNEREZ	DECLAVETTERIONS
DEBUREAUCRATISE	DECAPUCHONNERAS	DECHAPERONNIONS	DECLENCHASSIONS
DEBUTANISASSENT	DECAPUCHONNEREZ	DECHARGEASSIONS	DECLENCHERAIENT
DEBUTANISASSIEZ	DECAPUCHONNIONS	DECHAUSSASSIONS	DECLERICALISAIS


Mots de 15 lettres de DECLERICALISAIT à DECREDIBILISAIS - Page 15/61

DECLERICALISAIT	DECOMMUNISATION	DECONDITIONNENT	DECONTAMINERENT
DECLERICALISANT	DECOMMUNISERAIS	DECONDITIONNERA	DECONTAMINERIEZ
DECLERICALISEES	DECOMMUNISERAIT	DECONDITIONNIEZ	DECONTAMINERONS
DECLERICALISENT	DECOMMUNISERENT	DECONDITIONNONS	DECONTAMINERONT
DECLERICALISERA	DECOMMUNISERIEZ	DECONGELASSIONS	DECONTENANCAMES
DECLERICALISIEZ	DECOMMUNISERONS	DECONGELERAIENT	DECONTENANCASSE
DECLERICALISONS	DECOMMUNISERONT	DECONGESTIONNAI	DECONTENANCATES
DECLINQUASSIONS	DECOMPACTASSENT	DECONGESTIONNAS	DECONTENANCERAI
DECLINQUERAIENT	DECOMPACTASSIEZ	DECONGESTIONNAT	DECONTENANCERAS
DECLIQUETASSENT	DECOMPACTERIONS	DECONGESTIONNEE	DECONTENANCEREZ
DECLIQUETASSIEZ	DECOMPENSASSENT	DECONGESTIONNER	DECONTENANCIONS
DECLIQUETERIONS*	DECOMPENSASSIEZ	DECONGESTIONNES	DECONTRACTAIENT
DECLIQUETTERAIS	DECOMPENSATIONS	DECONGESTIONNEZ	DECONTRACTANTES
DECLIQUETTERAIT	DECOMPENSERIONS	DECONNECTASSENT	DECONTRACTASSES
DECLIQUETTERIEZ	DECOMPLEXASSENT	DECONNECTASSIEZ	DECONTRACTERAIS
DECLIQUETTERONS	DECOMPLEXASSIEZ	DECONNECTERIONS	DECONTRACTERAIT
DECLIQUETTERONT	DECOMPLEXERIONS	DECONSEILLAIENT	DECONTRACTERENT
DECLOISONNAIENT	DECOMPOSASSIONS	DECONSEILLASSES	DECONTRACTERIEZ
DECLOISONNASSES	DECOMPOSERAIENT	DECONSEILLERAIS	DECONTRACTERONS
DECLOISONNEMENT	DECOMPRESSAIENT	DECONSEILLERAIT	DECONTRACTERONT
DECLOISONNERAIS	DECOMPRESSASSES	DECONSEILLERENT	DECONVENTIONNAI
DECLOISONNERAIT	DECOMPRESSERAIS	DECONSEILLERIEZ	DECONVENTIONNAS
DECLOISONNERENT	DECOMPRESSERAIT	DECONSEILLERONS	DECONVENTIONNAT
DECLOISONNERIEZ	DECOMPRESSERENT	DECONSEILLERONT	DECONVENTIONNEE
DECLOISONNERONS	DECOMPRESSERIEZ	DECONSIDERAIENT	DECONVENTIONNER
DECLOISONNERONT	DECOMPRESSERONS	DECONSIDERASSES	DECONVENTIONNES
DECOHABITASSENT	DECOMPRESSERONT	DECONSIDERATION	DECONVENTIONNEZ
DECOHABITASSIEZ	DECOMPRIMASSENT	DECONSIDERERAIS	DECORRELASSIONS
DECOHABITATIONS	DECOMPRIMASSIEZ	DECONSIDERERAIT	DECORRELERAIENT
DECOHABITERIONS	DECOMPRIMERIONS	DECONSIDERERENT	DECORTIQUASSENT
DECOLLECTIVISAI	DECONCENTRAIENT	DECONSIDERERIEZ	DECORTIQUASSIEZ
DECOLLECTIVISAS	DECONCENTRASSES	DECONSIDERERONS	DECORTIQUERIONS
DECOLLECTIVISAT	DECONCENTRATION	DECONSIDERERONT	DECOUENNASSIONS
DECOLLECTIVISEE	DECONCENTRERAIS	DECONSIGNASSENT	DECOUENNERAIENT
DECOLLECTIVISER	DECONCENTRERAIT	DECONSIGNASSIEZ	DECOURAGEASSENT
DECOLLECTIVISES	DECONCENTRERENT	DECONSIGNERIONS	DECOURAGEASSIEZ
DECOLLECTIVISEZ	DECONCENTRERIEZ	DECONSTIPASSENT	DECOURAGERAIENT
DECOLLETASSIONS	DECONCENTRERONS	DECONSTIPASSIEZ	DECOURONNASSENT
DECOLLETERAIENT*	DECONCENTRERONT	DECONSTIPERIONS	DECOURONNASSIEZ
DECOLLETTERIONS	DECONCERTASSENT	DECONSTRUCTIONS	DECOURONNEMENTS
DECOLONISASSENT	DECONCERTASSIEZ	DECONSTRUIRIONS	DECOURONNERIONS
DECOLONISASSIEZ	DECONCERTERIONS	DECONSTRUISIMES	DECRAMPONNAIENT
DECOLONISATIONS	DECONDENSASSENT	DECONSTRUISIONS	DECRAMPONNASSES
DECOLONISERIONS	DECONDENSASSIEZ	DECONSTRUISISSE	DECRAMPONNERAIS
DECOMMANDASSENT	DECONDENSATIONS	DECONSTRUISITES	DECRAMPONNERAIT
DECOMMANDASSIEZ	DECONDENSERIONS	DECONTAMINAIENT	DECRAMPONNERENT
DECOMMANDERIONS	DECONDITIONNAIS	DECONTAMINASSES	DECRAMPONNERIEZ
DECOMMETTRAIENT	DECONDITIONNAIT	DECONTAMINATION	DECRAMPONNERONS
DECOMMUNISAIENT	DECONDITIONNANT	DECONTAMINERAIS	DECRAMPONNERONT
DECOMMUNISASSES	DECONDITIONNEES	DECONTAMINERAIT	DECREDIBILISAIS


Mots de 15 lettres de DECREDIBILISAIT à DEGUERPISSEMENT - Page 16/61

DECREDIBILISAIT	DEDIFFERENCIENT	DEFISCALISERAIS	DEGENERESCENCES
DECREDIBILISANT	DEDIFFERENCIERA	DEFISCALISERAIT	DEGENERESCENTES
DECREDIBILISEES	DEDIFFERENCIIEZ	DEFISCALISERENT	DEGINGANDASSENT
DECREDIBILISENT	DEDIFFERENCIONS	DEFISCALISERIEZ	DEGINGANDASSIEZ
DECREDIBILISERA	DEDOMMAGEASSENT	DEFISCALISERONS	DEGINGANDERIONS
DECREDIBILISIEZ	DEDOMMAGEASSIEZ	DEFISCALISERONT	DEGLINGUASSIONS
DECREDIBILISONS	DEDOMMAGERAIENT	DEFLATIONNISTES	DEGLINGUERAIENT
DECREDITASSIONS	DEDOUBLONNAIENT*	DEFLECHISSAIENT	DEGLOBULISATION
DECREDITERAIENT	DEDOUBLONNASSES*	DEFLEURISSAIENT	DEGOBILLASSIONS
DECREMENTASSENT	DEDOUBLONNERAIS*	DEFORESTASSIONS	DEGOBILLERAIENT
DECREMENTASSIEZ	DEDOUBLONNERAIT*	DEFORESTERAIENT	DEGOUDRONNAIENT
DECREMENTERIONS	DEDOUBLONNERENT*	DEFOURAILLAIENT	DEGOUDRONNASSES
DECREPITASSIONS	DEDOUBLONNERIEZ*	DEFOURAILLASSES	DEGOUDRONNERAIS
DECREPITERAIENT	DEDOUBLONNERONS*	DEFOURAILLERAIS	DEGOUDRONNERAIT
DECRIMINALISAIS	DEDOUBLONNERONT*	DEFOURAILLERAIT	DEGOUDRONNERENT
DECRIMINALISAIT	DEDRAMATISAIENT	DEFOURAILLERENT	DEGOUDRONNERIEZ
DECRIMINALISANT	DEDRAMATISASSES	DEFOURAILLERIEZ	DEGOUDRONNERONS
DECRIMINALISEES	DEDRAMATISATION	DEFOURAILLERONS	DEGOUDRONNERONT
DECRIMINALISENT	DEDRAMATISERAIS	DEFOURAILLERONT	DEGOULINASSIONS
DECRIMINALISERA	DEDRAMATISERAIT	DEFRAGMENTAIENT	DEGOULINERAIENT
DECRIMINALISIEZ	DEDRAMATISERENT	DEFRAGMENTASSES	DEGOUPILLASSENT
DECRIMINALISONS	DEDRAMATISERIEZ	DEFRAGMENTATION	DEGOUPILLASSIEZ
DECULASSASSIONS	DEDRAMATISERONS	DEFRAGMENTERAIS	DEGOUPILLERIONS
DECULASSERAIENT	DEDRAMATISERONT	DEFRAGMENTERAIT	DEGOURBIFIAIENT
DECULOTTASSIONS	DEFATIGUASSIONS	DEFRAGMENTERENT	DEGOURBIFIASSES
DECULOTTERAIENT	DEFATIGUERAIENT	DEFRAGMENTERIEZ	DEGOURBIFIERAIS
DECULPABILISAIS	DEFAUFILASSIONS	DEFRAGMENTERONS	DEGOURBIFIERAIT
DECULPABILISAIT	DEFAUFILERAIENT	DEFRAGMENTERONT	DEGOURBIFIERENT
DECULPABILISANT	DEFAVORABLEMENT	DEFRAICHIRAIENT	DEGOURBIFIERIEZ
DECULPABILISEES	DEFAVORISASSENT	DEFRAICHISSIONS	DEGOURBIFIERONS
DECULPABILISENT	DEFAVORISASSIEZ	DEFRANCHIRAIENT	DEGOURBIFIERONT
DECULPABILISERA	DEFAVORISERIONS	DEFRANCHISSIONS	DEGOURDISSAIENT
DECULPABILISIEZ	DEFECTUEUSEMENT	DEFROISSASSIONS	DEGOURDISSEMENT
DECULPABILISONS	DEFENESTRASSENT	DEFROISSERAIENT	DEGRAFFITASSENT
DECULTURASSIONS	DEFENESTRASSIEZ	DEFUSIONNASSENT	DEGRAFFITASSIEZ
DECULTURERAIENT	DEFENESTRATIONS	DEFUSIONNASSIEZ	DEGRAFFITERIONS
DEDAIGNEUSEMENT	DEFENESTRERIONS	DEFUSIONNERIONS	DEGRAISSASSIONS
DEDIABOLISAIENT	DEFEUILLASSIONS	DEGALONNASSIONS	DEGRAISSERAIENT
DEDIABOLISASSES	DEFEUILLERAIENT	DEGALONNERAIENT	DEGRAVOIERAIENT
DEDIABOLISATION	DEFIBRILLASSENT	DEGASOLINASSENT	DEGRAVOYASSIONS
DEDIABOLISERAIS	DEFIBRILLASSIEZ	DEGASOLINASSIEZ	DEGRINGOLASSENT
DEDIABOLISERAIT	DEFIBRILLATEURS	DEGASOLINERIONS	DEGRINGOLASSIEZ
DEDIABOLISERENT	DEFIBRILLATIONS	DEGAUCHISSAIENT	DEGRINGOLERIONS
DEDIABOLISERIEZ	DEFIBRILLERIONS	DEGAUCHISSEMENT	DEGROSSISSAIENT
DEDIABOLISERONS	DEFICELLERAIENT	DEGAUCHISSEUSES	DEGROSSISSEMENT
DEDIABOLISERONT	DEFINITIONNELLE	DEGAZOLINASSENT	DEGROUILLASSENT
DEDIFFERENCIAIS	DEFISCALISABLES	DEGAZOLINASSIEZ	DEGROUILLASSIEZ
DEDIFFERENCIAIT	DEFISCALISAIENT	DEGAZOLINERIONS	DEGROUILLERIONS
DEDIFFERENCIANT	DEFISCALISASSES	DEGAZONNASSIONS	DEGUERPISSAIENT
DEDIFFERENCIEES	DEFISCALISATION	DEGAZONNERAIENT	DEGUERPISSEMENT


Mots de 15 lettres de DEGUEULASSAIENT à DEMYELINISERIEZ - Page 17/61

DEGUEULASSAIENT	DELOCALISASSIEZ	DEMAZOUTERAIENT	DEMONETISERIONS
DEGUEULASSASSES	DELOCALISATIONS	DEMEDICALISAMES	DEMONSTRATRICES
DEGUEULASSERAIS	DELOCALISERIONS	DEMEDICALISASSE	DEMONTRABILITES
DEGUEULASSERAIT	DEMAGNETISAIENT	DEMEDICALISATES	DEMORALISASSENT
DEGUEULASSERENT	DEMAGNETISASSES	DEMEDICALISERAI	DEMORALISASSIEZ
DEGUEULASSERIES	DEMAGNETISATION	DEMEDICALISERAS	DEMORALISATEURS
DEGUEULASSERIEZ	DEMAGNETISERAIS	DEMEDICALISEREZ	DEMORALISATIONS
DEGUEULASSERONS	DEMAGNETISERAIT	DEMEDICALISIONS	DEMORALISATRICE
DEGUEULASSERONT	DEMAGNETISERENT	DEMENAGEASSIONS	DEMORALISERIONS
DEGURGITASSIONS	DEMAGNETISERIEZ	DEMILITARISAMES	DEMOUCHETASSENT
DEGURGITERAIENT	DEMAGNETISERONS	DEMILITARISASSE	DEMOUCHETASSIEZ
DEHARNACHASSENT	DEMAGNETISERONT	DEMILITARISATES	DEMOUCHETERIONS*
DEHARNACHASSIEZ	DEMAIGRISSAIENT	DEMILITARISERAI	DEMOUCHETTERAIS
DEHARNACHERIONS	DEMAIGRISSEMENT	DEMILITARISERAS	DEMOUCHETTERAIT
DEHOUILLASSIONS	DEMAILLOTASSENT	DEMILITARISEREZ	DEMOUCHETTERIEZ
DEHOUILLERAIENT	DEMAILLOTASSIEZ	DEMILITARISIONS	DEMOUCHETTERONS
DELABIALISAIENT	DEMAILLOTERIONS	DEMINERALISAMES	DEMOUCHETTERONT
DELABIALISASSES	DEMANTELASSIONS	DEMINERALISASSE	DEMOUSTICATIONS
DELABIALISATION	DEMANTELERAIENT	DEMINERALISATES	DEMOUSTIQUAIENT
DELABIALISERAIS	DEMANTIBULAIENT	DEMINERALISERAI	DEMOUSTIQUASSES
DELABIALISERAIT	DEMANTIBULASSES	DEMINERALISERAS	DEMOUSTIQUERAIS
DELABIALISERENT	DEMANTIBULERAIS	DEMINERALISEREZ	DEMOUSTIQUERAIT
DELABIALISERIEZ	DEMANTIBULERAIT	DEMINERALISIONS	DEMOUSTIQUERENT
DELABIALISERONS	DEMANTIBULERENT	DEMISSIONNAIENT	DEMOUSTIQUERIEZ
DELABIALISERONT	DEMANTIBULERIEZ	DEMISSIONNAIRES	DEMOUSTIQUERONS
DELABYRINTHAMES	DEMANTIBULERONS	DEMISSIONNASSES	DEMOUSTIQUERONT
DELABYRINTHASSE	DEMANTIBULERONT	DEMISSIONNERAIS	DEMULTIPLEXAGES
DELABYRINTHATES	DEMAQUILLASSENT	DEMISSIONNERAIT	DEMULTIPLEXAMES
DELABYRINTHERAI	DEMAQUILLASSIEZ	DEMISSIONNERENT	DEMULTIPLEXASSE
DELABYRINTHERAS	DEMAQUILLERIONS	DEMISSIONNERIEZ	DEMULTIPLEXATES
DELABYRINTHEREZ	DEMARABOUTAIENT	DEMISSIONNERONS	DEMULTIPLEXERAI
DELABYRINTHIONS	DEMARABOUTASSES	DEMISSIONNERONT	DEMULTIPLEXERAS
DELEATURASSIONS	DEMARABOUTERAIS	DEMOBILISASSENT	DEMULTIPLEXEREZ
DELEATURERAIENT	DEMARABOUTERAIT	DEMOBILISASSIEZ	DEMULTIPLEXIONS
DELEGITIMASSENT	DEMARABOUTERENT	DEMOBILISATEURS	DEMULTIPLIAIENT
DELEGITIMASSIEZ	DEMARABOUTERIEZ	DEMOBILISATIONS	DEMULTIPLIASSES
DELEGITIMATIONS	DEMARABOUTERONS	DEMOBILISATRICE	DEMULTIPLIERAIS
DELEGITIMERIONS	DEMARABOUTERONT	DEMOBILISERIONS	DEMULTIPLIERAIT
DELIGNIFIASSENT	DEMASTIQUASSENT	DEMOCRATISAIENT	DEMULTIPLIERENT
DELIGNIFIASSIEZ	DEMASTIQUASSIEZ	DEMOCRATISASSES	DEMULTIPLIERIEZ
DELIGNIFICATION	DEMASTIQUERIONS	DEMOCRATISATION	DEMULTIPLIERONS
DELIGNIFIERIONS	DEMATERIALISAIS	DEMOCRATISERAIS	DEMULTIPLIERONT
DELINEAMENTAMES	DEMATERIALISAIT	DEMOCRATISERAIT	DEMUSELLERAIENT
DELINEAMENTASSE	DEMATERIALISANT	DEMOCRATISERENT	DEMYELINISAIENT
DELINEAMENTATES	DEMATERIALISEES	DEMOCRATISERIEZ	DEMYELINISASSES
DELINEAMENTERAI	DEMATERIALISENT	DEMOCRATISERONS	DEMYELINISATION
DELINEAMENTERAS	DEMATERIALISERA	DEMOCRATISERONT	DEMYELINISERAIS
DELINEAMENTEREZ	DEMATERIALISIEZ	DEMONETISASSENT	DEMYELINISERAIT
DELINEAMENTIONS	DEMATERIALISONS	DEMONETISASSIEZ	DEMYELINISERENT
DELOCALISASSENT	DEMAZOUTASSIONS	DEMONETISATIONS	DEMYELINISERIEZ


Mots de 15 lettres de DEMYELINISERONS à DEPUCELLERAIENT - Page 18/61

DEMYELINISERONS	DENIVELLERAIENT	DEPERSONNALISAT	DEPOLITISATIONS
DEMYELINISERONT	DENOTATIONNELLE	DEPERSONNALISEE	DEPOLITISERIONS
DEMYSTIFIASSENT	DENOYAUTASSIONS	DEPERSONNALISER	DEPOLYMERISAMES
DEMYSTIFIASSIEZ	DENOYAUTERAIENT	DEPERSONNALISES	DEPOLYMERISASSE
DEMYSTIFICATEUR	DENTUROLOGIQUES	DEPERSONNALISEZ	DEPOLYMERISATES
DEMYSTIFICATION	DENTUROLOGISTES	DEPHOSPHATAIENT	DEPOLYMERISERAI
DEMYSTIFIERIONS	DENUCLEARISAMES	DEPHOSPHATASSES	DEPOLYMERISERAS
DEMYTHIFIASSENT	DENUCLEARISASSE	DEPHOSPHATATION	DEPOLYMERISEREZ
DEMYTHIFIASSIEZ	DENUCLEARISATES	DEPHOSPHATERAIS	DEPOLYMERISIONS
DEMYTHIFICATION	DENUCLEARISERAI	DEPHOSPHATERAIT	DEPOSSEDASSIONS
DEMYTHIFIERIONS	DENUCLEARISERAS	DEPHOSPHATERENT	DEPOSSEDERAIENT
DENASALISASSENT	DENUCLEARISEREZ	DEPHOSPHATERIEZ	DEPOUILLASSIONS
DENASALISASSIEZ	DENUCLEARISIONS	DEPHOSPHATERONS	DEPOUILLERAIENT
DENASALISATIONS	DEPALISSASSIONS	DEPHOSPHATERONT	DEPOUSSIERAIENT
DENASALISERIONS	DEPALISSERAIENT	DEPHOSPHORAIENT	DEPOUSSIERASSES
DENATIONALISAIS	DEPAQUETASSIONS	DEPHOSPHORASSES	DEPOUSSIERERAIS
DENATIONALISAIT	DEPAQUETERAIENT*	DEPHOSPHORATION	DEPOUSSIERERAIT
DENATIONALISANT	DEPAQUETTERIONS	DEPHOSPHORERAIS	DEPOUSSIERERENT
DENATIONALISEES	DEPARASITASSENT	DEPHOSPHORERAIT	DEPOUSSIERERIEZ
DENATIONALISENT	DEPARASITASSIEZ	DEPHOSPHORERENT	DEPOUSSIERERONS
DENATIONALISERA	DEPARASITERIONS	DEPHOSPHORERIEZ	DEPOUSSIERERONT
DENATIONALISIEZ	DEPAREILLASSENT	DEPHOSPHORERONS	DEPRESSIONNAIRE
DENATIONALISONS	DEPAREILLASSIEZ	DEPHOSPHORERONT	DEPRESSURISAMES
DENATURALISAMES	DEPAREILLERIONS	DEPIGMENTASSENT	DEPRESSURISASSE
DENATURALISASSE	DEPARTAGEASSENT	DEPIGMENTASSIEZ	DEPRESSURISATES
DENATURALISATES	DEPARTAGEASSIEZ	DEPIGMENTATIONS	DEPRESSURISERAI
DENATURALISERAI	DEPARTAGERAIENT	DEPIGMENTERIONS	DEPRESSURISERAS
DENATURALISERAS	DEPARTEMENTALES	DEPLAFONNASSENT	DEPRESSURISEREZ
DENATURALISEREZ	DEPASSIONNAIENT	DEPLAFONNASSIEZ	DEPRESSURISIONS
DENATURALISIONS	DEPASSIONNASSES	DEPLAFONNEMENTS	DEPROGRAMMAIENT
DENAZIFIASSIONS	DEPASSIONNERAIS	DEPLAFONNERIONS	DEPROGRAMMASSES
DENAZIFICATIONS	DEPASSIONNERAIT	DEPLANIFICATION	DEPROGRAMMATION
DENAZIFIERAIENT	DEPASSIONNERENT	DEPLANTINASSENT	DEPROGRAMMERAIS
DENDROMETRIQUES	DEPASSIONNERIEZ	DEPLANTINASSIEZ	DEPROGRAMMERAIT
DENEBULISASSENT	DEPASSIONNERONS	DEPLANTINERIONS	DEPROGRAMMERENT
DENEBULISASSIEZ	DEPASSIONNERONT	DEPOETISASSIONS	DEPROGRAMMERIEZ
DENEBULISATIONS	DEPATOUILLAIENT	DEPOETISERAIENT	DEPROGRAMMERONS
DENEBULISERIONS	DEPATOUILLASSES	DEPOITRAILLAMES	DEPROGRAMMERONT
DENICOTINISAMES	DEPATOUILLERAIS	DEPOITRAILLASSE	DEPROLETARISAIS
DENICOTINISASSE	DEPATOUILLERAIT	DEPOITRAILLATES	DEPROLETARISAIT
DENICOTINISATES	DEPATOUILLERENT	DEPOITRAILLERAI	DEPROLETARISANT
DENICOTINISERAI	DEPATOUILLERIEZ	DEPOITRAILLERAS	DEPROLETARISEES
DENICOTINISERAS	DEPATOUILLERONS	DEPOITRAILLEREZ	DEPROLETARISENT
DENICOTINISEREZ	DEPATOUILLERONT	DEPOITRAILLIONS	DEPROLETARISERA
DENICOTINISEURS	DEPENALISASSENT	DEPOLARISASSENT	DEPROLETARISIEZ
DENICOTINISIONS	DEPENALISASSIEZ	DEPOLARISASSIEZ	DEPROLETARISONS
DENITRIFIASSENT	DEPENALISATIONS	DEPOLARISATIONS	DEPROTEGEASSENT
DENITRIFIASSIEZ	DEPENALISERIONS	DEPOLARISERIONS	DEPROTEGEASSIEZ
DENITRIFICATION	DEPERSONNALISAI	DEPOLITISASSENT	DEPROTEGERAIENT
DENITRIFIERIONS	DEPERSONNALISAS	DEPOLITISASSIEZ	DEPUCELLERAIENT


Mots de 15 lettres de DEQUALIFIASSENT à DESAPPOINTERAIS - Page 19/61

DEQUALIFIASSENT	DEROUILLASSIONS	DESACIERERAIENT	DESALIGNASSIONS
DEQUALIFIASSIEZ	DEROUILLERAIENT	DESACRALISAIENT	DESALIGNERAIENT
DEQUALIFICATION	DERURALISATIONS	DESACRALISASSES	DESALINISASSENT
DEQUALIFIERIONS	DESABONNASSIONS	DESACRALISATION	DESALINISASSIEZ
DERADICALISAMES*	DESABONNERAIENT	DESACRALISERAIS	DESALINISATIONS
DERADICALISASSE*	DESACCENTUAIENT	DESACRALISERAIT	DESALINISERIONS
DERADICALISATES*	DESACCENTUASSES	DESACRALISERENT	DESALTERASSIONS
DERADICALISERAI*	DESACCENTUATION	DESACRALISERIEZ	DESALTERERAIENT
DERADICALISERAS*	DESACCENTUERAIS	DESACRALISERONS	DESAMARRASSIONS
DERADICALISEREZ*	DESACCENTUERAIT	DESACRALISERONT	DESAMARRERAIENT
DERADICALISIONS*	DESACCENTUERENT	DESACTIVASSIONS	DESAMBIGUISAMES
DERAISONNASSENT	DESACCENTUERIEZ	DESACTIVERAIENT	DESAMBIGUISASSE
DERAISONNASSIEZ	DESACCENTUERONS	DESADAPTASSIONS	DESAMBIGUISATES
DERAISONNEMENTS	DESACCENTUERONT	DESADAPTERAIENT	DESAMBIGUISERAI
DERAISONNERIONS	DESACCLIMATAMES	DESAFFECTASSENT	DESAMBIGUISERAS
DEREALISASSIONS	DESACCLIMATASSE	DESAFFECTASSIEZ	DESAMBIGUISEREZ
DEREALISERAIENT	DESACCLIMATATES	DESAFFECTATIONS	DESAMBIGUISIONS
DEREFERENCAIENT	DESACCLIMATERAI	DESAFFECTERIONS	DESAMIANTASSENT
DEREFERENCASSES	DESACCLIMATERAS	DESAFFECTIONNAI	DESAMIANTASSIEZ
DEREFERENCEMENT	DESACCLIMATEREZ	DESAFFECTIONNAS	DESAMIANTERIONS
DEREFERENCERAIS	DESACCLIMATIONS	DESAFFECTIONNAT	DESAMIDONNAIENT
DEREFERENCERAIT	DESACCORDASSENT	DESAFFECTIONNEE	DESAMIDONNASSES
DEREFERENCERENT	DESACCORDASSIEZ	DESAFFECTIONNER	DESAMIDONNERAIS
DEREFERENCERIEZ	DESACCORDERIONS	DESAFFECTIONNES	DESAMIDONNERAIT
DEREFERENCERONS	DESACCOUPLAIENT	DESAFFECTIONNEZ	DESAMIDONNERENT
DEREFERENCERONT	DESACCOUPLASSES	DESAFFILIASSENT	DESAMIDONNERIEZ
DEREGLEMENTAMES	DESACCOUPLEMENT	DESAFFILIASSIEZ	DESAMIDONNERONS
DEREGLEMENTASSE	DESACCOUPLERAIS	DESAFFILIATIONS	DESAMIDONNERONT
DEREGLEMENTATES	DESACCOUPLERAIT	DESAFFILIERIONS	DESAMORCASSIONS
DEREGLEMENTERAI	DESACCOUPLERENT	DESAGRAFASSIONS	DESAMORCERAIENT
DEREGLEMENTERAS	DESACCOUPLERIEZ	DESAGRAFERAIENT	DESANGOISSAIENT
DEREGLEMENTEREZ	DESACCOUPLERONS	DESAGREABLEMENT	DESANGOISSASSES
DEREGLEMENTIONS	DESACCOUPLERONT	DESAGREGEASSENT	DESANGOISSERAIS
DEREMBOURSAIENT	DESACCOUTUMAMES	DESAGREGEASSIEZ	DESANGOISSERAIT
DEREMBOURSASSES	DESACCOUTUMANCE	DESAGREGERAIENT	DESANGOISSERENT
DEREMBOURSEMENT	DESACCOUTUMASSE	DESAIMANTASSENT	DESANGOISSERIEZ
DEREMBOURSERAIS	DESACCOUTUMATES	DESAIMANTASSIEZ	DESANGOISSERONS
DEREMBOURSERAIT	DESACCOUTUMERAI	DESAIMANTATIONS	DESANGOISSERONT
DEREMBOURSERENT	DESACCOUTUMERAS	DESAIMANTERIONS	DESANNEXASSIONS
DEREMBOURSERIEZ	DESACCOUTUMEREZ	DESAISONNALISAI	DESANNEXERAIENT
DEREMBOURSERONS	DESACCOUTUMIONS	DESAISONNALISAS	DESANNONCASSENT
DEREMBOURSERONT	DESACIDIFIAIENT	DESAISONNALISAT	DESANNONCASSIEZ
DERIVETTERAIENT	DESACIDIFIASSES	DESAISONNALISEE	DESANNONCERIONS
DERMATOLOGIQUES	DESACIDIFIERAIS	DESAISONNALISER	DESAPPARIASSENT
DERMATOLOGISTES	DESACIDIFIERAIT	DESAISONNALISES	DESAPPARIASSIEZ
DERMATOMYOSITES	DESACIDIFIERENT	DESAISONNALISEZ	DESAPPARIERIONS
DERMATOPHYTOSES	DESACIDIFIERIEZ	DESAJUSTASSIONS	DESAPPOINTAIENT
DERMOGRAPHISMES	DESACIDIFIERONS	DESAJUSTERAIENT	DESAPPOINTASSES
DERMOPHARMACIES	DESACIDIFIERONT	DESALIENASSIONS	DESAPPOINTEMENT
DERMOPROTECTEUR	DESACIERASSIONS	DESALIENERAIENT	DESAPPOINTERAIS


Mots de 15 lettres de DESAPPOINTERAIT à DESENCOMBRERIEZ - Page 20/61

DESAPPOINTERAIT	DESASSIMILERENT	DESECTORISATION	DESEMPRISONNANT
DESAPPOINTERENT	DESASSIMILERIEZ	DESECTORISERAIS	DESEMPRISONNEES
DESAPPOINTERIEZ	DESASSIMILERONS	DESECTORISERAIT	DESEMPRISONNENT
DESAPPOINTERONS	DESASSIMILERONT	DESECTORISERENT	DESEMPRISONNERA
DESAPPOINTERONT	DESASSORTIMENTS	DESECTORISERIEZ	DESEMPRISONNIEZ
DESAPPRENDRIONS	DESASSORTIRIONS	DESECTORISERONS	DESEMPRISONNONS
DESAPPROBATEURS	DESASSORTISSAIS	DESECTORISERONT	DESENCADRASSENT
DESAPPROBATIONS	DESASSORTISSAIT	DESELECTIONNAIS*	DESENCADRASSIEZ
DESAPPROBATRICE	DESASSORTISSANT	DESELECTIONNAIT*	DESENCADREMENTS
DESAPPROUVAIENT	DESASSORTISSENT	DESELECTIONNANT*	DESENCADRERIONS
DESAPPROUVASSES	DESASSORTISSIEZ	DESELECTIONNEES*	DESENCERCLAIENT*
DESAPPROUVERAIS	DESASSORTISSONS	DESELECTIONNENT*	DESENCERCLASSES*
DESAPPROUVERAIT	DESASTREUSEMENT	DESELECTIONNERA*	DESENCERCLEMENT*
DESAPPROUVERENT	DESATELLISAIENT	DESELECTIONNIEZ*	DESENCERCLERAIS*
DESAPPROUVERIEZ	DESATELLISASSES	DESELECTIONNONS*	DESENCERCLERAIT*
DESAPPROUVERONS	DESATELLISATION	DESEMBALLASSENT	DESENCERCLERENT*
DESAPPROUVERONT	DESATELLISERAIS	DESEMBALLASSIEZ	DESENCERCLERIEZ*
DESARCHIVASSENT	DESATELLISERAIT	DESEMBALLERIONS	DESENCERCLERONS*
DESARCHIVASSIEZ	DESATELLISERENT	DESEMBOBINAIENT	DESENCERCLERONT*
DESARCHIVERIONS	DESATELLISERIEZ	DESEMBOBINASSES	DESENCHAINAIENT
DESARCONNASSENT	DESATELLISERONS	DESEMBOBINERAIS	DESENCHAINASSES
DESARCONNASSIEZ	DESATELLISERONT	DESEMBOBINERAIT	DESENCHAINERAIS
DESARCONNERIONS	DESATOMISASSENT	DESEMBOBINERENT	DESENCHAINERAIT
DESARGENTASSENT	DESATOMISASSIEZ	DESEMBOBINERIEZ	DESENCHAINERENT
DESARGENTASSIEZ	DESATOMISATIONS	DESEMBOBINERONS	DESENCHAINERIEZ
DESARGENTERIONS	DESATOMISERIONS	DESEMBOBINERONT	DESENCHAINERONS
DESARRIMASSIONS	DESAVANTAGEAMES	DESEMBOURBAIENT	DESENCHAINERONT
DESARRIMERAIENT	DESAVANTAGEASSE	DESEMBOURBASSES	DESENCHANTAIENT
DESARTICULAIENT	DESAVANTAGEATES	DESEMBOURBERAIS	DESENCHANTASSES
DESARTICULASSES	DESAVANTAGERAIS	DESEMBOURBERAIT	DESENCHANTEMENT
DESARTICULATION	DESAVANTAGERAIT	DESEMBOURBERENT	DESENCHANTERAIS
DESARTICULERAIS	DESAVANTAGERENT	DESEMBOURBERIEZ	DESENCHANTERAIT
DESARTICULERAIT	DESAVANTAGERIEZ	DESEMBOURBERONS	DESENCHANTERENT
DESARTICULERENT	DESAVANTAGERONS	DESEMBOURBERONT	DESENCHANTERIEZ
DESARTICULERIEZ	DESAVANTAGERONT	DESEMBOURGEOISA	DESENCHANTERONS
DESARTICULERONS	DESAVANTAGEUSES	DESEMBOURGEOISE	DESENCHANTERONT
DESARTICULERONT	DESCOLARISAIENT	DESEMBOUTEILLAI	DESENCLAVASSENT
DESASSEMBLAIENT	DESCOLARISASSES	DESEMBOUTEILLAS	DESENCLAVASSIEZ
DESASSEMBLASSES	DESCOLARISATION	DESEMBOUTEILLAT	DESENCLAVEMENTS
DESASSEMBLERAIS	DESCOLARISERAIS	DESEMBOUTEILLEE	DESENCLAVERIONS
DESASSEMBLERAIT	DESCOLARISERAIT	DESEMBOUTEILLER	DESENCOLLASSENT
DESASSEMBLERENT	DESCOLARISERENT	DESEMBOUTEILLES	DESENCOLLASSIEZ
DESASSEMBLERIEZ	DESCOLARISERIEZ	DESEMBOUTEILLEZ	DESENCOLLERIONS
DESASSEMBLERONS	DESCOLARISERONS	DESEMPARASSIONS	DESENCOMBRAIENT
DESASSEMBLERONT	DESCOLARISERONT	DESEMPARERAIENT	DESENCOMBRASSES
DESASSIMILAIENT	DESCRIPTIVISMES	DESEMPESASSIONS	DESENCOMBREMENT
DESASSIMILASSES	DESECHOUASSIONS	DESEMPESERAIENT	DESENCOMBRERAIS
DESASSIMILATION	DESECHOUERAIENT	DESEMPLISSAIENT	DESENCOMBRERAIT
DESASSIMILERAIS	DESECTORISAIENT	DESEMPRISONNAIS	DESENCOMBRERENT
DESASSIMILERAIT	DESECTORISASSES	DESEMPRISONNAIT	DESENCOMBRERIEZ


Mots de 15 lettres de DESENCOMBRERONS à DESHUMIDIFIATES - Page 21/61

DESENCOMBRERONS	DESENGOURDIRONT	DESENTORTILLANT	DESEQUILIBRERAI
DESENCOMBRERONT	DESENGOURDISSES	DESENTORTILLEES	DESEQUILIBRERAS
DESENCRASSAIENT	DESENGOURDISSEZ	DESENTORTILLENT	DESEQUILIBREREZ
DESENCRASSASSES	DESENGRENASSENT	DESENTORTILLERA	DESEQUILIBRIONS
DESENCRASSERAIS	DESENGRENASSIEZ	DESENTORTILLIEZ	DESEQUIPASSIONS
DESENCRASSERAIT	DESENGRENERIONS	DESENTORTILLONS	DESEQUIPERAIENT
DESENCRASSERENT	DESENIVRASSIONS	DESENTRAVASSENT	DESERTIFIASSENT
DESENCRASSERIEZ	DESENIVRERAIENT	DESENTRAVASSIEZ	DESERTIFIASSIEZ
DESENCRASSERONS	DESENLACASSIONS	DESENTRAVERIONS	DESERTIFICATION
DESENCRASSERONT	DESENLACERAIENT	DESENVASASSIONS	DESERTIFIERIONS
DESENDETTASSENT	DESENLAIDIRIONS	DESENVASERAIENT	DESESPERASSIONS
DESENDETTASSIEZ	DESENLAIDISSAIS	DESENVELOPPAMES	DESESPERERAIENT
DESENDETTEMENTS	DESENLAIDISSAIT	DESENVELOPPASSE	DESETATISASSENT
DESENDETTERIONS	DESENLAIDISSANT	DESENVELOPPATES	DESETATISASSIEZ
DESENERVASSIONS	DESENLAIDISSENT	DESENVELOPPERAI	DESETATISATIONS
DESENERVERAIENT	DESENLAIDISSIEZ	DESENVELOPPERAS	DESETATISERIONS
DESENFILASSIONS	DESENLAIDISSONS	DESENVELOPPEREZ	DESEXCITASSIONS
DESENFILERAIENT	DESENNUIERAIENT	DESENVELOPPIONS	DESEXCITERAIENT
DESENFLAMMAIENT	DESENNUYASSIONS	DESENVENIMAIENT	DESEXUALISAIENT
DESENFLAMMASSES	DESENRAIERAIENT	DESENVENIMASSES	DESEXUALISASSES
DESENFLAMMERAIS	DESENRAYASSIONS	DESENVENIMERAIS	DESEXUALISATION
DESENFLAMMERAIT	DESENRAYERAIENT	DESENVENIMERAIT	DESEXUALISERAIS
DESENFLAMMERENT	DESENSABLASSENT	DESENVENIMERENT	DESEXUALISERAIT
DESENFLAMMERIEZ	DESENSABLASSIEZ	DESENVENIMERIEZ	DESEXUALISERENT
DESENFLAMMERONS	DESENSABLEMENTS	DESENVENIMERONS	DESEXUALISERIEZ
DESENFLAMMERONT	DESENSABLERIONS	DESENVENIMERONT	DESEXUALISERONS
DESENFOURNAIENT	DESENSIBILISAIS	DESENVERGUAIENT	DESEXUALISERONT
DESENFOURNASSES	DESENSIBILISAIT	DESENVERGUASSES	DESHABILLASSENT
DESENFOURNERAIS	DESENSIBILISANT	DESENVERGUERAIS	DESHABILLASSIEZ
DESENFOURNERAIT	DESENSIBILISEES	DESENVERGUERAIT	DESHABILLERIONS
DESENFOURNERENT	DESENSIBILISENT	DESENVERGUERENT	DESHABITUASSENT
DESENFOURNERIEZ	DESENSIBILISERA	DESENVERGUERIEZ	DESHABITUASSIEZ
DESENFOURNERONS	DESENSIBILISIEZ	DESENVERGUERONS	DESHABITUERIONS
DESENFOURNERONT	DESENSIBILISONS	DESENVERGUERONT	DESHERITASSIONS
DESENFUMASSIONS	DESENSIMASSIONS	DESENVOUTASSENT	DESHERITERAIENT
DESENFUMERAIENT	DESENSIMERAIENT	DESENVOUTASSIEZ	DESHONORASSIONS
DESENGAGEASSENT	DESENSORCELAMES	DESENVOUTEMENTS	DESHONORERAIENT
DESENGAGEASSIEZ	DESENSORCELASSE	DESENVOUTERIONS	DESHUMANISAIENT
DESENGAGERAIENT	DESENSORCELATES	DESEPAISSIRIONS	DESHUMANISANTES
DESENGLUASSIONS	DESENSORCELERAI*	DESEPAISSISSAIS	DESHUMANISASSES
DESENGLUERAIENT	DESENSORCELERAS*	DESEPAISSISSAIT	DESHUMANISATION
DESENGORGEAIENT	DESENSORCELEREZ*	DESEPAISSISSANT	DESHUMANISERAIS
DESENGORGEASSES	DESENSORCELIONS	DESEPAISSISSENT	DESHUMANISERAIT
DESENGORGEMENTS	DESENSORCELLENT	DESEPAISSISSIEZ	DESHUMANISERENT
DESENGORGERIONS	DESENSORCELLERA	DESEPAISSISSONS	DESHUMANISERIEZ
DESENGOURDIRAIS	DESENTOILASSENT	DESEQUILIBRAMES	DESHUMANISERONS
DESENGOURDIRAIT	DESENTOILASSIEZ	DESEQUILIBRANTE	DESHUMANISERONT
DESENGOURDIRENT	DESENTOILERIONS	DESEQUILIBRANTS	DESHUMIDIFIAMES
DESENGOURDIRIEZ	DESENTORTILLAIS	DESEQUILIBRASSE	DESHUMIDIFIASSE
DESENGOURDIRONS	DESENTORTILLAIT	DESEQUILIBRATES	DESHUMIDIFIATES


Mots de 15 lettres de DESHUMIDIFIERAI à DESSAISISSAIENT - Page 22/61

DESHUMIDIFIERAI	DESINCARNASSENT	DESINSTALLASSES	DESOCIALISERAIS
DESHUMIDIFIERAS	DESINCARNASSIEZ	DESINSTALLATION	DESOCIALISERAIT
DESHUMIDIFIEREZ	DESINCARNATIONS	DESINSTALLERAIS	DESOCIALISERENT
DESHUMIDIFIIONS	DESINCARNERIONS	DESINSTALLERAIT	DESOCIALISERIEZ
DESHYDRATASSENT	DESINCORPORAMES	DESINSTALLERENT	DESOCIALISERONS
DESHYDRATASSIEZ	DESINCORPORASSE	DESINSTALLERIEZ	DESOCIALISERONT
DESHYDRATATIONS	DESINCORPORATES	DESINSTALLERONS	DESODORISASSENT
DESHYDRATERIONS	DESINCORPORERAI	DESINSTALLERONT	DESODORISASSIEZ
DESHYDROGENAMES	DESINCORPORERAS	DESINTEGRASSENT	DESODORISATIONS
DESHYDROGENASSE	DESINCORPOREREZ	DESINTEGRASSIEZ	DESODORISERIONS
DESHYDROGENATES	DESINCORPORIONS	DESINTEGRATIONS	DESOLIDARISAMES
DESHYDROGENERAI	DESINCRUSTAIENT	DESINTEGRERIONS	DESOLIDARISASSE
DESHYDROGENERAS	DESINCRUSTANTES	DESINTERESSAMES	DESOLIDARISATES
DESHYDROGENEREZ	DESINCRUSTASSES	DESINTERESSASSE	DESOLIDARISERAI
DESHYDROGENIONS	DESINCRUSTATION	DESINTERESSATES	DESOLIDARISERAS
DESHYPOTHEQUAIS	DESINCRUSTERAIS	DESINTERESSERAI	DESOLIDARISEREZ
DESHYPOTHEQUAIT	DESINCRUSTERAIT	DESINTERESSERAS	DESOLIDARISIONS
DESHYPOTHEQUANT	DESINCRUSTERENT	DESINTERESSEREZ	DESOPERCULAIENT
DESHYPOTHEQUEES	DESINCRUSTERIEZ	DESINTERESSIONS	DESOPERCULASSES
DESHYPOTHEQUENT	DESINCRUSTERONS	DESINTOXICATION	DESOPERCULATEUR
DESHYPOTHEQUERA	DESINCRUSTERONT	DESINTOXIQUAMES	DESOPERCULERAIS
DESHYPOTHEQUIEZ	DESINDEXASSIONS	DESINTOXIQUANTE	DESOPERCULERAIT
DESHYPOTHEQUONS	DESINDEXERAIENT	DESINTOXIQUANTS	DESOPERCULERENT
DESIDEOLOGISAIS	DESINFECTASSENT	DESINTOXIQUASSE	DESOPERCULERIEZ
DESIDEOLOGISAIT	DESINFECTASSIEZ	DESINTOXIQUATES	DESOPERCULERONS
DESIDEOLOGISANT	DESINFECTERIONS	DESINTOXIQUERAI	DESOPERCULERONT
DESIDEOLOGISEES	DESINFORMASSENT	DESINTOXIQUERAS	DESORBITASSIONS
DESIDEOLOGISENT	DESINFORMASSIEZ	DESINTOXIQUEREZ	DESORBITERAIENT
DESIDEOLOGISERA	DESINFORMATEURS	DESINTOXIQUIONS	DESORDONNASSENT
DESIDEOLOGISIEZ	DESINFORMATIONS	DESINVESTIRIONS	DESORDONNASSIEZ
DESIDEOLOGISONS	DESINFORMATRICE	DESINVESTISSAIS	DESORDONNERIONS
DESIDERABILITES	DESINFORMERIONS	DESINVESTISSAIT	DESORGANISAIENT
DESILLUSIONNAIS	DESINHIBASSIONS	DESINVESTISSANT	DESORGANISASSES
DESILLUSIONNAIT	DESINHIBERAIENT	DESINVESTISSENT	DESORGANISATEUR
DESILLUSIONNANT	DESINHIBITRICES	DESINVESTISSIEZ	DESORGANISATION
DESILLUSIONNEES	DESINSCRIPTIONS	DESINVESTISSONS	DESORGANISERAIS
DESILLUSIONNENT	DESINSCRIRAIENT	DESINVITASSIONS	DESORGANISERAIT
DESILLUSIONNERA	DESINSCRIVAIENT	DESINVITERAIENT	DESORGANISERENT
DESILLUSIONNIEZ	DESINSCRIVIRENT	DESOBLIGEAMMENT	DESORGANISERIEZ
DESILLUSIONNONS	DESINSCRIVISSES	DESOBLIGEASSENT	DESORGANISERONS
DESIMLOCKASSENT*	DESINSECTISAMES	DESOBLIGEASSIEZ	DESORGANISERONT
DESIMLOCKASSIEZ*	DESINSECTISASSE	DESOBLIGERAIENT	DESORIENTASSENT
DESIMLOCKERIONS*	DESINSECTISATES	DESOBLITERATION	DESORIENTASSIEZ
DESINCARCERAMES	DESINSECTISERAI	DESOBSTRUASSENT	DESORIENTATIONS
DESINCARCERASSE	DESINSECTISERAS	DESOBSTRUASSIEZ	DESORIENTERIONS
DESINCARCERATES	DESINSECTISEREZ	DESOBSTRUCTIONS	DESOXYGENASSENT
DESINCARCERERAI	DESINSECTISIONS	DESOBSTRUERIONS	DESOXYGENASSIEZ
DESINCARCERERAS	DESINSERASSIONS	DESOCIALISAIENT	DESOXYGENATIONS
DESINCARCEREREZ	DESINSERERAIENT	DESOCIALISASSES	DESOXYGENERIONS
DESINCARCERIONS	DESINSTALLAIENT	DESOCIALISATION	DESSAISISSAIENT


Mots de 15 lettres de DESSAISISSEMENT à DIFFERENCIANTES - Page 23/61

DESSAISISSEMENT	DESTRUCTURASSES	DETERMINERAIENT	DEVITALISATIONS
DESSAISONALISAI	DESTRUCTURATION	DETORTILLASSENT	DEVITALISERIONS
DESSAISONALISAS	DESTRUCTURERAIS	DETORTILLASSIEZ	DEVITRIFIASSENT
DESSAISONALISAT	DESTRUCTURERAIT	DETORTILLERIONS	DEVITRIFIASSIEZ
DESSAISONALISEE	DESTRUCTURERENT	DETOXIFIASSIONS	DEVITRIFICATION
DESSAISONALISER	DESTRUCTURERIEZ	DETOXIFICATIONS	DEVITRIFIERIONS
DESSAISONALISES	DESTRUCTURERONS	DETOXIFIERAIENT	DEXTRINISATIONS
DESSAISONALISEZ	DESTRUCTURERONT	DETOXIQUASSIONS	DEXTROMORAMIDES
DESSALINISAIENT*	DESUBJECTIVISAI	DETOXIQUERAIENT	DIABETOLOGIQUES
DESSALINISASSES*	DESUBJECTIVISAS	DETRICOTASSIONS	DIABOLISASSIONS
DESSALINISATION	DESUBJECTIVISAT	DETRICOTERAIENT	DIABOLISERAIENT
DESSALINISERAIS*	DESUBJECTIVISEE	DETROUSSASSIONS	DIAGNOSTICIENNE
DESSALINISERAIT*	DESUBJECTIVISER	DETROUSSERAIENT	DIAGNOSTIQUAMES
DESSALINISERENT*	DESUBJECTIVISES	DEUTEROSTOMIENS	DIAGNOSTIQUASSE
DESSALINISERIEZ*	DESUBJECTIVISEZ	DEVALORISASSENT	DIAGNOSTIQUATES
DESSALINISERONS*	DESULFITASSIONS	DEVALORISASSIEZ	DIAGNOSTIQUERAI
DESSALINISERONT*	DESULFITERAIENT	DEVALORISATIONS	DIAGNOSTIQUERAS
DESSANGLASSIONS	DESULFURASSIONS	DEVALORISERIONS	DIAGNOSTIQUEREZ
DESSANGLERAIENT	DESULFURERAIENT	DEVELOPPASSIONS	DIAGNOSTIQUEURS
DESSAOULASSIONS	DESURCHAUFFAMES	DEVELOPPEMENTAL	DIAGNOSTIQUEUSE
DESSAOULERAIENT	DESURCHAUFFASSE	DEVELOPPERAIENT	DIAGNOSTIQUIONS
DESSERTISSAIENT	DESURCHAUFFATES	DEVERGONDASSENT	DIAGONALISABLES
DESSOUCHASSIONS	DESURCHAUFFERAI	DEVERGONDASSIEZ	DIAGONALISAIENT
DESSOUCHERAIENT	DESURCHAUFFERAS	DEVERGONDERIONS	DIAGONALISASSES
DESSUINTASSIONS	DESURCHAUFFEREZ	DEVERROUILLAGES	DIAGONALISATION
DESSUINTERAIENT	DESURCHAUFFEURS	DEVERROUILLAMES	DIAGONALISERAIS
DESTABILISAIENT	DESURCHAUFFIONS	DEVERROUILLASSE	DIAGONALISERAIT
DESTABILISANTES	DESYNCHRONISAIS	DEVERROUILLATES	DIAGONALISERENT
DESTABILISASSES	DESYNCHRONISAIT	DEVERROUILLERAI	DIAGONALISERIEZ
DESTABILISATEUR	DESYNCHRONISANT	DEVERROUILLERAS	DIAGONALISERONS
DESTABILISATION	DESYNCHRONISEES	DEVERROUILLEREZ	DIAGONALISERONT
DESTABILISERAIS	DESYNCHRONISENT	DEVERROUILLIONS	DIALECTICIENNES
DESTABILISERAIT	DESYNCHRONISERA	DEVIATIONNISMES	DIALECTIQUEMENT
DESTABILISERENT	DESYNCHRONISIEZ	DEVIATIONNISTES	DIALECTISASSENT
DESTABILISERIEZ	DESYNCHRONISONS	DEVIERGEASSIONS	DIALECTISASSIEZ
DESTABILISERONS	DESYNDICALISAIS	DEVIRGINISAIENT	DIALECTISERIONS
DESTABILISERONT	DESYNDICALISAIT	DEVIRGINISASSES	DIALECTOLOGIQUE
DESTALINISAIENT	DESYNDICALISANT	DEVIRGINISERAIS	DIAPHANOSCOPIES
DESTALINISASSES	DESYNDICALISEES	DEVIRGINISERAIT	DIAPHRAGMASSENT
DESTALINISATION	DESYNDICALISENT	DEVIRGINISERENT	DIAPHRAGMASSIEZ
DESTALINISERAIS	DESYNDICALISERA	DEVIRGINISERIEZ	DIAPHRAGMATIQUE
DESTALINISERAIT	DESYNDICALISIEZ	DEVIRGINISERONS	DIAPHRAGMERIONS
DESTALINISERENT	DESYNDICALISONS	DEVIRGINISERONT	DIATHERMANEITES
DESTALINISERIEZ	DETALONNASSIONS	DEVIRILISASSENT	DICTIONNAIRIQUE
DESTALINISERONS	DETALONNERAIENT	DEVIRILISASSIEZ	DICTIONNARISTES
DESTALINISERONT	DETAPISSASSIONS	DEVIRILISATIONS	DIENCEPHALIQUES
DESTRESSASSIONS	DETAPISSERAIENT	DEVIRILISERIONS	DIESELISASSIONS
DESTRESSERAIENT	DETERIORASSIONS	DEVISAGEASSIONS	DIESELISERAIENT
DESTRUCTURAIENT	DETERIORERAIENT	DEVITALISASSENT	DIFFERENCIAIENT
DESTRUCTURANTES	DETERMINASSIONS	DEVITALISASSIEZ	DIFFERENCIANTES*


Mots de 15 lettres de DIFFERENCIASSES à DYSFONCTIONNAIT - Page 24/61

DIFFERENCIASSES	DISCIPLINASSENT	DISJOIGNISSIONS	DOCUMENTERAIENT
DIFFERENCIATEUR	DISCIPLINASSIEZ	DISJONCTASSIONS	DODECAPHONIQUES
DIFFERENCIATION	DISCIPLINERIONS	DISJONCTERAIENT	DODECAPHONISMES
DIFFERENCIERAIS	DISCOGRAPHIQUES	DISPARAISSAIENT	DODECAPHONISTES
DIFFERENCIERAIT	DISCOMPTASSIONS	DISPARAITRAIENT	DOGMATISASSIONS
DIFFERENCIERENT	DISCOMPTERAIENT	DISPATCHASSIONS	DOGMATISERAIENT
DIFFERENCIERIEZ	DISCONTINUAIENT	DISPATCHERAIENT	DOLICHOCEPHALES
DIFFERENCIERONS	DISCONTINUASSES	DISPROPORTIONNE	DOLLARISASSIONS
DIFFERENCIERONT	DISCONTINUATION	DISPUTAILLAIENT	DOLLARISERAIENT
DIFFERENTIABLES	DISCONTINUERAIS	DISPUTAILLASSES	DOLOMITISATIONS
DIFFERENTIAIENT	DISCONTINUERAIT	DISPUTAILLERAIS	DOMANIALISAIENT
DIFFERENTIASSES	DISCONTINUERENT	DISPUTAILLERAIT	DOMANIALISASSES
DIFFERENTIATEUR	DISCONTINUERIEZ	DISPUTAILLERENT	DOMANIALISERAIS
DIFFERENTIATION	DISCONTINUERONS	DISPUTAILLERIEZ	DOMANIALISERAIT
DIFFERENTIELLES	DISCONTINUERONT	DISPUTAILLERONS	DOMANIALISERENT
DIFFERENTIERAIS	DISCONVIENDRAIS	DISPUTAILLERONT	DOMANIALISERIEZ
DIFFERENTIERAIT	DISCONVIENDRAIT	DISQUALIFIAIENT	DOMANIALISERONS
DIFFERENTIERENT	DISCONVIENDRIEZ	DISQUALIFIASSES	DOMANIALISERONT
DIFFERENTIERIEZ	DISCONVIENDRONS	DISQUALIFIERAIS	DOMESTIQUASSENT
DIFFERENTIERONS	DISCONVIENDRONT	DISQUALIFIERAIT	DOMESTIQUASSIEZ
DIFFERENTIERONT	DISCONVINSSIONS	DISQUALIFIERENT	DOMESTIQUERIONS
DIFFICULTUEUSES	DISCOUNTASSIONS	DISQUALIFIERIEZ	DOMICILIASSIONS
DIFFRACTASSIONS	DISCOUNTERAIENT	DISQUALIFIERONS	DOMICILIATAIRES
DIFFRACTERAIENT	DISCREDITASSENT	DISQUALIFIERONT	DOMICILIERAIENT
DIFFUSIONNISMES	DISCREDITASSIEZ	DISSEMINASSIONS	DONJUANISASSENT
DIFFUSIONNISTES	DISCREDITERIONS	DISSEMINERAIENT	DONJUANISASSIEZ
DIGITALISASSENT	DISCRETIONNAIRE	DISSIMULASSIONS	DONJUANISERIONS
DIGITALISASSIEZ	DISCRETISASSENT	DISSIMULATRICES	DONQUICHOTTISME
DIGITALISATIONS	DISCRETISASSIEZ	DISSIMULERAIENT	DOPAMINERGIQUES
DIGITALISERIONS	DISCRETISATIONS	DISSOCIABILITES	DOSTOIEVSKIENNE
DIGITOPONCTURES*	DISCRETISERIONS	DISTANCIASSIONS	DOUBLONNASSIONS
DIGITOPUNCTURES	DISCRIMINASSENT	DISTANCIERAIENT	DOUBLONNERAIENT
DILIGENTASSIONS	DISCRIMINASSIEZ	DISTINGUASSIONS	DOULOUREUSEMENT
DILIGENTERAIENT	DISCRIMINATEURS	DISTINGUERAIENT	DRAGEIFIASSIONS
DIMENSIONNAIENT	DISCRIMINATIONS	DISTRIBUASSIONS	DRAGEIFIERAIENT
DIMENSIONNASSES	DISCRIMINATIVES	DISTRIBUERAIENT	DRAGEONNASSIONS
DIMENSIONNELLES	DISCRIMINATOIRE	DISTRIBUTIONNEL	DRAGEONNERAIENT
DIMENSIONNEMENT	DISCRIMINERIONS	DISTRIBUTIVITES	DRAMATISASSIONS
DIMENSIONNERAIS	DISCUTAILLAIENT	DIVERSIFIASSENT	DRAMATISERAIENT
DIMENSIONNERAIT	DISCUTAILLASSES	DIVERSIFIASSIEZ	DREPANOCYTAIRES
DIMENSIONNERENT	DISCUTAILLERAIS	DIVERSIFICATION	DRUMMONDVILLOIS
DIMENSIONNERIEZ	DISCUTAILLERAIT	DIVERSIFIERIONS	DUDGEONNASSIONS
DIMENSIONNERONS	DISCUTAILLERENT	DIVERTISSEMENTS	DUDGEONNERAIENT
DIMENSIONNERONT	DISCUTAILLERIES	DIVULGACHASSENT*	DYNAMOMETRIQUES
DINITROTOLUENES	DISCUTAILLERIEZ	DIVULGACHASSIEZ*	DYSACROMELIQUES
DIPHTONGUASSENT	DISCUTAILLERONS	DIVULGACHERIONS*	DYSCHROMATOPSIE
DIPHTONGUASSIEZ	DISCUTAILLERONT	DOCTRINAIREMENT	DYSEMBRYOPLASIE
DIPHTONGUERIONS	DISCUTAILLEUSES	DOCUMENTALISTES	DYSENDOCRINIENS
DIPLOBLASTIQUES	DISGRACIASSIONS	DOCUMENTARISTES	DYSFONCTIONNAIS
DIRECTIONNELLES	DISGRACIERAIENT	DOCUMENTASSIONS	DYSFONCTIONNAIT


Mots de 15 lettres de DYSFONCTIONNANT à ELECTROMENAGERE - Page 25/61

DYSFONCTIONNANT	ECHANTILLONNONS	ECOPASTORALISME*	EFFLANQUERAIENT
DYSFONCTIONNELS	ECHARDONNASSENT	ECOPHYSIOLOGIES	EFFLEURISSAIENT
DYSFONCTIONNENT	ECHARDONNASSIEZ	ECORESPONSABLES	EFFRANGEASSIONS
DYSFONCTIONNERA	ECHARDONNERIONS	ECORNIFLASSIONS	EGOURMANDASSENT
DYSFONCTIONNIEZ	ECHAROGNASSIONS	ECORNIFLERAIENT	EGOURMANDASSIEZ
DYSFONCTIONNONS	ECHAROGNERAIENT	ECOTOXICOLOGIES	EGOURMANDERIONS
DYSMENORRHEIQUE	ECHELONNASSIONS	ECOURTICHASSENT	EGRATIGNASSIONS
DYSMORPHOPHOBIE	ECHELONNERAIENT	ECOURTICHASSIEZ	EGRATIGNERAIENT
DYSORTHOGRAPHIE	ECHENILLASSIONS	ECOURTICHERIONS	EGRAVILLONNAMES
DYSTROPHISATION	ECHENILLERAIENT	ECOUVILLONNAGES	EGRAVILLONNASSE
EBOUILLANTAIENT	ECHEVELLERAIENT	ECOUVILLONNAMES	EGRAVILLONNATES
EBOUILLANTASSES	ECHOGRAPHIAIENT	ECOUVILLONNASSE	EGRAVILLONNERAI
EBOUILLANTERAIS	ECHOGRAPHIASSES	ECOUVILLONNATES	EGRAVILLONNERAS
EBOUILLANTERAIT	ECHOGRAPHIERAIS	ECOUVILLONNERAI	EGRAVILLONNEREZ
EBOUILLANTERENT	ECHOGRAPHIERAIT	ECOUVILLONNERAS	EGRAVILLONNIONS
EBOUILLANTERIEZ	ECHOGRAPHIERENT	ECOUVILLONNEREZ	ELASTICIMETRIES
EBOUILLANTERONS	ECHOGRAPHIERIEZ	ECOUVILLONNIONS	ELECTRIFIASSENT
EBOUILLANTERONT	ECHOGRAPHIERONS	ECOVOLONTARIATS	ELECTRIFIASSIEZ
EBOURGEONNAIENT	ECHOGRAPHIERONT	ECRABOUILLAIENT	ELECTRIFICATION
EBOURGEONNASSES	ECHOTOMOGRAPHIE	ECRABOUILLASSES	ELECTRIFIERIONS
EBOURGEONNEMENT	ECLABOUSSASSENT	ECRABOUILLEMENT	ELECTRISASSIONS
EBOURGEONNERAIS	ECLABOUSSASSIEZ	ECRABOUILLERAIS	ELECTRISERAIENT
EBOURGEONNERAIT	ECLABOUSSEMENTS	ECRABOUILLERAIT	ELECTROAFFINITE
EBOURGEONNERENT	ECLABOUSSERIONS	ECRABOUILLERENT	ELECTROBIOLOGIE
EBOURGEONNERIEZ	ECLAIRCISSAIENT	ECRABOUILLERIEZ	ELECTROCAUTERES
EBOURGEONNERONS	ECLAIRCISSANTES	ECRABOUILLERONS	ELECTROCHIMIQUE
EBOURGEONNERONT	ECLAIRCISSEMENT	ECRABOUILLERONT	ELECTROCUTAIENT
EBOURIFFASSIONS	ECOBLANCHIMENTS	ECRAPOUTIRAIENT	ELECTROCUTASSES
EBOURIFFERAIENT	ECOCITOYENNETES	ECRAPOUTISSIONS	ELECTROCUTERAIS
EBULLIOMETRIQUE	ECOCONSTRUCTION	ECRIVAILLASSENT	ELECTROCUTERAIT
EBULLIOSCOPIQUE	ECOCRIMINALITES	ECRIVAILLASSIEZ	ELECTROCUTERENT
ECARQUILLASSENT	ECOLABELISAIENT*	ECRIVAILLERIONS	ELECTROCUTERIEZ
ECARQUILLASSIEZ	ECOLABELISASSES*	ECRIVASSASSIONS	ELECTROCUTERONS
ECARQUILLEMENTS	ECOLABELISERAIS*	ECRIVASSERAIENT	ELECTROCUTERONT
ECARQUILLERIONS	ECOLABELISERAIT*	ECUSSONNASSIONS	ELECTRODERMALES
ECCLESIASTIQUES	ECOLABELISERENT*	ECUSSONNERAIENT	ELECTRODIALYSES
ECCLESIOLOGIQUE	ECOLABELISERIEZ*	EDIMBOURGEOISES	ELECTROEROSIONS
ECHAFAUDASSIONS	ECOLABELISERONS*	EDITIONNASSIONS	ELECTROFORMAGES
ECHAFAUDERAIENT	ECOLABELISERONT*	EDITIONNERAIENT	ELECTROLOCATION
ECHALASSASSIONS	ECOLABELLISAMES*	EDMONTONNIENNES	ELECTROLYSABLES
ECHALASSERAIENT	ECOLABELLISASSE*	EDUCATIONNELLES	ELECTROLYSAIENT
ECHANTILLONNAGE	ECOLABELLISATES*	EFFAROUCHASSENT	ELECTROLYSASSES
ECHANTILLONNAIS	ECOLABELLISERAI*	EFFAROUCHASSIEZ	ELECTROLYSERAIS
ECHANTILLONNAIT	ECOLABELLISERAS*	EFFAROUCHEMENTS	ELECTROLYSERAIT
ECHANTILLONNANT	ECOLABELLISEREZ*	EFFAROUCHERIONS	ELECTROLYSERENT
ECHANTILLONNEES	ECOLABELLISIONS*	EFFEUILLASSIONS	ELECTROLYSERIEZ
ECHANTILLONNENT	ECONDUISISSIONS	EFFEUILLERAIENT	ELECTROLYSERONS
ECHANTILLONNERA	ECONOMETRICIENS	EFFILOCHASSIONS	ELECTROLYSERONT
ECHANTILLONNEUR	ECONOMISASSIONS	EFFILOCHERAIENT	ELECTROLYTIQUES
ECHANTILLONNIEZ	ECONOMISERAIENT	EFFLANQUASSIONS	ELECTROMENAGERE


Mots de 15 lettres de ELECTROMENAGERS à ENCARTONNASSENT - Page 26/61

ELECTROMENAGERS	EMBERLIFICOTENT	EMERVEILLERIONS	EMPOISSONNERAIS
ELECTROMETRIQUE	EMBERLIFICOTERA	EMMAGASINASSENT	EMPOISSONNERAIT
ELECTROMOTRICES	EMBERLIFICOTEUR	EMMAGASINASSIEZ	EMPOISSONNERENT
ELECTRONARCOSES	EMBERLIFICOTIEZ	EMMAGASINEMENTS	EMPOISSONNERIEZ
ELECTRONEGATIFS	EMBERLIFICOTONS	EMMAGASINERIONS	EMPOISSONNERONS
ELECTRONEGATIVE	EMBOBELINASSENT	EMMAILLOTASSENT	EMPOISSONNERONT
ELECTRONICIENNE	EMBOBELINASSIEZ	EMMAILLOTASSIEZ	EMPOURPRASSIONS
ELECTRONOGRAMME	EMBOBELINERIONS	EMMAILLOTEMENTS	EMPOURPRERAIENT
ELECTROPHORESES	EMBOUCANASSIONS	EMMAILLOTERIONS	EMPOUSSIERAIENT
ELECTROPONCTURE	EMBOUCANERAIENT	EMMENAGEASSIONS	EMPOUSSIERASSES
ELECTROPORTATIF	EMBOURGEOISAMES	EMMITONNASSIONS	EMPOUSSIEREMENT
ELECTROPOSITIFS	EMBOURGEOISASSE	EMMITONNERAIENT	EMPOUSSIERERAIS
ELECTROPOSITIVE	EMBOURGEOISATES	EMMITOUFLASSENT	EMPOUSSIERERAIT
ELECTROPUNCTURE	EMBOURGEOISERAI	EMMITOUFLASSIEZ	EMPOUSSIERERENT
ELECTROSENSIBLE	EMBOURGEOISERAS	EMMITOUFLERIONS	EMPOUSSIERERIEZ
ELECTROSTATIQUE	EMBOURGEOISEREZ	EMMOUSCAILLAMES	EMPOUSSIERERONS
ELECTROTHERAPIE	EMBOURGEOISIONS	EMMOUSCAILLASSE	EMPOUSSIERERONT
ELECTROTHERMIES	EMBOUTEILLAIENT	EMMOUSCAILLATES	EMPREIGNISSIONS
ELECTROTROPISME	EMBOUTEILLASSES	EMMOUSCAILLERAI	EMPRESURASSIONS
ELECTROVALENCES	EMBOUTEILLERAIS	EMMOUSCAILLERAS	EMPRESURERAIENT
ELEPHANTIASIQUE	EMBOUTEILLERAIT	EMMOUSCAILLEREZ	EMPRISONNASSENT
EMBARBOUILLAMES	EMBOUTEILLERENT	EMMOUSCAILLIONS	EMPRISONNASSIEZ
EMBARBOUILLASSE	EMBOUTEILLERIEZ	EMOTIONNASSIONS	EMPRISONNEMENTS
EMBARBOUILLATES	EMBOUTEILLERONS	EMOTIONNERAIENT	EMPRISONNERIONS
EMBARBOUILLERAI	EMBOUTEILLERONT	EMOUCHETASSIONS	EMPUANTISSAIENT
EMBARBOUILLERAS	EMBOUTEILLEUSES	EMOUCHETERAIENT*	EMPUANTISSEMENT
EMBARBOUILLEREZ	EMBRANCHASSIONS	EMOUCHETTERIONS	EMPYREUMATIQUES
EMBARBOUILLIONS	EMBRANCHERAIENT	EMOUSTILLASSENT	EMULSIFIASSIONS
EMBARDOUFLAIENT	EMBRIGADASSIONS	EMOUSTILLASSIEZ	EMULSIFIERAIENT
EMBARDOUFLASSES	EMBRIGADERAIENT	EMOUSTILLERIONS	EMULSIONNASSENT
EMBARDOUFLERAIS	EMBRINGUASSIONS	EMPANACHASSIONS	EMULSIONNASSIEZ
EMBARDOUFLERAIT	EMBRINGUERAIENT	EMPANACHERAIENT	EMULSIONNERIONS
EMBARDOUFLERENT	EMBRONCHASSIONS	EMPAQUETASSIONS	ENCAGOULASSIONS
EMBARDOUFLERIEZ	EMBRONCHERAIENT	EMPAQUETERAIENT*	ENCAGOULERAIENT
EMBARDOUFLERONS	EMBROUILLAMINIS	EMPAQUETTERIONS	ENCALMINASSIONS*
EMBARDOUFLERONT	EMBROUILLASSENT	EMPENNELASSIONS	ENCALMINERAIENT*
EMBARRASSASSENT	EMBROUILLASSIEZ	EMPENNELERAIENT*	ENCANAILLASSENT
EMBARRASSASSIEZ	EMBROUILLEMENTS	EMPENNELLERIONS	ENCANAILLASSIEZ
EMBARRASSERIONS	EMBROUILLERIONS	EMPHYSEMATEUSES	ENCANAILLEMENTS
EMBASTILLASSENT	EMBROUSSAILLAIS	EMPIERGEASSIONS*	ENCANAILLERIONS
EMBASTILLASSIEZ	EMBROUSSAILLAIT	EMPLAFONNASSENT	ENCAPSULASSIONS
EMBASTILLEMENTS	EMBROUSSAILLANT	EMPLAFONNASSIEZ	ENCAPSULERAIENT
EMBASTILLERIONS	EMBROUSSAILLEES	EMPLAFONNERIONS	ENCAPUCHONNAMES
EMBEGUINASSIONS	EMBROUSSAILLENT	EMPOISONNASSENT	ENCAPUCHONNASSE
EMBEGUINERAIENT	EMBROUSSAILLERA	EMPOISONNASSIEZ	ENCAPUCHONNATES
EMBELLISSEMENTS	EMBROUSSAILLIEZ	EMPOISONNEMENTS	ENCAPUCHONNERAI
EMBERLIFICOTAIS	EMBROUSSAILLONS	EMPOISONNERIONS	ENCAPUCHONNERAS
EMBERLIFICOTAIT	EMERVEILLASSENT	EMPOISSONNAIENT	ENCAPUCHONNEREZ
EMBERLIFICOTANT	EMERVEILLASSIEZ	EMPOISSONNASSES	ENCAPUCHONNIONS
EMBERLIFICOTEES	EMERVEILLEMENTS	EMPOISSONNEMENT	ENCARTONNASSENT


Mots de 15 lettres de ENCARTONNASSIEZ à ENTHOUSIASMAMES - Page 27/61

ENCARTONNASSIEZ	ENCHIFRENASSIEZ	ENFOURCHASSIONS	ENREGIMENTAIENT
ENCARTONNERIONS	ENCHIFRENEMENTS	ENFOURCHERAIENT	ENREGIMENTASSES
ENCASERNASSIONS	ENCHIFRENERIONS	ENFREIGNISSIONS	ENREGIMENTEMENT
ENCASERNERAIENT	ENCLENCHASSIONS	ENFUTAILLASSENT	ENREGIMENTERAIS
ENCASTELASSIONS	ENCLENCHERAIENT	ENFUTAILLASSIEZ	ENREGIMENTERAIT
ENCASTELERAIENT	ENCLIQUETASSENT	ENFUTAILLERIONS	ENREGIMENTERENT
ENCAUSTIQUAIENT	ENCLIQUETASSIEZ	ENGAZONNASSIONS	ENREGIMENTERIEZ
ENCAUSTIQUASSES	ENCLIQUETERIONS*	ENGAZONNERAIENT	ENREGIMENTERONS
ENCAUSTIQUERAIS	ENCLIQUETTERAIS	ENGLOUTISSAIENT	ENREGIMENTERONT
ENCAUSTIQUERAIT	ENCLIQUETTERAIT	ENGLOUTISSEMENT	ENREGISTRASSENT
ENCAUSTIQUERENT	ENCLIQUETTERIEZ	ENGOUFFRASSIONS	ENREGISTRASSIEZ
ENCAUSTIQUERIEZ	ENCLIQUETTERONS	ENGOUFFRERAIENT	ENREGISTREMENTS
ENCAUSTIQUERONS	ENCLIQUETTERONT	ENGOURDISSAIENT	ENREGISTRERIONS
ENCAUSTIQUERONT	ENCORBELLEMENTS	ENGOURDISSEMENT	ENRICHISSEMENTS
ENCELLULASSIONS	ENCOURAGEASSENT	ENGRAISSASSIONS	ENROUILLASSIONS
ENCELLULERAIENT	ENCOURAGEASSIEZ	ENGRAISSERAIENT	ENROUILLERAIENT
ENCEPHALITIQUES	ENCOURAGERAIENT	ENGRANGEASSIONS	ENRUBANNASSIONS
ENCEPHALOGRAMME	ENCYCLOPEDIQUES	ENGRUMELASSIONS	ENRUBANNERAIENT
ENCEPHALOPATHIE	ENCYCLOPEDISMES	ENGRUMELERAIENT*	ENSAISINASSIONS
ENCHAPERONNAMES	ENCYCLOPEDISTES	ENGRUMELLERIONS	ENSAISINERAIENT
ENCHAPERONNASSE	ENDEMOEPIDEMIES	ENGUIRLANDAIENT	ENSANGLANTAIENT
ENCHAPERONNATES	ENDEUILLASSIONS	ENGUIRLANDASSES	ENSANGLANTASSES
ENCHAPERONNERAI	ENDEUILLERAIENT	ENGUIRLANDERAIS	ENSANGLANTERAIS
ENCHAPERONNERAS	ENDIMANCHASSENT	ENGUIRLANDERAIT	ENSANGLANTERAIT
ENCHAPERONNEREZ	ENDIMANCHASSIEZ	ENGUIRLANDERENT	ENSANGLANTERENT
ENCHAPERONNIONS	ENDIMANCHERIONS	ENGUIRLANDERIEZ	ENSANGLANTERIEZ
ENCHATELASSIONS	ENDIVISIONNAMES	ENGUIRLANDERONS	ENSANGLANTERONS
ENCHATELERAIENT	ENDIVISIONNASSE	ENGUIRLANDERONT	ENSANGLANTERONT
ENCHATONNASSENT	ENDIVISIONNATES	ENHARNACHASSENT	ENSAUVAGEASSENT
ENCHATONNASSIEZ	ENDIVISIONNERAI	ENHARNACHASSIEZ	ENSAUVAGEASSIEZ
ENCHATONNEMENTS	ENDIVISIONNERAS	ENHARNACHERIONS	ENSAUVAGERAIENT
ENCHATONNERIONS	ENDIVISIONNEREZ	ENIGMATIQUEMENT	ENSEMENCASSIONS
ENCHAUSSASSIONS	ENDIVISIONNIONS	ENJAVELLERAIENT	ENSEMENCERAIENT
ENCHAUSSERAIENT	ENDOCRINOLOGIES	ENJUPONNASSIONS	ENSEVELISSAIENT
ENCHEMISASSIONS	ENDOCRINOLOGUES	ENJUPONNERAIENT	ENSEVELISSEMENT
ENCHEMISERAIENT	ENDOCTRINASSENT	ENLAIDISSEMENTS	ENSEVELISSEUSES
ENCHERISSEMENTS	ENDOCTRINASSIEZ	ENNEASYLLABIQUE	ENSOLEILLASSENT
ENCHEVAUCHAIENT	ENDOCTRINEMENTS	ENNOBLISSEMENTS	ENSOLEILLASSIEZ
ENCHEVAUCHASSES	ENDOCTRINERIONS	ENORGUEILLIRAIS	ENSOLEILLEMENTS
ENCHEVAUCHERAIS	ENDOLORISSAIENT	ENORGUEILLIRAIT	ENSOLEILLERIONS
ENCHEVAUCHERAIT	ENDOLORISSEMENT	ENORGUEILLIRENT	ENSORCELASSIONS
ENCHEVAUCHERENT	ENDOMMAGEASSENT	ENORGUEILLIRIEZ	ENSORCELERAIENT*
ENCHEVAUCHERIEZ	ENDOMMAGEASSIEZ	ENORGUEILLIRONS	ENSORCELLEMENTS
ENCHEVAUCHERONS	ENDOMMAGERAIENT	ENORGUEILLIRONT	ENSORCELLERIONS
ENCHEVAUCHERONT	ENDORMISSEMENTS	ENORGUEILLISSES	ENSOUTANASSIONS
ENCHEVETRASSENT	ENDURCISSEMENTS	ENORGUEILLISSEZ	ENSOUTANERAIENT
ENCHEVETRASSIEZ	ENERGETICIENNES	ENQUIQUINASSENT	ENTENEBRASSIONS
ENCHEVETREMENTS	ENFIROUAPASSENT	ENQUIQUINASSIEZ	ENTENEBRERAIENT
ENCHEVETRERIONS	ENFIROUAPASSIEZ	ENQUIQUINEMENTS	ENTEROBACTERIES
ENCHIFRENASSENT	ENFIROUAPERIONS	ENQUIQUINERIONS	ENTHOUSIASMAMES


Mots de 15 lettres de ENTHOUSIASMANTE à ERYTHROCYTAIRES - Page 28/61

ENTHOUSIASMANTE	ENTRECHOQUEMENT	ENTRELARDASSIEZ	EPANOUISSEMENTS
ENTHOUSIASMANTS	ENTRECHOQUERAIS	ENTRELARDERIONS	EPARPILLASSIONS
ENTHOUSIASMASSE	ENTRECHOQUERAIT	ENTREMANGEAIENT	EPARPILLERAIENT
ENTHOUSIASMATES	ENTRECHOQUERENT	ENTREMANGERIONS	EPICONDYLIENNES
ENTHOUSIASMERAI	ENTRECHOQUERIEZ	ENTREMELASSIONS	EPICONTINENTALE
ENTHOUSIASMERAS	ENTRECHOQUERONS	ENTREMELERAIENT	EPICONTINENTAUX
ENTHOUSIASMEREZ	ENTRECHOQUERONT	ENTREMETTRAIENT	EPIDEMIOLOGIQUE
ENTHOUSIASMIONS	ENTRECOUPASSENT	ENTRENUISISSENT	EPIDEMIOLOGISTE
ENTORTILLASSENT	ENTRECOUPASSIEZ	ENTRENUISISSIEZ	EPIDERMOMYCOSES
ENTORTILLASSIEZ	ENTRECOUPERIONS	ENTREPOSASSIONS	EPIGRAMMATIQUES
ENTORTILLEMENTS	ENTRECROISAIENT	ENTREPOSERAIENT	EPIGRAMMATISTES
ENTORTILLERIONS	ENTRECROISASSES	ENTREPOSITAIRES	EPINCELLERAIENT
ENTOURLOUPAIENT	ENTRECROISEMENT	ENTREPRENDRIONS	EPINCETTERAIENT
ENTOURLOUPASSES	ENTRECROISERAIS	ENTREPRENEURIAL	EPIPHENOMENISME
ENTOURLOUPERAIS	ENTRECROISERAIT	ENTREPRENEURIAT	EPIPHENOMENISTE
ENTOURLOUPERAIT	ENTRECROISERENT	ENTREREGARDAMES	EPISCOPALIENNES
ENTOURLOUPERENT	ENTRECROISERIEZ	ENTREREGARDATES	EPISTEMOLOGIQUE
ENTOURLOUPERIEZ	ENTRECROISERONS	ENTREREGARDEREZ	EPISTEMOLOGISTE
ENTOURLOUPERONS	ENTRECROISERONT	ENTREREGARDIONS	EPONTILLASSIONS
ENTOURLOUPERONT	ENTREDECHIRAMES	ENTRETAILLAIENT	EPONTILLERAIENT
ENTOURLOUPETTES	ENTREDECHIRATES	ENTRETAILLASSES	EPOULARDASSIONS
ENTRACCUSASSENT	ENTREDECHIREREZ	ENTRETAILLERAIS	EPOULARDERAIENT
ENTRACCUSASSIEZ	ENTREDECHIRIONS	ENTRETAILLERAIT	EPOUSSETASSIONS
ENTRACCUSERIONS	ENTREDETRUIRAIT	ENTRETAILLERENT	EPOUSSETERAIENT*
ENTRADMIRASSENT	ENTREDETRUIRIEZ	ENTRETAILLERIEZ	EPOUSSETTERIONS
ENTRADMIRASSIEZ	ENTREDETRUIRONS	ENTRETAILLERONS	EPOUSTOUFLAIENT
ENTRADMIRERIONS	ENTREDETRUIRONT	ENTRETAILLERONT	EPOUSTOUFLANTES
ENTRAPERCEVIONS	ENTREDETRUISAIT	ENTRETIENDRIONS	EPOUSTOUFLASSES
ENTRAPERCEVRAIS	ENTREDETRUISANT	ENTRETISSASSENT*	EPOUSTOUFLERAIS
ENTRAPERCEVRAIT	ENTREDETRUISENT	ENTRETISSASSIEZ*	EPOUSTOUFLERAIT
ENTRAPERCEVRIEZ	ENTREDETRUISIEZ	ENTRETISSERIONS*	EPOUSTOUFLERENT
ENTRAPERCEVRONS	ENTREDETRUISONS	ENTRETOISASSENT	EPOUSTOUFLERIEZ
ENTRAPERCEVRONT	ENTREDEVORAIENT	ENTRETOISASSIEZ	EPOUSTOUFLERONS
ENTRAPERCOIVENT	ENTREDEVORERAIT	ENTRETOISEMENTS	EPOUSTOUFLERONT
ENTRAPERCUSSENT	ENTREDEVORERENT	ENTRETOISERIONS	EPOUVANTASSIONS
ENTRAPERCUSSIEZ	ENTREDEVORERIEZ	ENTREVOUTASSENT	EPOUVANTERAIENT
ENTREBAILLAIENT	ENTREDEVORERONS	ENTREVOUTASSIEZ	EQUARRISSEMENTS
ENTREBAILLASSES	ENTREDEVORERONT	ENTREVOUTERIONS	EQUATOGUINEENNE
ENTREBAILLEMENT	ENTREGORGEAIENT	ENTROBLIGEAIENT	EQUILIBRASSIONS
ENTREBAILLERAIS	ENTREGORGERIONS	ENTROBLIGERIONS	EQUILIBRERAIENT
ENTREBAILLERAIT	ENTREHAISSAIENT*	ENTROUVRIRAIENT	EQUIMOLECULAIRE
ENTREBAILLERENT	ENTREHEURTAIENT*	ENTROUVRISSIONS	EQUIPOTENTIELLE
ENTREBAILLERIEZ	ENTREHEURTERAIT*	ENVELOPPASSIONS	EQUIVOQUASSIONS
ENTREBAILLERONS	ENTREHEURTERENT*	ENVELOPPERAIENT	EQUIVOQUERAIENT
ENTREBAILLERONT	ENTREHEURTERIEZ*	ENVIRONNASSIONS	ERESIPELATEUSES
ENTREBATTISSENT	ENTREHEURTERONS*	ENVIRONNEMENTAL	ERGOCALCIFEROLS
ENTREBATTISSIEZ	ENTREHEURTERONT*	ENVIRONNERAIENT	ERGOTHERAPEUTES
ENTREBATTRAIENT	ENTRELACASSIONS	ENVISAGEASSIONS	ERYSIPELATEUSES
ENTRECHOQUAIENT	ENTRELACERAIENT	EPAISSISSEMENTS	ERYTHROBLASTOSE
ENTRECHOQUASSES	ENTRELARDASSENT	EPANNELLERAIENT	ERYTHROCYTAIRES


Mots de 15 lettres de ERYTHROPOIETINE à EXTERNALISERAIS - Page 29/61

ERYTHROPOIETINE	ETANCHEIFIASSES	EUROPEANISERENT	EXHIBITIONNISME
ERYTHROXYLACEES*	ETANCHEIFIERAIS	EUROPEANISERIEZ	EXHIBITIONNISTE
ESCADRONNASSENT	ETANCHEIFIERAIT	EUROPEANISERONS	EXISTENTIALISME
ESCADRONNASSIEZ	ETANCHEIFIERENT	EUROPEANISERONT	EXISTENTIALISTE
ESCADRONNERIONS	ETANCHEIFIERIEZ	EUROSCEPTICISME	EXPANSIONNISMES
ESCAGASSASSIONS	ETANCHEIFIERONS	EUROSTRATEGIQUE	EXPANSIONNISTES
ESCAGASSERAIENT	ETANCHEIFIERONT	EUROTERRORISMES	EXPECTORASSIONS
ESCARMOUCHAIENT	ETANCONNASSIONS	EUSTHENOPTERONS	EXPECTORERAIENT
ESCARMOUCHASSES	ETANCONNERAIENT	EUTHANASIASSENT	EXPEDITIONNAIRE
ESCARMOUCHERAIS	ETHERIFIASSIONS	EUTHANASIASSIEZ	EXPERIMENTAIENT
ESCARMOUCHERAIT	ETHERIFICATIONS	EUTHANASIERIONS	EXPERIMENTASSES
ESCARMOUCHERENT	ETHERIFIERAIENT	EUTROPHICATIONS	EXPERIMENTATEUR
ESCARMOUCHERIEZ	ETHNICISASSIONS	EUTROPHISASSENT	EXPERIMENTATION
ESCARMOUCHERONS	ETHNICISERAIENT	EUTROPHISASSIEZ	EXPERIMENTERAIS
ESCARMOUCHERONT	ETHNOBIOLOGISTE	EUTROPHISATIONS	EXPERIMENTERAIT
ESCARRIFIASSENT	ETHNOBOTANIQUES	EUTROPHISERIONS	EXPERIMENTERENT
ESCARRIFIASSIEZ	ETHNOBOTANISTES	EVANGELIQUEMENT	EXPERIMENTERIEZ
ESCARRIFICATION	ETHNOCENTRIQUES	EVANGELISASSENT	EXPERIMENTERONS
ESCARRIFIERIONS	ETHNOCENTRISMES	EVANGELISASSIEZ	EXPERIMENTERONT
ESCHATOLOGIQUES	ETHNOCENTRISTES	EVANGELISATEURS	EXPERTISASSIONS
ESCLAVAGEASSENT	ETHNOGRAPHIQUES	EVANGELISATIONS	EXPERTISERAIENT
ESCLAVAGEASSIEZ	ETHNOZOOLOGIQUE	EVANGELISATRICE	EXPLICITASSIONS
ESCLAVAGERAIENT	ETHYLSULFURIQUE	EVANGELISERIONS	EXPLICITERAIENT
ESQUIMAUTASSENT	ETINCELLERAIENT	EVANOUISSEMENTS	EXPLOITABILITES
ESQUIMAUTASSIEZ	ETIQUETTERAIENT	EVENEMENTIELLES	EXPONENTIATIONS
ESQUIMAUTERIONS	ETOUPILLASSIONS	EVOLUTIONNISMES	EXPRESSIONNISME
ESSENTIELLEMENT	ETOUPILLERAIENT	EVOLUTIONNISTES	EXPRESSIONNISTE
ESSORILLASSIONS	ETOURDISSEMENTS	EXANTHEMATEUSES	EXPROPRIASSIONS
ESSORILLERAIENT	ETRESILLONNAMES	EXANTHEMATIQUES	EXPROPRIATRICES
ESSOUFFLASSIONS	ETRESILLONNASSE	EXCELLENTISSIME	EXPROPRIERAIENT
ESSOUFFLERAIENT	ETRESILLONNATES	EXCENTRIQUEMENT	EXSANGUINATIONS
ESTAMPILLASSENT	ETRESILLONNERAI	EXCEPTIONNELLES	EXTEMPORANEMENT
ESTAMPILLASSIEZ	ETRESILLONNERAS	EXCOMMUNIASSENT	EXTENSIONALITES
ESTAMPILLERIONS	ETRESILLONNEREZ	EXCOMMUNIASSIEZ	EXTENSIONNELLES
ESTERIFIASSIONS	ETRESILLONNIONS	EXCOMMUNICATION	EXTERIORISAIENT
ESTERIFICATIONS	ETRONCONNASSENT	EXCOMMUNIERIONS	EXTERIORISASSES
ESTERIFIERAIENT	ETRONCONNASSIEZ	EXCREMENTIELLES	EXTERIORISATION
ESTHETISASSIONS	ETRONCONNERIONS	EXCURSIONNAIENT	EXTERIORISERAIS
ESTHETISERAIENT	EUPHEMISASSIONS	EXCURSIONNASSES	EXTERIORISERAIT
ESTOMAQUASSIONS	EUPHEMISERAIENT	EXCURSIONNERAIS	EXTERIORISERENT
ESTOMAQUERAIENT	EUPHORISASSIONS	EXCURSIONNERAIT	EXTERIORISERIEZ
ESTOURBISSAIENT	EUPHORISERAIENT	EXCURSIONNERENT	EXTERIORISERONS
ESTRAPADASSIONS	EUROCOMMUNISMES	EXCURSIONNERIEZ	EXTERIORISERONT
ESTRAPADERAIENT	EUROCOMMUNISTES	EXCURSIONNERONS	EXTERMINASSIONS
ESTRAPASSASSENT	EUROOBLIGATIONS*	EXCURSIONNERONT	EXTERMINATRICES
ESTRAPASSASSIEZ	EUROPEANISAIENT	EXCURSIONNISTES	EXTERMINERAIENT
ESTRAPASSERIONS	EUROPEANISASSES	EXEMPLIFIASSENT	EXTERNALISAIENT
ETALINGUASSIONS	EUROPEANISATION	EXEMPLIFIASSIEZ	EXTERNALISASSES
ETALINGUERAIENT	EUROPEANISERAIS	EXEMPLIFICATION	EXTERNALISATION
ETANCHEIFIAIENT	EUROPEANISERAIT	EXEMPLIFIERIONS	EXTERNALISERAIS


Mots de 15 lettres de EXTERNALISERAIT à FOURMILLASSIONS - Page 30/61

EXTERNALISERAIT	FANTASTIQUEMENT	FICTIONNALISEES*	FLUIDIFICATIONS
EXTERNALISERENT	FARANDOLASSIONS	FICTIONNALISENT*	FLUIDIFIERAIENT
EXTERNALISERIEZ	FARANDOLERAIENT	FICTIONNALISERA*	FLUVIOGLACIAIRE
EXTERNALISERONS	FARFOUILLASSENT	FICTIONNALISIEZ*	FLUVIOMETRIQUES
EXTERNALISERONT	FARFOUILLASSIEZ	FICTIONNALISONS*	FOLICHONNASSENT
EXTEROCEPTIVITE	FARFOUILLERIONS	FILIALISASSIONS	FOLICHONNASSIEZ
EXTEROCEPTRICES	FASTIDIEUSEMENT	FILIALISERAIENT	FOLICHONNERIONS
EXTRABUDGETAIRE	FEDERALISASSENT	FILIGRANASSIONS	FOLKLORISASSENT
EXTRACELLULAIRE	FEDERALISASSIEZ	FILIGRANERAIENT	FOLKLORISASSIEZ
EXTRACONJUGALES	FEDERALISATIONS	FILMOGRAPHIQUES	FOLKLORISATIONS
EXTRACORPORELLE	FEDERALISERIONS	FINANCIARISAMES	FOLKLORISERIONS
EXTRACOUTUMIERE	FERMENTESCIBLES	FINANCIARISASSE	FONCTIONNALISAI
EXTRACOUTUMIERS	FERRAILLASSIONS	FINANCIARISATES	FONCTIONNALISAS
EXTRAGALACTIQUE	FERRAILLERAIENT	FINANCIARISERAI	FONCTIONNALISAT
EXTRAJUDICIAIRE	FERRIMAGNETIQUE	FINANCIARISERAS	FONCTIONNALISEE
EXTRAORDINAIRES	FERRIMAGNETISME	FINANCIARISEREZ	FONCTIONNALISER
EXTRAPOLASSIONS	FERROALUMINIUMS*	FINANCIARISIONS	FONCTIONNALISES
EXTRAPOLERAIENT	FERROELECTRIQUE	FINLANDISASSENT	FONCTIONNALISEZ
EXTRAPYRAMIDALE	FERROMAGNESIENS	FINLANDISASSIEZ	FONCTIONNALISME
EXTRAPYRAMIDAUX	FERROMAGNETIQUE	FINLANDISATIONS	FONCTIONNALISTE
EXTRASENSORIELS	FERROMAGNETISME	FINLANDISERIONS	FONCTIONNALITES
EXTRASTATUTAIRE	FERROMANGANESES	FISCALISASSIONS	FONCTIONNARIATS
EXTRATERRESTRES	FERROMOLYBDENES	FISCALISERAIENT	FONCTIONNARISAI
EXTRAVAGUASSENT	FERROPRUSSIATES	FISSIONNASSIONS	FONCTIONNARISAS
EXTRAVAGUASSIEZ	FERTILISASSIONS	FISSIONNERAIENT	FONCTIONNARISAT
EXTRAVAGUERIONS	FERTILISATRICES	FLAMANDISASSENT	FONCTIONNARISEE
EXTRAVASASSIONS	FERTILISERAIENT	FLAMANDISASSIEZ	FONCTIONNARISER
EXTRAVASERAIENT	FERTIRRIGATIONS	FLAMANDISERIONS	FONCTIONNARISES
EXTRINSEQUEMENT	FERTIRRIGUAIENT	FLAMINGANTISMES	FONCTIONNARISEZ
FACTORISASSIONS	FERTIRRIGUASSES	FLEGMATIQUEMENT	FONCTIONNARISME
FACTORISERAIENT	FERTIRRIGUERAIS	FLEMMARDASSIONS	FONCTIONNASSENT
FACULTATIVEMENT	FERTIRRIGUERAIT	FLEMMARDERAIENT	FONCTIONNASSIEZ
FAINEANTASSIONS	FERTIRRIGUERENT	FLEURDELISAIENT	FONCTIONNEMENTS
FAINEANTERAIENT	FERTIRRIGUERIEZ	FLEURDELISASSES	FONCTIONNERIONS
FALLACIEUSEMENT	FERTIRRIGUERONS	FLEURDELISERAIS	FONDAMENTALISME
FALSIFIABILITES	FERTIRRIGUERONT	FLEURDELISERAIT	FONDAMENTALISTE
FALSIFICATRICES	FETICHISASSIONS	FLEURDELISERENT	FOOTBALLISTIQUE
FAMILIARISAIENT	FETICHISERAIENT	FLEURDELISERIEZ	FORFAITAIREMENT
FAMILIARISASSES	FEUILLETASSIONS	FLEURDELISERONS	FORFAITISASSENT
FAMILIARISATION	FEUILLETERAIENT*	FLEURDELISERONT	FORFAITISASSIEZ
FAMILIARISERAIS	FEUILLETONESQUE	FLEURETTERAIENT	FORFAITISATIONS
FAMILIARISERAIT	FEUILLETONISTES	FLEXIBILISAIENT	FORFAITISERIONS
FAMILIARISERENT	FEUILLETTERIONS	FLEXIBILISASSES	FORLONGEASSIONS
FAMILIARISERIEZ	FIABILISASSIONS	FLEXIBILISERAIS	FORMALISASSIONS
FAMILIARISERONS	FIABILISERAIENT	FLEXIBILISERAIT	FORMALISERAIENT
FAMILIARISERONT	FIBRINOLYTIQUES	FLEXIBILISERENT	FOSSILISASSIONS
FANFARONNASSENT	FIBROMYALGIQUES	FLEXIBILISERIEZ	FOSSILISERAIENT
FANFARONNASSIEZ	FICTIONNALISAIS*	FLEXIBILISERONS	FOURGONNASSIONS
FANFARONNERIONS	FICTIONNALISAIT*	FLEXIBILISERONT	FOURGONNERAIENT
FANTASMAGORIQUE	FICTIONNALISANT*	FLUIDIFIASSIONS	FOURMILLASSIONS


Mots de 15 lettres de FOURMILLERAIENT à GRAMMATICALISAS - Page 31/61

FOURMILLERAIENT	FRIGORIFIASSENT	GAZOUILLERAIENT	GHETTOISASSIONS
FOURRAGEASSIONS	FRIGORIFIASSIEZ	GELATINISATIONS	GHETTOISERAIENT
FOUTIMASSASSENT	FRIGORIFIERIONS	GELATINOBROMURE	GIGANTESQUEMENT
FOUTIMASSASSIEZ	FRISSONNASSIONS	GENERALISASSENT	GIROUETTASSIONS
FOUTIMASSERIONS	FRISSONNERAIENT	GENERALISASSIEZ	GIROUETTERAIENT
FRACTIONNASSENT	FRISTOUILLAIENT	GENERALISATEURS	GLAMOURISASSENT*
FRACTIONNASSIEZ	FRISTOUILLASSES	GENERALISATIONS	GLAMOURISASSIEZ*
FRACTIONNEMENTS	FRISTOUILLERAIS	GENERALISATRICE	GLAMOURISERIONS*
FRACTIONNERIONS	FRISTOUILLERAIT	GENERALISERIONS	GLANDOUILLAIENT
FRAGILISASSIONS	FRISTOUILLERENT	GENERATIONNELLE	GLANDOUILLASSES
FRAGILISERAIENT	FRISTOUILLERIEZ	GENTILHOMMERIES	GLANDOUILLERAIS
FRAGMENTASSIONS	FRISTOUILLERONS	GENTILHOMMIERES	GLANDOUILLERAIT
FRAGMENTERAIENT	FRISTOUILLERONT	GENTRIFIASSIONS*	GLANDOUILLERENT
FRAISICULTRICES	FROUFROUTASSENT	GENTRIFICATIONS	GLANDOUILLERIEZ
FRAMBOISASSIONS	FROUFROUTASSIEZ	GENTRIFIERAIENT*	GLANDOUILLERONS
FRAMBOISERAIENT	FROUFROUTEMENTS	GEOCHRONOLOGIES	GLANDOUILLERONT
FRANCAFRICAINES	FROUFROUTERIONS	GEOLOCALISAIENT	GLOBALISASSIONS
FRANCHISASSIONS	FRUCTICULTRICES	GEOLOCALISASSES	GLOBALISATRICES
FRANCHISERAIENT	FRUCTIFIASSIONS	GEOLOCALISATION	GLOBALISERAIENT
FRANCHISSEMENTS	FRUCTIFICATEURS	GEOLOCALISERAIS	GLOBETROTTEUSES*
FRANCHOUILLARDE	FRUCTIFICATIONS	GEOLOCALISERAIT	GLOMERULOPATHIE
FRANCHOUILLARDS	FRUCTIFICATRICE	GEOLOCALISERENT	GLORIFICATRICES
FRANCOCENTRISME	FRUCTIFIERAIENT	GEOLOCALISERIEZ	GLOUGLOUTASSENT
FRANCOPHONISAIS	FRUITICULTRICES	GEOLOCALISERONS	GLOUGLOUTASSIEZ
FRANCOPHONISAIT	FUMERONNASSIONS	GEOLOCALISERONT	GLOUGLOUTERIONS
FRANCOPHONISANT	FUMERONNERAIENT	GEOMETRIQUEMENT	GLUCOCORTICOIDE
FRANCOPHONISEES	GADGETISASSIONS	GEOMETRISASSENT	GLUCONEOGENESES
FRANCOPHONISENT	GADGETISERAIENT	GEOMETRISASSIEZ	GLYCERINASSIONS
FRANCOPHONISERA	GADROUILLASSENT	GEOMETRISATIONS	GLYCERINERAIENT
FRANCOPHONISIEZ	GADROUILLASSIEZ	GEOMETRISERIONS	GLYCOGENOGENESE
FRANCOPHONISONS	GADROUILLERIONS	GEOMORPHOLOGIES	GLYCOPROTEIQUES
FRANSQUILLONNAI	GALVANISASSIONS	GEOMORPHOLOGUES	GLYCOREGULATION
FRANSQUILLONNAS	GALVANISERAIENT	GEOPHYSICIENNES	GOBICHONNASSENT
FRANSQUILLONNAT	GALVANOCAUTERES	GEOPOLITICIENNE	GOBICHONNASSIEZ
FRANSQUILLONNER	GALVANOPLASTIES	GEOSTATIONNAIRE	GOBICHONNERIONS
FRANSQUILLONNES	GAMBERGEASSIONS	GEOSTATISTIQUES	GONADOSTIMULINE
FRANSQUILLONNEZ	GAMMAGLOBULINES	GEOSTRATEGIQUES	GONADOTROPHINES
FRATERNELLEMENT	GANGLIOPLEGIQUE	GEOTECHNICIENNE	GOUDRONNASSIONS
FRATERNISASSENT	GARDIENNASSIONS	GEOTHERMOMETRES	GOUDRONNERAIENT
FRATERNISASSIEZ	GARDIENNERAIENT	GEOTHERMOMETRIE	GOURMANDASSIONS
FRATERNISATIONS	GARGARISASSIONS	GERMANISASSIONS	GOURMANDERAIENT
FRATERNISERIONS	GARGARISERAIENT	GERMANISERAIENT	GOURNABLASSIONS
FRAUDULEUSEMENT	GARGOUILLASSENT	GERMANOPRATINES	GOURNABLERAIENT
FREDERICTONNAIS	GARGOUILLASSIEZ	GERONTOCRATIQUE	GOUVERNEMENTALE
FREQUENCEMETRES	GARGOUILLEMENTS	GERONTOLOGIQUES	GOUVERNEMENTAUX
FREQUENTASSIONS	GARGOUILLERIONS	GERONTOLOGISTES	GRAILLONNASSENT
FREQUENTERAIENT	GASTRODUODENALE	GESTATIONNELLES	GRAILLONNASSIEZ
FRICTIONNASSENT	GASTRODUODENAUX	GESTICULASSIONS	GRAILLONNERIONS
FRICTIONNASSIEZ	GASTROENTERITES	GESTICULERAIENT	GRAMMATICALISAI
FRICTIONNERIONS	GAZOUILLASSIONS	GEWURZTRAMINERS	GRAMMATICALISAS


Mots de 15 lettres de GRAMMATICALISAT à HOMOGENEIFIATES - Page 32/61

GRAMMATICALISAT	GRILLAGEASSIONS	HANNETONNERIONS	HERPETOLOGIQUES
GRAMMATICALISEE	GRISAILLASSIONS	HARMONIEUSEMENT	HERPETOLOGISTES
GRAMMATICALISER	GRISAILLERAIENT	HARMONISASSIONS	HETEROCENTRIQUE
GRAMMATICALISES	GROGNASSASSIONS	HARMONISERAIENT	HETEROCYCLIQUES
GRAMMATICALISEZ	GROGNASSERAIENT	HAUSSMANNIENNES	HETEROGAMETIQUE
GRAMMATICALITES	GROGNONNASSIONS	HEBOIDOPHRENIES	HETEROMETABOLES
GRANDILOQUENCES	GROGNONNERAIENT	HEIDEGGERIENNES	HETEROMORPHISME
GRANDILOQUENTES	GROMMELLERAIENT	HELICICULTRICES	HETEROPLASTIQUE
GRANOCLASSEMENT	GROSSULARIACEES*	HELIOCENTRIQUES	HETEROPROTEINES
GRANULOCYTAIRES	GROUPUSCULAIRES	HELIOCENTRISMES	HETEROSEXUALITE
GRANULOMETRIQUE	GUADELOUPEENNES	HELIOGRAPHIQUES	HETEROSEXUELLES
GRAPHITISATIONS	GUEULETONNAIENT	HELIOSISMOLOGIE	HEXACHLOROPHENE
GRAPPILLASSIONS	GUEULETONNASSES	HELIOSYNCHRONES	HEXACORALLIAIRE
GRAPPILLERAIENT	GUEULETONNERAIS	HELIOTHERAPIQUE	HEXASYLLABIQUES
GRASSOUILLETTES	GUEULETONNERAIT	HELIOTHERMIQUES	HIERARCHISAIENT
GRATICULASSIONS	GUEULETONNERENT	HELIPORTASSIONS	HIERARCHISASSES
GRATICULERAIENT	GUEULETONNERIEZ	HELIPORTERAIENT	HIERARCHISATION
GRATOUILLASSENT	GUEULETONNERONS	HELITRANSPORTEE	HIERARCHISERAIS
GRATOUILLASSIEZ	GUEULETONNERONT	HELITRANSPORTES	HIERARCHISERAIT
GRATOUILLEMENTS*	GUILLEMETASSENT	HELITREUILLAGES	HIERARCHISERENT
GRATOUILLERIONS	GUILLEMETASSIEZ	HELITREUILLAMES	HIERARCHISERIEZ
GRATTOUILLAIENT	GUILLEMETERIONS*	HELITREUILLASSE	HIERARCHISERONS
GRATTOUILLASSES	GUILLEMETTERAIS	HELITREUILLATES	HIERARCHISERONT
GRATTOUILLEMENT	GUILLEMETTERAIT	HELITREUILLERAI	HIEROGLYPHIQUES
GRATTOUILLERAIS	GUILLEMETTERIEZ	HELITREUILLERAS	HIPPOCASTANACEE
GRATTOUILLERAIT	GUILLEMETTERONS	HELITREUILLEREZ	HIPPOPOTAMESQUE
GRATTOUILLERENT	GUILLEMETTERONT	HELITREUILLIONS	HIRUDINICULTURE
GRATTOUILLERIEZ	GUILLOCHASSIONS	HELLENISASSIONS	HISPANISASSIONS
GRATTOUILLERONS	GUILLOCHERAIENT	HELLENISERAIENT	HISPANISERAIENT
GRATTOUILLERONT	GUILLOTINASSENT	HELMINTHOLOGIES	HISTOCOMPATIBLE
GRAVILLONNAIENT	GUILLOTINASSIEZ	HEMAGGLUTININES	HISTORIOGRAMMES
GRAVILLONNASSES	GUILLOTINEMENTS	HEMATOPOIETIQUE	HISTORIOGRAPHES
GRAVILLONNERAIS	GUILLOTINERIONS	HEMICYLINDRIQUE	HISTORIOGRAPHIE
GRAVILLONNERAIT	GUINDAILLASSENT	HEMOCHROMATOSES	HITCHCOCKIENNES
GRAVILLONNERENT	GUINDAILLASSIEZ	HEMOCOMPATIBLES	HOLLYWOODIENNES
GRAVILLONNERIEZ	GUINDAILLERIONS	HEMODYNAMOMETRE	HOLOCRISTALLINE
GRAVILLONNERONS	GYNANDROMORPHES	HEMOGLOBINURIES	HOLOCRISTALLINS
GRAVILLONNERONT	GYROMAGNETIQUES	HENDECASYLLABES	HOLOGRAPHIAIENT
GRAVILLONNEUSES	HABSBOURGEOISES	HEPATONEPHRITES	HOLOGRAPHIASSES
GRAVITATIONNELS	HAGIOGRAPHIQUES	HEPTASYLLABIQUE	HOLOGRAPHIERAIS
GRENAILLASSIONS	HALLSTATTIENNES	HEPTATHLONIENNE	HOLOGRAPHIERAIT
GRENAILLERAIENT	HALLUCINASSIONS	HERBORISASSIONS	HOLOGRAPHIERENT
GRENOUILLASSENT	HALLUCINATOIRES	HERBORISATRICES	HOLOGRAPHIERIEZ
GRENOUILLASSIEZ	HALLUCINERAIENT	HERBORISERAIENT	HOLOGRAPHIERONS
GRENOUILLERIONS	HAMECONNASSIONS	HEREDITAIREMENT	HOLOGRAPHIERONT
GRIBOUILLASSENT	HAMECONNERAIENT	HEREDOCONTAGION	HOLOPHRASTIQUES
GRIBOUILLASSIEZ	HANDICAPASSIONS	HERISSONNASSENT	HOMEOMORPHISMES
GRIBOUILLERIONS	HANDICAPERAIENT	HERISSONNASSIEZ	HOMOGENEIFIAMES
GRIFFONNASSIONS	HANNETONNASSENT	HERISSONNERIONS	HOMOGENEIFIASSE
GRIFFONNERAIENT	HANNETONNASSIEZ	HERMAPHRODISMES	HOMOGENEIFIATES


Mots de 15 lettres de HOMOGENEIFIERAI à IMPLEMENTASSENT - Page 33/61

HOMOGENEIFIERAI	HYDROFUGERAIENT	HYPOGLYCEMIANTS	IMMOBILISASSENT
HOMOGENEIFIERAS	HYDROGENASSIONS	HYPOGLYCEMIQUES	IMMOBILISASSIEZ
HOMOGENEIFIEREZ	HYDROGENERAIENT	HYPOLIPEMIANTES	IMMOBILISATIONS
HOMOGENEIFIIONS	HYDROGEOLOGIQUE	HYPOLIPIDEMIANT	IMMOBILISERIONS
HOMOGENEISAIENT	HYDROGRAPHIQUES	HYPOOESTROGENIE	IMMORTALISAIENT
HOMOGENEISASSES	HYDROLYSASSIONS	HYPOPHOSPHOREUX	IMMORTALISASSES
HOMOGENEISATEUR	HYDROLYSERAIENT	HYPOSTASIASSENT	IMMORTALISATION
HOMOGENEISATION	HYDROMECANIQUES	HYPOSTASIASSIEZ	IMMORTALISERAIS
HOMOGENEISERAIS	HYDROPERICARDES	HYPOSTASIERIONS	IMMORTALISERAIT
HOMOGENEISERAIT	HYDROTECHNIQUES	HYPOSULFUREUSES	IMMORTALISERENT
HOMOGENEISERENT	HYDROTHERAPEUTE	HYPOTHALAMIQUES	IMMORTALISERIEZ
HOMOGENEISERIEZ	HYDROTHERAPIQUE	HYPOTHEQUASSENT	IMMORTALISERONS
HOMOGENEISERONS	HYDROTIMETRIQUE	HYPOTHEQUASSIEZ	IMMORTALISERONT
HOMOGENEISERONT	HYDROTRAITEMENT	HYPOTHEQUERIONS	IMMUNOCOMPETENT
HOMOLOGUASSIONS	HYGROMETRICITES	HYPOTHYROIDISME	IMMUNODEPRESSIF
HOMOLOGUERAIENT	HYPERALGESIQUES	HYPOVENTILATION	IMMUNODEPRIMEES
HOMOPARENTALITE	HYPERCALORIQUES	HYPOVITAMINOSES	IMMUNOGENETIQUE
HORIZONTALEMENT	HYPERCORRECTION	HYSTERISASSIONS	IMMUNOGLOBULINE
HORMONOTHERAPIE	HYPEREMOTIVITES	HYSTERISERAIENT	IMMUNOSTIMULANT
HORRIPILASSIONS	HYPERFREQUENCES	HYSTEROGRAPHIES	IMMUNOTHERAPIES
HORRIPILERAIENT	HYPERGLYCEMIANT	ICONOGRAPHIQUES	IMMUNOTOLERANCE
HOSPITALISAIENT	HYPERINFLATIONS	IDENTIFIASSIONS	IMMUNOTOLERANTE
HOSPITALISASSES	HYPERKINETIQUES	IDENTIFICATEURS	IMMUNOTOLERANTS
HOSPITALISATION	HYPERLIPIDEMIES	IDENTIFICATIONS	IMPATIENTASSENT
HOSPITALISERAIS	HYPERMENORRHEES	IDENTIFICATOIRE	IMPATIENTASSIEZ
HOSPITALISERAIT	HYPERPUISSANCES	IDENTIFICATRICE	IMPATIENTERIONS
HOSPITALISERENT	HYPERSECRETIONS	IDENTIFIERAIENT	IMPATRONISAIENT
HOSPITALISERIEZ	HYPERSOMNIAQUES	IDEOLOGIQUEMENT	IMPATRONISASSES
HOSPITALISERONS	HYPERTEXTUALITE	IDEOLOGISATIONS	IMPATRONISATION
HOSPITALISERONT	HYPERTEXTUELLES	IDIOSYNCRASIQUE	IMPATRONISERAIS
HOUBLONNASSIONS	HYPERTHYROIDIES	IDIOSYNCRATIQUE	IMPATRONISERAIT
HOUBLONNERAIENT	HYPERTROPHIAMES	IDIOTIFIASSIONS	IMPATRONISERENT
HOUSPILLASSIONS	HYPERTROPHIASSE	IDIOTIFIERAIENT	IMPATRONISERIEZ
HOUSPILLERAIENT	HYPERTROPHIATES	IGNIFUGEASSIONS	IMPATRONISERONS
HUMIDIFIASSIONS	HYPERTROPHIERAI	ILLOCUTIONNAIRE	IMPATRONISERONT
HUMIDIFICATEURS	HYPERTROPHIERAS	ILLUSIONNASSENT	IMPEDANCEMETRES
HUMIDIFICATIONS	HYPERTROPHIEREZ	ILLUSIONNASSIEZ	IMPEDANCEMETRIE*
HUMIDIFIERAIENT	HYPERTROPHIIONS	ILLUSIONNERIONS	IMPENETRABILITE
HYDRAULICIENNES	HYPERTROPHIQUES	IMMANQUABLEMENT	IMPERMEABILISAI
HYDROALCOOLIQUE	HYPERVITAMINOSE	IMMATERIALISMES	IMPERMEABILISAS
HYDROCARBONATES	HYPNOTHERAPEUTE	IMMATERIALISTES	IMPERMEABILISAT
HYDROCHARIDACEE	HYPNOTISASSIONS	IMMATRICULAIENT	IMPERMEABILISEE
HYDROCHARITACEE	HYPNOTISERAIENT	IMMATRICULASSES	IMPERMEABILISER
HYDROCORTISONES	HYPOALLERGIQUES	IMMATRICULATION	IMPERMEABILISES
HYDROCUTASSIONS	HYPOCHLORHYDRIE	IMMATRICULERAIS	IMPERMEABILISEZ
HYDROCUTERAIENT	HYPOCHONDRIAQUE	IMMATRICULERAIT	IMPERMEABILITES
HYDRODYNAMIQUES	HYPOCONDRIAQUES	IMMATRICULERENT	IMPERSONNALITES
HYDROELECTRIQUE	HYPOCORISTIQUES	IMMATRICULERIEZ	IMPITOYABILITES
HYDROFUGEASSENT	HYPOCYCLOIDALES	IMMATRICULERONS	IMPITOYABLEMENT
HYDROFUGEASSIEZ	HYPOGLYCEMIANTE	IMMATRICULERONT	IMPLEMENTASSENT


Mots de 15 lettres de IMPLEMENTASSIEZ à INFREQUENTABLES - Page 34/61

IMPLEMENTASSIEZ	INCOMPREHENSIVE	INDISPOSASSIONS	INFANTILISAIENT
IMPLEMENTATIONS	INCOMPRESSIBLES	INDISPOSERAIENT	INFANTILISANTES
IMPLEMENTERIONS	INCONDITIONNEES	INDISSOLUBILITE	INFANTILISASSES
IMPONDERABILITE	INCONDITIONNELS	INDISTINCTEMENT	INFANTILISATION
IMPORTUNASSIONS	INCONNAISSABLES	INDIVIDUALISAIS	INFANTILISERAIS
IMPORTUNERAIENT	INCONNAISSANCES	INDIVIDUALISAIT	INFANTILISERAIT
IMPRATICABILITE	INCONSEQUEMMENT	INDIVIDUALISANT	INFANTILISERENT
IMPRESCRIPTIBLE	INCONSIDEREMENT	INDIVIDUALISEES	INFANTILISERIEZ
IMPRESSIONNABLE	INCONSTRUCTIBLE	INDIVIDUALISENT	INFANTILISERONS
IMPRESSIONNAMES	INCONTOURNABLES	INDIVIDUALISERA	INFANTILISERONT
IMPRESSIONNANTE	INCOORDINATIONS	INDIVIDUALISIEZ	INFATIGABILITES
IMPRESSIONNANTS	INCORPORABILITE	INDIVIDUALISMES	INFATIGABLEMENT
IMPRESSIONNASSE	INCORPORASSIONS	INDIVIDUALISONS	INFERIORISAIENT
IMPRESSIONNATES	INCORPORERAIENT	INDIVIDUALISTES	INFERIORISASSES
IMPRESSIONNERAI	INCORRIGIBILITE	INDIVISIBILITES	INFERIORISATION
IMPRESSIONNERAS	INCREMENTASSENT	INDIVISIBLEMENT	INFERIORISERAIS
IMPRESSIONNEREZ	INCREMENTASSIEZ	INDOEUROPEENNES	INFERIORISERAIT
IMPRESSIONNIONS	INCREMENTATIONS	INDRICOTHERIUMS	INFERIORISERENT
IMPRESSIONNISME	INCREMENTERIONS	INDUBITABLEMENT	INFERIORISERIEZ
IMPRESSIONNISTE	INCREMENTIELLES	INDULGENCIAIENT	INFERIORISERONS
IMPREVISIBILITE	INCRIMINASSIONS	INDULGENCIASSES	INFERIORISERONT
IMPRODUCTIVITES	INCRIMINERAIENT	INDULGENCIERAIS	INFINITESIMALES
IMPROVISASSIONS	INDEBOULONNABLE	INDULGENCIERAIT	INFLAMMABILITES
IMPROVISATRICES	INDEBROUILLABLE	INDULGENCIERENT	INFLATIONNISMES
IMPROVISERAIENT	INDECACHETABLES	INDULGENCIERIEZ	INFLATIONNISTES
IMPULSIONNELLES	INDECHIFFRABLES	INDULGENCIERONS	INFLECHISSABLES
INACCESSIBILITE	INDECIDABILITES	INDULGENCIERONT	INFLECHISSAIENT
INACCOUTUMANCES	INDECOMPOSABLES	INDUSTRIALISAIS	INFLECHISSEMENT
INADMISSIBILITE	INDEFECTIBILITE	INDUSTRIALISAIT	INFLUENCABILITE
INALIENABILITES	INDEFINISSABLES	INDUSTRIALISANT	INFLUENCASSIONS
INALTERABILITES	INDEFORMABILITE	INDUSTRIALISEES	INFLUENCERAIENT
INAPPRIVOISABLE	INDEMNISASSIONS	INDUSTRIALISENT	INFORMATICIENNE
INARTICULATIONS	INDEMNISERAIENT	INDUSTRIALISERA	INFORMATIONNELS
INASSOUVISSABLE	INDEPENDANTISME	INDUSTRIALISIEZ	INFORMATISABLES
INAUTHENTICITES	INDEPENDANTISTE	INDUSTRIALISMES	INFORMATISAIENT
INCARCERASSIONS	INDESCRIPTIBLES	INDUSTRIALISONS	INFORMATISASSES
INCARCERERAIENT	INDESTRUCTIBLES	INDUSTRIALISTES	INFORMATISATION
INCARDINASSIONS*	INDETERMINABLES	INEFFACABLEMENT	INFORMATISERAIS
INCARDINERAIENT*	INDETERMINATION	INELUCTABILITES	INFORMATISERAIT
INCESTUEUSEMENT	INDETERMINISMES	INELUCTABLEMENT	INFORMATISERENT
INCIRCONCISIONS	INDETERMINISTES	INENVISAGEABLES	INFORMATISERIEZ
INCOERCIBILITES	INDIANISASSIONS	INEPUISABLEMENT	INFORMATISERONS
INCOMMENSURABLE	INDIANISERAIENT	INEXCITABILITES	INFORMATISERONT
INCOMMODASSIONS	INDIFFERASSIONS	INEXCUSABLEMENT	INFRACAMBRIENNE
INCOMMODERAIENT	INDIFFERENCIEES	INEXPERIMENTEES	INFRALIMINAIRES
INCOMMUNICABLES	INDIFFERENTISME	INEXTENSIBILITE	INFRALITTORALES
INCOMMUTABILITE	INDIFFERENTISTE	INEXTRICABILITE	INFRANCHISSABLE
INCOMPATIBILITE	INDIFFERERAIENT	INFAILLIBILISTE	INFRASTRUCTUREL
INCOMPREHENSIFS	INDISCIPLINABLE	INFAILLIBILITES	INFRASTRUCTURES
INCOMPREHENSION	INDISPONIBILITE	INFAILLIBLEMENT	INFREQUENTABLES


Mots de 15 lettres de INFROISSABILISA à INTERPERSONNELS - Page 35/61

INFROISSABILISA	INSONORISERIONS	INTERCEDERAIENT	INTERIORISASSES
INFROISSABILISE	INSOUPCONNABLES	INTERCELLULAIRE	INTERIORISATION
INFROISSABILITE	INSTINCTIVEMENT	INTERCEPTASSENT	INTERIORISERAIS
INGURGITASSIONS	INSTITUTIONNELS	INTERCEPTASSIEZ	INTERIORISERAIT
INGURGITERAIENT	INSTRUISISSIONS	INTERCEPTERIONS	INTERIORISERENT
INHALOTHERAPIES	INSTRUMENTAIENT	INTERCHANGEABLE	INTERIORISERIEZ
INHOSPITALIERES	INSTRUMENTAIRES	INTERCLASSAIENT	INTERIORISERONS
ININTELLIGENCES	INSTRUMENTALISA	INTERCLASSASSES	INTERIORISERONT
ININTELLIGENTES	INSTRUMENTALISE	INTERCLASSEMENT	INTERJETASSIONS
ININTELLIGIBLES	INSTRUMENTASSES	INTERCLASSERAIS	INTERJETTERIONS
ININTERESSANTES	INSTRUMENTATION	INTERCLASSERAIT	INTERLIGNASSENT
ININTERRUPTIONS	INSTRUMENTERAIS	INTERCLASSERENT	INTERLIGNASSIEZ
INITIALISASSENT	INSTRUMENTERAIT	INTERCLASSERIEZ	INTERLIGNERIONS
INITIALISASSIEZ	INSTRUMENTERENT	INTERCLASSERONS	INTERLOCUTOIRES
INITIALISATIONS	INSTRUMENTERIEZ	INTERCLASSERONT	INTERLOCUTRICES
INITIALISERIONS	INSTRUMENTERONS	INTERCLASSEUSES	INTERLOQUASSENT
INNOCENTASSIONS	INSTRUMENTERONT	INTERCOMMUNALES	INTERLOQUASSIEZ
INNOCENTERAIENT	INSTRUMENTISTES	INTERCOMMUNIONS	INTERLOQUERIONS
INOPPORTUNEMENT	INSUBORDINATION	INTERCONNECTAIS	INTERMAXILLAIRE
INOPPOSABILITES	INSUPPORTASSENT	INTERCONNECTAIT	INTERMEDIATIONS
INORGANISATIONS	INSUPPORTASSIEZ	INTERCONNECTANT	INTERMETALLIQUE
INQUANTIFIABLES	INSUPPORTERIONS	INTERCONNECTEES	INTERMUSCULAIRE
INQUISITORIALES	INSURRECTIONNEL	INTERCONNECTENT	INTERNALISAIENT
INSAPONIFIABLES	INTELLECTUALISA	INTERCONNECTERA	INTERNALISASSES
INSATISFACTIONS	INTELLECTUALISE	INTERCONNECTIEZ	INTERNALISATION
INSATISFAISANTE	INTELLECTUALITE	INTERCONNECTONS	INTERNALISERAIS
INSATISFAISANTS	INTELLECTUELLES	INTERCONNEXIONS	INTERNALISERAIT
INSECURISASSENT	INTELLIGENTSIAS	INTERCULTURELLE	INTERNALISERENT
INSECURISASSIEZ	INTELLIGENTZIAS	INTERDEPENDANCE	INTERNALISERIEZ
INSECURISERIONS	INTELLIGIBILITE	INTERDEPENDANTE	INTERNALISERONS
INSENSIBILISAIS	INTENSIFIASSENT	INTERDEPENDANTS	INTERNALISERONT
INSENSIBILISAIT	INTENSIFIASSIEZ	INTERESSASSIONS	INTERNATIONALES
INSENSIBILISANT	INTENSIFICATION	INTERESSERAIENT	INTEROCEANIQUES
INSENSIBILISEES	INTENSIFIERIONS	INTERFACASSIONS	INTEROCEPTIVITE
INSENSIBILISENT	INTENSIONNELLES	INTERFACERAIENT	INTEROCEPTRICES
INSENSIBILISERA	INTENTIONNALITE	INTERFECONDITES	INTERPARIETALES
INSENSIBILISIEZ	INTENTIONNELLES	INTERFERASSIONS	INTERPELASSIONS
INSENSIBILISONS	INTERACTIONNELS	INTERFERENTIELS	INTERPELERAIENT*
INSEPARABILITES	INTERACTIVEMENT	INTERFERERAIENT	INTERPELLASSENT
INSEPARABLEMENT	INTERAFRICAINES	INTERFEROGRAMME	INTERPELLASSIEZ
INSOLUBILISAMES	INTERAGISSAIENT	INTERFEROMETRES	INTERPELLATEURS
INSOLUBILISASSE	INTERALLEMANDES	INTERFEROMETRIE	INTERPELLATIONS
INSOLUBILISATES	INTERAMERICAINE	INTERFOLIASSENT	INTERPELLATIVES
INSOLUBILISERAI	INTERAMERICAINS	INTERFOLIASSIEZ	INTERPELLATRICE
INSOLUBILISERAS	INTERATTRACTION	INTERFOLIERIONS	INTERPELLERIONS
INSOLUBILISEREZ	INTERBANCARITES	INTERGALACTIQUE	INTERPENETRAMES
INSOLUBILISIONS	INTERCALASSIONS	INTERGLACIAIRES	INTERPENETRATES
INSONORISASSENT	INTERCALERAIENT	INTERINDIVIDUEL	INTERPENETREREZ
INSONORISASSIEZ	INTERCANTONALES	INTERINDUSTRIEL	INTERPENETRIONS
INSONORISATIONS	INTERCEDASSIONS	INTERIORISAIENT	INTERPERSONNELS


Mots de 15 lettres de INTERPLANETAIRE à LARYNGECTOMISAS - Page 36/61

INTERPLANETAIRE	INTERVIEWASSENT	INVESTIGUASSENT	JUDICIARISATION
INTERPOLASSIONS	INTERVIEWASSIEZ	INVESTIGUASSIEZ	JUDICIARISERAIS
INTERPOLATRICES	INTERVIEWERIONS	INVESTIGUERIONS	JUDICIARISERAIT
INTERPOLERAIENT	INTERVOCALIQUES	INVESTISSEMENTS	JUDICIARISERENT
INTERPOSASSIONS	INTOLERABLEMENT	INVISIBILISAMES*	JUDICIARISERIEZ
INTERPOSERAIENT	INTOLERANTISMES	INVISIBILISASSE*	JUDICIARISERONS
INTERPRETARIATS	INTOXIQUASSIONS	INVISIBILISATES*	JUDICIARISERONT
INTERPRETASSENT	INTOXIQUERAIENT	INVISIBILISERAI*	JURIDICTIONNELS
INTERPRETASSIEZ	INTRACARDIAQUES	INVISIBILISERAS*	JURISPRUDENTIEL
INTERPRETATEURS	INTRACELLULAIRE	INVISIBILISEREZ*	JUSTICIABILITES
INTERPRETATIONS	INTRACEREBRALES	INVISIBILISIONS*	JUSTIFICATRICES
INTERPRETATIVES	INTRACRANIENNES	INVRAISEMBLABLE	JUXTAPOSASSIONS
INTERPRETATRICE	INTRAFAMILIALES	INVRAISEMBLANCE	JUXTAPOSERAIENT
INTERPRETERIONS	INTRAMONTAGNARD	INVULNERABILITE	JUXTATROPICALES
INTERPROFESSION	INTRAMUSCULAIRE	IRRATIONALISMES	KALEIDOSCOPIQUE
INTERPROVINCIAL*	INTRANQUILLITES	IRRATIONALISTES	KAOLINISASSIONS
INTERREGIONALES	INTRANSIGEANCES	IRRECEVABILITES	KAOLINISERAIENT
INTERRELIGIEUSE	INTRANSIGEANTES	IRRECONCILIABLE	KARSTIFICATIONS
INTERROGATOIRES	INTRANSITIVITES	IRREDUCTIBILITE	KAZAKHSTANAISES
INTERROGATRICES	INTRANSMISSIBLE	IRREFUTABILITES	KERATINISASSENT
INTERROGEASSENT	INTRANSPORTABLE	IRREFUTABLEMENT	KERATINISASSIEZ
INTERROGEASSIEZ	INTRANUCLEAIRES	IRREGULIEREMENT	KERATINISATIONS
INTERROGERAIENT	INTRAPSYCHIQUES	IRREPARABLEMENT	KERATINISERIONS
INTERROMPISSENT	INTRARACHIDIENS	IRREPREHENSIBLE	KILOMETRASSIONS
INTERROMPISSIEZ	INTRASPECIFIQUE	IRREPRESENTABLE	KILOMETRERAIENT
INTERROMPRAIENT	INTRINSEQUEMENT	IRRESISTIBILITE	KIMMERIDGIENNES
INTERRONEGATIFS	INTRODUISISSENT	IRRESPECTUEUSES	KINESITHERAPIES
INTERRONEGATIVE	INTRODUISISSIEZ	IRRETRECISSABLE	KNOCKOUTASSIONS
INTERSAISONNIER	INTROJECTASSENT	IRREVERENCIEUSE	KNOCKOUTERAIENT
INTERSEXUALITES	INTROJECTASSIEZ	IRREVERSIBILITE	KREMLINOLOGIQUE
INTERSPECIFIQUE	INTROJECTERIONS	IRREVOCABILITES	LABELLISASSIONS
INTERSTELLAIRES	INTRONISASSIONS	IRREVOCABLEMENT	LABELLISERAIENT
INTERSTITIELLES	INTRONISERAIENT	ISCHIOJAMBIERES*	LABIALISASSIONS
INTERSUBJECTIFS	INTROSPECTAIENT	ISOCHROMATIQUES	LABIALISERAIENT
INTERSUBJECTIVE	INTROSPECTASSES	ISOLATIONNISMES	LABYRINTHIENNES
INTERSYNDICALES	INTROSPECTERAIS	ISOLATIONNISTES	LABYRINTHIFORME
INTERTEXTUALITE	INTROSPECTERAIT	ISOMERISASSIONS	LABYRINTHODONTE
INTERTEXTUELLES	INTROSPECTERENT	ISOMERISERAIENT	LACEDEMONIENNES
INTERTROPICALES	INTROSPECTERIEZ	ITALIANISASSENT	LACTODENSIMETRE
INTERVENTIONNEL	INTROSPECTERONS	ITALIANISASSIEZ	LAMBRISSASSIONS
INTERVERTEBRALE	INTROSPECTERONT	ITALIANISATIONS	LAMBRISSERAIENT
INTERVERTEBRAUX	INTUITIONNISMES	ITALIANISERIONS	LAMELLIBRANCHES
INTERVERTIRIONS	INTUITIONNISTES	JAVELLISASSIONS	LANGOUREUSEMENT
INTERVERTISSAIS	INTUSSUSCEPTION	JAVELLISERAIENT	LANGUEDOCIENNES
INTERVERTISSAIT	INVECTIVASSIONS	JOURNALISASSENT	LAPAROSCOPIQUES
INTERVERTISSANT	INVECTIVERAIENT	JOURNALISASSIEZ	LAPIDIFIASSIONS
INTERVERTISSENT	INVENTORIASSENT	JOURNALISERIONS	LAPIDIFICATIONS
INTERVERTISSIEZ	INVENTORIASSIEZ	JOURNALISTIQUES	LAPIDIFIERAIENT
INTERVERTISSONS	INVENTORIERIONS	JUDICIARISAIENT	LARYNGECTOMISAI
INTERVIENDRIONS	INVESTIGATRICES	JUDICIARISASSES	LARYNGECTOMISAS


Mots de 15 lettres de LARYNGECTOMISAT à MARIVAUDASSIONS - Page 37/61

LARYNGECTOMISAT	LITTORALISATION	MAGNETOSCOPEREZ	MANUTENTIONNEES
LARYNGECTOMISEE	LOBOTOMISASSENT	MAGNETOSCOPIONS	MANUTENTIONNENT
LARYNGECTOMISER	LOBOTOMISASSIEZ	MAGNETOSTATIQUE	MANUTENTIONNERA
LARYNGECTOMISES	LOBOTOMISATIONS*	MAGNETOTHERAPIE	MANUTENTIONNIEZ
LARYNGECTOMISEZ	LOBOTOMISERIONS	MAGOUILLASSIONS	MANUTENTIONNONS
LARYNGOLOGIQUES	LOMBOSCIATIQUES	MAGOUILLERAIENT	MAQUEREAUTAIENT
LARYNGOLOGISTES	LONGUEUILLOISES	MAILLETTERAIENT	MAQUEREAUTASSES
LATERALISATIONS	LUBRIFICATRICES	MAINTIENDRAIENT	MAQUEREAUTERAIS
LATERITISATIONS	LUMINOTHERAPIES	MAJESTUEUSEMENT	MAQUEREAUTERAIT
LECHOUILLASSENT	LUXEMBOURGEOISE	MAJORITAIREMENT	MAQUEREAUTERENT
LECHOUILLASSIEZ	LUXEMBOURGISMES	MALACOPTERYGIEN	MAQUEREAUTERIEZ
LECHOUILLERIONS	LYMPHOBLASTIQUE	MALENCONTREUSES	MAQUEREAUTERONS
LEGISLATIVEMENT	LYMPHOCYTOPENIE	MALHEUREUSEMENT	MAQUEREAUTERONT
LEMMATISASSIONS	LYOPHILISASSENT	MALINTENTIONNEE	MAQUERELLASSENT
LEMMATISERAIENT	LYOPHILISASSIEZ	MALINTENTIONNES	MAQUERELLASSIEZ
LENTIBULARIACEE*	LYOPHILISATEURS	MALLEABILISAMES	MAQUERELLERIONS
LEUCODYSTROPHIE	LYOPHILISATIONS	MALLEABILISASSE	MAQUIGNONNAIENT
LEUCOPOIETIQUES	LYOPHILISERIONS	MALLEABILISATES	MAQUIGNONNASSES
LEVALLOISIENNES	MAASTRICHTIENNE	MALLEABILISERAI	MAQUIGNONNERAIS
LEXICALISASSENT	MACADAMISASSENT	MALLEABILISERAS	MAQUIGNONNERAIT
LEXICALISASSIEZ	MACADAMISASSIEZ	MALLEABILISEREZ	MAQUIGNONNERENT
LEXICALISATIONS	MACADAMISERIONS	MALLEABILISIONS	MAQUIGNONNERIEZ
LEXICALISERIONS	MACHIAVELIENNES	MALTHUSIANISMES	MAQUIGNONNERONS
LEXICOGRAPHIQUE	MACHICOTASSIONS	MALTHUSIANISTES	MAQUIGNONNERONT
LIAISONNASSIONS	MACHICOTERAIENT	MALTRAITASSIONS	MARABOUTASSIONS
LIAISONNERAIENT	MACHOUILLASSENT	MALTRAITERAIENT	MARABOUTERAIENT
LIBERALISASSENT	MACHOUILLASSIEZ	MANCHONNASSIONS	MARCHANDASSIONS
LIBERALISASSIEZ	MACHOUILLERIONS	MANCHONNERAIENT	MARCHANDERAIENT
LIBERALISATIONS	MACROECONOMIQUE	MANGEOTTASSIONS	MARCHANDISAIENT
LIBERALISERIONS	MACROECONOMISTE	MANGEOTTERAIENT	MARCHANDISASSES
LIBEROLIGNEUSES	MACROEVOLUTIONS	MANIFESTASSIONS	MARCHANDISATION
LICENCIEUSEMENT	MACROGLOBULINES	MANIFESTERAIENT	MARCHANDISERAIS
LICHENIFICATION	MACROGRAPHIQUES	MANIGANCASSIONS	MARCHANDISERAIT
LIMOUSINASSIONS	MACRONUTRIMENTS	MANIGANCERAIENT	MARCHANDISERENT
LIMOUSINERAIENT	MACROORDINATEUR	MANOEUVRABILITE	MARCHANDISERIEZ
LINEARISASSIONS*	MACROSCELIDIDES	MANOEUVRASSIONS	MARCHANDISERONS
LINEARISERAIENT*	MACROSEISMIQUES	MANOEUVRERAIENT	MARCHANDISERONT
LIPOASPIRATIONS	MACROSOCIOLOGIE	MANUFACTURABLES	MARCHANDISEUSES
LIPODYSTROPHIES	MACROSTRUCTURES	MANUFACTURAIENT	MARGINALISAIENT
LIPOGRAMMATIQUE	MAGNESIOTHERMIE	MANUFACTURASSES	MARGINALISASSES
LIPSCHITZIENNES	MAGNETISASSIONS	MANUFACTURERAIS	MARGINALISATION
LITHOGRAPHIAMES	MAGNETISERAIENT	MANUFACTURERAIT	MARGINALISERAIS
LITHOGRAPHIASSE	MAGNETOCASSETTE	MANUFACTURERENT	MARGINALISERAIT
LITHOGRAPHIATES	MAGNETOMETRIQUE	MANUFACTURERIEZ	MARGINALISERENT
LITHOGRAPHIERAI	MAGNETOMOTRICES	MANUFACTURERONS	MARGINALISERIEZ
LITHOGRAPHIERAS	MAGNETOSCOPAMES	MANUFACTURERONT	MARGINALISERONS
LITHOGRAPHIEREZ	MAGNETOSCOPASSE	MANUFACTURIERES	MARGINALISERONT
LITHOGRAPHIIONS	MAGNETOSCOPATES	MANUTENTIONNAIS	MARIONNETTISTES
LITHOGRAPHIQUES	MAGNETOSCOPERAI	MANUTENTIONNAIT	MARITIMISATIONS*
LITHOSPHERIQUES	MAGNETOSCOPERAS	MANUTENTIONNANT	MARIVAUDASSIONS


Mots de 15 lettres de MARIVAUDERAIENT à MICROELECTRODES - Page 38/61

MARIVAUDERAIENT	MAXIMALISASSIEZ	MENDIGOTASSIONS	METAMORPHOSABLE
MARMORISASSIONS	MAXIMALISATIONS	MENDIGOTERAIENT	METAMORPHOSAMES
MARMORISERAIENT	MAXIMALISERIONS	MENISCOGRAPHIES	METAMORPHOSASSE
MAROQUINASSIONS	MECANOGRAPHIQUE	MENSUALISASSENT	METAMORPHOSATES
MAROQUINERAIENT	MECANORECEPTEUR	MENSUALISASSIEZ	METAMORPHOSERAI
MARQUETTERAIENT	MECANOTHERAPIES	MENSUALISATIONS	METAMORPHOSERAS
MARSOUINASSIONS	MECONDUISISSENT	MENSUALISERIONS	METAMORPHOSEREZ
MARSOUINERAIENT	MECONDUISISSIEZ	MENTALISASSIONS	METAMORPHOSIONS
MARTYRISASSIONS	MECONNAISSABLES	MENTALISERAIENT	METAPHORISAIENT
MARTYRISERAIENT	MECONNAISSAIENT	MENTIONNASSIONS	METAPHORISASSES
MASCULINISAIENT	MECONNAISSANCES	MENTIONNERAIENT	METAPHORISERAIS
MASCULINISASSES	MECONNAITRAIENT	MERCANTILISAMES	METAPHORISERAIT
MASCULINISATION	MECONTENTASSENT	MERCANTILISASSE	METAPHORISERENT
MASCULINISERAIS	MECONTENTASSIEZ	MERCANTILISATES	METAPHORISERIEZ
MASCULINISERAIT	MECONTENTEMENTS	MERCANTILISERAI	METAPHORISERONS
MASCULINISERENT	MECONTENTERIONS	MERCANTILISERAS	METAPHORISERONT
MASCULINISERIEZ	MEDIAPLANNEUSES	MERCANTILISEREZ	METAPHYSICIENNE
MASCULINISERONS	MEDIATISASSIONS	MERCANTILISIONS	METAPSYCHOLOGIE
MASCULINISERONT	MEDIATISERAIENT	MERCERISASSIONS	METASTASASSIONS
MASSICOTASSIONS	MEDICALISASSENT	MERCERISERAIENT	METASTASERAIENT
MASSICOTERAIENT	MEDICALISASSIEZ	MERDOUILLASSENT	METEORISASSIONS
MASSOTHERAPEUTE	MEDICALISATIONS	MERDOUILLASSIEZ	METEORISERAIENT
MATELASSASSIONS	MEDICALISERIONS	MERDOUILLERIONS	METEOROLOGIQUES
MATELASSERAIENT	MEDICAMENTAIENT	MERISTEMATIQUES	METEOROLOGISTES
MATERIALISAIENT	MEDICAMENTASSES	MERITOCRATIQUES	METHAMPHETAMINE
MATERIALISASSES	MEDICAMENTERAIS	MESEMBRYANTHEME	METHANISASSIONS
MATERIALISATION	MEDICAMENTERAIT	MESENCHYMATEUSE	METHANISERAIENT
MATERIALISERAIS	MEDICAMENTERENT	MESESTIMASSIONS	METHEMOGLOBINES
MATERIALISERAIT	MEDICAMENTERIEZ	MESESTIMERAIENT	METHODOLOGIQUES
MATERIALISERENT	MEDICAMENTERONS	MESINTELLIGENCE	METHYLACRYLIQUE
MATERIALISERIEZ	MEDICAMENTERONT	MESOPOTAMIENNES	METICULEUSEMENT
MATERIALISERONS	MEDICAMENTEUSES	MESOTHERAPEUTES	METROPOLISATION
MATERIALISERONT	MEDICOSPORTIVES*	METABOLISASSENT	METROPOLITAINES
MATERNISASSIONS	MEDITERRANEENNE	METABOLISASSIEZ	MICASCHISTEUSES
MATERNISERAIENT	MEDULLOSURRENAL	METABOLISATIONS	MICHETONNASSENT
MATHEMATICIENNE	MEGALOBLASTIQUE	METABOLISERIONS	MICHETONNASSIEZ
MATHEMATISAIENT	MEGALOCEPHALIES	METALLISASSIONS	MICHETONNERIONS
MATHEMATISASSES	MEGALOMANIAQUES	METALLISERAIENT	MICROBIOLOGIQUE
MATHEMATISATION	MELANOBLASTOMES*	METALLOCHROMIES	MICROBIOLOGISTE
MATHEMATISERAIS	MELANOSTIMULINE	METALLOGENIQUES	MICROBOUTURAGES
MATHEMATISERAIT	MELASTOMATACEES*	METALLOGRAPHIES	MICROBRASSERIES
MATHEMATISERENT	MELODRAMATIQUES	METALLOPROTEINE	MICROCHIROPTERE
MATHEMATISERIEZ	MELODRAMATISAIS	METAMERISATIONS	MICROCHIRURGIES
MATHEMATISERONS	MELODRAMATISAIT	METAMORPHISAMES	MICROCLIMATIQUE
MATHEMATISERONT	MELODRAMATISANT	METAMORPHISASSE	MICROCOPIASSENT
MATRICULASSIONS	MELODRAMATISEES	METAMORPHISATES	MICROCOPIASSIEZ
MATRICULERAIENT	MELODRAMATISENT	METAMORPHISERAI	MICROCOPIERIONS
MAXIDISCOMPTEUR	MELODRAMATISERA	METAMORPHISERAS	MICRODISSECTION
MAXILLOFACIALES	MELODRAMATISIEZ	METAMORPHISEREZ	MICROECONOMIQUE
MAXIMALISASSENT	MELODRAMATISONS	METAMORPHISIONS	MICROELECTRODES


Mots de 15 lettres de MICROENTREPRISE à MYXOEDEMATEUSES - Page 39/61

MICROENTREPRISE	MINIATURISERAIS	MONOCHROMATEURS	MULTICONDUCTEUR
MICROEVOLUTIONS	MINIATURISERAIT	MONOCHROMATIQUE	MULTICULTURELLE
MICROFICHASSENT	MINIATURISERENT	MONOCOTYLEDONES	MULTIDIFFUSIONS
MICROFICHASSIEZ	MINIATURISERIEZ	MONOCRISTALLINE	MULTIFACTORIELS
MICROFICHERIONS	MINIATURISERONS	MONOCRISTALLINS	MULTILINEARITES
MICROFILMASSENT	MINIATURISERONT	MONOCYLINDRIQUE	MULTILINGUISMES
MICROFILMASSIEZ	MINIMALISASSENT	MONOLOGUASSIONS	MULTILOCULAIRES
MICROFILMERIONS	MINIMALISASSIEZ	MONOLOGUERAIENT	MULTINATIONALES
MICROFLUIDIQUES	MINIMALISATIONS	MONOMETALLISMES	MULTIPLEXASSENT
MICROGLOBULINES	MINIMALISERIONS	MONOMETALLISTES	MULTIPLEXASSIEZ
MICROGLOSSAIRES	MINIORDINATEURS*	MONOPARENTALITE	MULTIPLEXERIONS
MICROGRAPHIQUES	MIRACULEUSEMENT	MONOPHYLETIQUES	MULTIPLIASSIONS
MICROMECANIQUES	MISANTHROPIQUES	MONOPOLISASSENT	MULTIPLICATEURS
MICROMETEORITES	MISERICORDIEUSE	MONOPOLISASSIEZ	MULTIPLICATIONS
MICRONISASSIONS	MISSIONNASSIONS	MONOPOLISATEURS	MULTIPLICATIVES
MICRONISERAIENT	MISSIONNERAIENT	MONOPOLISATIONS	MULTIPLICATRICE
MICRONUTRIMENTS	MITHRIDATISAMES	MONOPOLISATRICE	MULTIPLIERAIENT
MICROORDINATEUR	MITHRIDATISASSE	MONOPOLISERIONS	MULTIPROCESSEUR
MICROORGANISMES	MITHRIDATISATES	MONOPOLISTIQUES	MULTIPROGRAMMEE
MICROPARTICULES*	MITHRIDATISERAI	MONOPROCESSEURS	MULTIPROGRAMMES
MICROPESANTEURS	MITHRIDATISERAS	MONOSACCHARIDES	MULTIPROPRIETES
MICROPODIFORMES	MITHRIDATISEREZ	MONOSUBSTITUEES	MULTIRESISTANCE
MICROPROCESSEUR	MITHRIDATISIONS	MONOSYLLABIQUES	MULTIRESISTANTE
MICROPROGRAMMES	MITOCHONDRIALES	MONOSYLLABISMES	MULTIRESISTANTS
MICROSATELLITES	MITRAILLASSIONS	MONSTRUEUSEMENT	MULTISECULAIRES
MICROSEISMIQUES	MITRAILLERAIENT	MONTBELIARDAISE*	MULTITRAITEMENT
MICROSOCIOLOGIE	MIXTIONNASSIONS	MONTLUCONNAISES	MULTITUBULAIRES
MICROSTRUCTURES	MIXTIONNERAIENT	MONTMORILLONITE	MULTIVIBRATEURS
MICROTECHNIQUES	MNEMOTECHNIQUES	MONTPELLIERAINE	MUNICIPALISAMES
MICROVILLOSITES	MODERNISASSIONS	MONTPELLIERAINS	MUNICIPALISASSE
MILITARISASSENT	MODERNISATRICES	MONTREUILLOISES	MUNICIPALISATES
MILITARISASSIEZ	MODERNISERAIENT	MORPHOGENETIQUE	MUNICIPALISERAI
MILITARISATIONS	MOISSONNASSIONS	MORPHOMETRIQUES	MUNICIPALISERAS
MILITARISERIONS	MOISSONNERAIENT	MOTIVATIONNELLE	MUNICIPALISEREZ
MILLESIMASSIONS	MOLLETONNASSENT	MOTOPROPULSEURS	MUNICIPALISIONS
MILLESIMERAIENT	MOLLETONNASSIEZ	MOUCHARDASSIONS	MUNITIONNASSENT
MILLIMETRASSENT	MOLLETONNERIONS	MOUCHARDERAIENT	MUNITIONNASSIEZ
MILLIMETRASSIEZ	MONARCHISASSENT	MOUCHERONNAIENT	MUNITIONNERIONS
MILLIMETRERIONS	MONARCHISASSIEZ	MOUCHERONNASSES	MUSEOGRAPHIQUES
MILLIVOLTMETRES	MONARCHISERIONS	MOUCHERONNERAIS	MUSICOGRAPHIQUE
MINERALISASSENT	MONDIALISASSENT	MOUCHERONNERAIT	MUSICOTHERAPIES
MINERALISASSIEZ	MONDIALISASSIEZ	MOUCHERONNERENT	MUTUALISASSIONS
MINERALISATEURS	MONDIALISATIONS	MOUCHERONNERIEZ	MUTUALISERAIENT
MINERALISATIONS	MONDIALISERIONS	MOUCHERONNERONS	MYCORHIZASSIONS
MINERALISATRICE	MONETARISASSENT*	MOUCHERONNERONT	MYCORHIZERAIENT
MINERALISERIONS	MONETARISASSIEZ*	MOUCHETTERAIENT	MYOCARDIOPATHIE
MINERALURGIQUES	MONETARISATIONS	MOUVEMENTASSENT	MYSTERIEUSEMENT
MINIATURISAIENT	MONETARISERIONS*	MOUVEMENTASSIEZ	MYSTIFICATRICES
MINIATURISASSES	MONOCAMERALISME	MOUVEMENTERIONS	MYTILICULTRICES
MINIATURISATION	MONOCELLULAIRES	MULTICELLULAIRE	MYXOEDEMATEUSES


Mots de 15 lettres de NABUCHODONOSORS à ORNEMENTASSIONS - Page 40/61

NABUCHODONOSORS	NEURASTHENIQUES	NUTRITIONNELLES	OFFICIALISERONT
NAEVOCARCINOMES	NEUROBIOCHIMIES	NUTRITIONNISTES	OLEOPNEUMATIQUE
NANOTECHNOLOGIE	NEUROBIOLOGIQUE	OBJECTIVASSIONS	OLIGODENDROCYTE
NARCISSIQUEMENT	NEUROBIOLOGISTE	OBJECTIVERAIENT	OLIGODENDROGLIE
NARCOTRAFIQUANT	NEUROCHIRURGIEN	OBLIGATOIREMENT	OLIGOPOLISTIQUE
NARRATOLOGIQUES	NEUROCHIRURGIES	OBSCURCISSAIENT	OLIGOSACCARIDES*
NATIONALISABLES	NEURODEPRESSEUR	OBSCURCISSEMENT	OLIGOSACCHARIDE
NATIONALISAIENT	NEUROENDOCRINES	OBSEQUIEUSEMENT	OMBELLIFERACEES
NATIONALISASSES	NEUROMEDIATEURS	OBSERVATIONNELS	OMNIPRATICIENNE
NATIONALISATION	NEUROMUSCULAIRE	OBSESSIONNELLES	ONIROMANCIENNES
NATIONALISERAIS	NEUROPATHOLOGIE	OBSTETRICIENNES	ONOMASIOLOGIQUE
NATIONALISERAIT	NEUROPLASTICITE	OBTEMPERASSIONS	ONTOLOGIQUEMENT
NATIONALISERENT	NEUROPSYCHIATRE	OBTEMPERERAIENT	OPERATIONNELLES
NATIONALISERIEZ	NEUROPSYCHIQUES	OCCASIONNALISME	OPHTALMOLOGIQUE
NATIONALISERONS	NEURORADIOLOGIE	OCCASIONNASSENT	OPHTALMOLOGISTE
NATIONALISERONT	NEURORECEPTEURS	OCCASIONNASSIEZ	OPHTALMOMETRIES
NATURALISASSENT	NEUROSECRETIONS	OCCASIONNERIONS	OPHTALMOSCOPIES
NATURALISASSIEZ	NEUROVEGETATIFS	OCCIDENTALISAIS	OPINIATRASSIONS
NATURALISATIONS	NEUROVEGETATIVE	OCCIDENTALISAIT	OPINIATRERAIENT
NATURALISERIONS	NEUTRALISASSENT	OCCIDENTALISANT	OPISTHOBRANCHES
NATUROPATHIQUES	NEUTRALISASSIEZ	OCCIDENTALISEES	OPPOSITIONNELLE
NAUFRAGEASSIONS	NEUTRALISATIONS	OCCIDENTALISENT	OPTIMALISASSENT
NEANDERTALIENNE	NEUTRALISERIONS	OCCIDENTALISERA	OPTIMALISASSIEZ
NEANTHROPIENNES	NEUTRONOGRAPHIE	OCCIDENTALISIEZ	OPTIMALISATIONS
NECESSITASSIONS	NICARAGUAYENNES	OCCIDENTALISMES	OPTIMALISERIONS
NECESSITERAIENT	NIGHTCLUBBEUSES*	OCCIDENTALISONS	ORCHESTRASSIONS
NECROMANCIENNES	NITRIFICATRICES	OCCIDENTALISTES	ORCHESTRATRICES
NEERLANDOPHONES	NITROCELLULOSES	OCCUPATIONNELLE	ORCHESTRERAIENT
NEGROSPIRITUALS*	NITROGLYCERINES	OCEANOGRAPHIQUE	ORDINATICIENNES
NEMATHELMINTHES	NOMENKLATURISTE	OCTOCORALLIAIRE	ORDONNANCASSENT
NEOCALEDONIENNE*	NOMINALISASSENT	OCTOSYLLABIQUES	ORDONNANCASSIEZ
NEOCAPITALISMES	NOMINALISASSIEZ	OECUMENIQUEMENT	ORDONNANCEMENTS
NEOCAPITALISTES	NOMINALISATIONS	OEILLETONNAIENT	ORDONNANCERIONS
NEOCLASSICISMES	NOMINALISERIONS	OEILLETONNASSES	ORGANISATIONNEL
NEOCOLONIALISME	NORADRENERGIQUE	OEILLETONNERAIS	ORGANOGENETIQUE
NEOCOLONIALISTE	NORAMIDOPYRINES	OEILLETONNERAIT	ORGANOLEPTIQUES
NEOCONSERVATEUR	NORMALISASSIONS	OEILLETONNERENT	ORGANOMAGNESIEN
NEODARWINIENNES	NORMALISATRICES	OEILLETONNERIEZ	ORGANOPHOSPHORE
NEOGLUCOGENESES	NORMALISERAIENT	OEILLETONNERONS	ORGANOTHERAPIES
NEOGRAMMAIRIENS	NOSTALGIQUEMENT	OEILLETONNERONT	ORGANSINASSIONS
NEOKEYNESIENNES*	NOUAKCHOTTOISES	OESOPHAGOSCOPES	ORGANSINERAIENT
NEOLIBERALISMES	NOVELLISASSIONS	OESOPHAGOSCOPIE	ORIENTALISAIENT
NEOLITHISATIONS	NOVELLISERAIENT	OFFICIALISAIENT	ORIENTALISASSES
NEOLOGISASSIONS	NUCLEARISASSENT	OFFICIALISASSES	ORIENTALISERAIS
NEOLOGISERAIENT	NUCLEARISASSIEZ	OFFICIALISATION	ORIENTALISERAIT
NEONICOTINOIDES*	NUCLEARISATIONS	OFFICIALISERAIS	ORIENTALISERENT
NEOPLASTICISMES	NUCLEARISERIONS	OFFICIALISERAIT	ORIENTALISERIEZ
NEOPLATONICIENS	NUCLEOPROTEIDES	OFFICIALISERENT	ORIENTALISERONS
NEOPOSITIVISMES	NUCLEOPROTEINES	OFFICIALISERIEZ	ORIENTALISERONT
NEOPOSITIVISTES	NUCLEOSYNTHESES	OFFICIALISERONS	ORNEMENTASSIONS


Mots de 15 lettres de ORNEMENTERAIENT à PARTICULARISMES - Page 41/61

ORNEMENTERAIENT	PALATALISASSIEZ	PANTHEONISERENT	PARAVOLCANIQUES
ORNITHOLOGIQUES	PALATALISATIONS	PANTHEONISERIEZ	PARCELLARISAMES
ORNITHOLOGISTES	PALATALISERIONS	PANTHEONISERONS	PARCELLARISASSE
ORTHOCENTRIQUES	PALEANTHROPIENS	PANTHEONISERONT	PARCELLARISATES
ORTHOGONALEMENT	PALEOASIATIQUES	PANTOUFLASSIONS	PARCELLARISERAI
ORTHOGRAPHIAMES	PALEOBOTANIQUES	PANTOUFLERAIENT	PARCELLARISERAS
ORTHOGRAPHIASSE	PALEOBOTANISTES	PAPILLONNASSENT	PARCELLARISEREZ
ORTHOGRAPHIATES	PALEOCHRETIENNE	PAPILLONNASSIEZ	PARCELLARISIONS
ORTHOGRAPHIERAI	PALEOCLIMATIQUE	PAPILLONNEMENTS	PARCELLISASSENT
ORTHOGRAPHIERAS	PALEOGEOGRAPHES	PAPILLONNERIONS	PARCELLISASSIEZ
ORTHOGRAPHIEREZ	PALEOGEOGRAPHIE	PAPILLOTASSIONS	PARCELLISATIONS
ORTHOGRAPHIIONS	PALEOGRAPHIQUES	PAPILLOTERAIENT	PARCELLISERIONS
ORTHOGRAPHIQUES	PALEOHISTOLOGIE	PARABOLIQUEMENT	PARCHEMINASSENT
ORTHOPEDAGOGIES	PALEOMAGNETIQUE	PARACHEVASSIONS	PARCHEMINASSIEZ
ORTHOPEDAGOGUES	PALEOMAGNETISME	PARACHEVERAIENT	PARCHEMINERIONS
ORTHOPHOSPHATES	PALEONTOLOGIQUE	PARACHUTASSIONS	PAREMENTASSIONS
ORTHORHOMBIQUES	PALEONTOLOGISTE	PARACHUTERAIENT	PAREMENTERAIENT
OSTEOCHONDRITES	PALEOPATHOLOGIE	PARACOMMERCIALE	PARENCHYMATEUSE
OSTEOCHONDROSES	PALEOSIBERIENNE	PARACOMMERCIAUX	PARISIANISAIENT
OSTEOPOROTIQUES	PALETTISASSIONS	PARADIGMATIQUES	PARISIANISASSES
OSTEOPRATICIENS	PALETTISERAIENT	PARAFFINASSIONS	PARISIANISERAIS
OSTRACISASSIONS	PALINGENESIQUES	PARAFFINERAIENT	PARISIANISERAIT
OSTRACISERAIENT	PALISSADASSIONS	PARALITTERAIRES	PARISIANISERENT
OSTREICULTRICES	PALISSADERAIENT	PARALITTERATURE	PARISIANISERIEZ
OUTREPASSASSENT	PALISSONNASSENT	PARALLELEPIPEDE	PARISIANISERONS
OUTREPASSASSIEZ	PALISSONNASSIEZ	PARALLELIPIPEDE	PARISIANISERONT
OUTREPASSERIONS	PALISSONNERIONS	PARALLELOGRAMME	PARISYLLABIQUES
OVATIONNASSIONS	PAMPLEMOUSSIERS	PARAMAGNETIQUES	PARKERISASSIONS
OVATIONNERAIENT	PANAFRICANISMES	PARAMAGNETISMES	PARKERISERAIENT
OXYACETYLENIQUE	PANAMERICANISME	PARAMETRASSIONS	PARKINSONIENNES
OXYDOREDUCTASES	PANCAPITALISMES	PARAMETRERAIENT	PARLEMENTARISME
OXYDOREDUCTEURS	PANCHROMATIQUES	PARAMIDOPHENOLS	PARLEMENTASSENT
OXYDOREDUCTIONS	PANCREATECTOMIE	PARAMINOPHENOLS	PARLEMENTASSIEZ
OXYDOREDUCTRICE	PANNEAUTASSIONS	PARANEOPLASIQUE	PARLEMENTERIONS
OXYGENOTHERAPIE	PANNEAUTERAIENT	PARANGONNASSENT	PARODONTOLOGIES
OXYHEMOGLOBINES	PANORAMIQUAIENT	PARANGONNASSIEZ	PARODONTOLOGUES
PAILLARDASSIONS	PANORAMIQUASSES	PARANGONNERIONS	PARODONTOPATHIE
PAILLARDERAIENT	PANORAMIQUERAIS	PARAPETROLIERES	PARQUETTERAIENT
PAILLASSONNAGES	PANORAMIQUERAIT	PARAPHRASASSENT	PARTHENOCARPIES
PAILLASSONNAMES	PANORAMIQUERENT	PARAPHRASASSIEZ	PARTHENOGENESES
PAILLASSONNASSE	PANORAMIQUERIEZ	PARAPHRASERIONS	PARTICIPASSIONS
PAILLASSONNATES	PANORAMIQUERONS	PARAPHRASTIQUES	PARTICIPERAIENT
PAILLASSONNERAI	PANORAMIQUERONT	PARAPHYLETIQUES	PARTICULARISAIS
PAILLASSONNERAS	PANTAGRUELIQUES	PARAPSYCHOLOGIE	PARTICULARISAIT
PAILLASSONNEREZ	PANTHEONISABLES*	PARAPSYCHOLOGUE	PARTICULARISANT
PAILLASSONNIONS	PANTHEONISAIENT	PARASITOLOGIQUE	PARTICULARISEES
PAILLETTERAIENT	PANTHEONISASSES	PARASYMPATHIQUE	PARTICULARISENT
PAILLONNASSIONS	PANTHEONISATION	PARASYNTHETIQUE	PARTICULARISERA
PAILLONNERAIENT	PANTHEONISERAIS	PARATHYROIDIENS	PARTICULARISIEZ
PALATALISASSENT	PANTHEONISERAIT	PARATUBERCULOSE	PARTICULARISMES


Mots de 15 lettres de PARTICULARISONS à PHILOSOPHASSIEZ - Page 42/61

PARTICULARISONS	PELLICULASSIONS	PERMEABILISAMES	PETITIONNEMENTS
PARTICULARISTES	PELLICULERAIENT	PERMEABILISASSE	PETITIONNERIONS
PARTITIONNAIENT	PELOPONNESIENNE	PERMEABILISATES	PETOUILLASSIONS
PARTITIONNASSES	PELOTONNASSIONS	PERMEABILISERAI	PETOUILLERAIENT
PARTITIONNEMENT	PELOTONNERAIENT	PERMEABILISERAS	PETRARQUISAIENT
PARTITIONNERAIS	PELVIPERITONITE	PERMEABILISEREZ	PETRARQUISANTES
PARTITIONNERAIT	PENDOUILLASSENT	PERMEABILISIONS	PETRARQUISASSES
PARTITIONNERENT	PENDOUILLASSIEZ	PERMISSIONNAIRE	PETRARQUISERAIS
PARTITIONNERIEZ	PENDOUILLERIONS	PERNICIEUSEMENT	PETRARQUISERAIT
PARTITIONNERONS	PENNSYLVANIENNE	PERONOSPORACEES	PETRARQUISERENT
PARTITIONNERONT	PENSIONNASSIONS	PERPENDICULAIRE	PETRARQUISERIEZ
PASSEMENTASSENT	PENSIONNERAIENT	PERPETUELLEMENT	PETRARQUISERONS
PASSEMENTASSIEZ	PENTASYLLABIQUE	PERQUISITIONNAI	PETRARQUISERONT
PASSEMENTERIONS	PENTATHLONIENNE	PERQUISITIONNAS	PETROGRAPHIQUES
PASSEPOILASSENT	PENTHIOBARBITAL	PERQUISITIONNAT	PETROLOCHIMIQUE
PASSEPOILASSIEZ	PERCEPTIBILITES	PERQUISITIONNEE	PETROLOCHIMISTE
PASSEPOILERIONS	PERCEPTIBLEMENT	PERQUISITIONNER	PETROMONARCHIES
PASSIONNASSIONS	PERCEPTIONNISME	PERQUISITIONNES	PHAGOCYTASSIONS
PASSIONNERAIENT	PERCUSSIONNISTE	PERQUISITIONNEZ	PHAGOCYTERAIENT
PASTEURISASSENT	PERCUTIREACTION	PERSECUTASSIONS	PHALANSTERIENNE
PASTEURISASSIEZ	PEREGRINASSIONS	PERSECUTERAIENT	PHALLOCENTRIQUE
PASTEURISATEURS	PEREGRINERAIENT	PERSEVERASSIONS	PHALLOCENTRISME
PASTEURISATIONS	PEREMPTOIREMENT	PERSEVERERAIENT	PHALLOCRATIQUES
PASTEURISERIONS	PERENNISASSIONS	PERSIFFLASSIONS	PHANTASMASSIONS
PATHOGNOMONIQUE	PERENNISERAIENT	PERSIFFLERAIENT	PHANTASMERAIENT
PATOUILLASSIONS	PERFECTIBILITES	PERSONNALISABLE	PHARMACEUTIQUES
PATOUILLERAIENT	PERFECTIONNAMES	PERSONNALISAMES	PHARMACODYNAMIE
PATRIARCALEMENT	PERFECTIONNASSE	PERSONNALISASSE	PHARMACOGNOSIES
PATRIGOTASSIONS	PERFECTIONNATES	PERSONNALISATES	PHARMACOLOGIQUE
PATRIGOTERAIENT	PERFECTIONNERAI	PERSONNALISERAI	PHARMACOLOGISTE
PATRIOTIQUEMENT	PERFECTIONNERAS	PERSONNALISERAS	PHARYNGOSCOPIES
PATROUILLASSENT	PERFECTIONNEREZ	PERSONNALISEREZ	PHENAKISTICOPES
PATROUILLASSIEZ	PERFECTIONNIONS	PERSONNALISIONS	PHENAKISTISCOPE
PATROUILLERIONS	PERFECTIONNISME	PERSONNELLEMENT	PHENOLPHTALEINE
PAUPERISASSIONS	PERFECTIONNISTE	PERSONNIFIAIENT	PHENOMENALEMENT
PAUPERISERAIENT	PERIARTICULAIRE	PERSONNIFIASSES	PHENOMENALISMES
PECTINICULTEURS	PERICLITASSIONS	PERSONNIFIERAIS	PHENOMENALISTES
PECTINICULTRICE	PERICLITERAIENT	PERSONNIFIERAIT	PHENOMENOLOGIES
PECTINICULTURES	PERINEORRAPHIES	PERSONNIFIERENT	PHENOMENOLOGUES
PEDAGOGIQUEMENT	PERIPATETICIENS	PERSONNIFIERIEZ	PHENYLBUTAZONES
PEDOPSYCHIATRES	PERIPHRASASSENT	PERSONNIFIERONS	PHENYLCETONURIE
PEDOPSYCHIATRIE	PERIPHRASASSIEZ	PERSONNIFIERONT	PHENYLPYRUVIQUE
PEINTURLURAIENT	PERIPHRASERIONS	PERSPECTIVISMES	PHILADELPHIENNE
PEINTURLURASSES	PERIPHRASTIQUES	PERVERTISSAIENT	PHILANTHROPIQUE
PEINTURLURERAIS	PERISSODACTYLES	PERVERTISSEMENT	PHILANTHROPISME
PEINTURLURERAIT	PERITELEPHONIES	PERVERTISSEUSES	PHILHARMONIQUES
PEINTURLURERENT	PERITELEVISIONS	PESTILENTIELLES	PHILHELLENIQUES
PEINTURLURERIEZ	PERMANENTASSENT	PETERSBOURGEOIS*	PHILHELLENISMES
PEINTURLURERONS	PERMANENTASSIEZ	PETITIONNASSENT	PHILOSOPHASSENT
PEINTURLURERONT	PERMANENTERIONS	PETITIONNASSIEZ	PHILOSOPHASSIEZ


Mots de 15 lettres de PHILOSOPHERIONS à POLITIQUASSIONS - Page 43/61

PHILOSOPHERIONS	PHOTOGRAPHIERAI	PIQUENIQUASSENT	PLIENSBACHIENNE
PHILOTECHNIQUES	PHOTOGRAPHIERAS	PIQUENIQUASSIEZ	PLOUTOCRATIQUES
PHLEBOTHROMBOSE	PHOTOGRAPHIEREZ	PIQUENIQUERIONS	PLURALISASSIONS
PHONETISASSIONS	PHOTOGRAPHIIONS	PIRANDELLIENNES	PLURALISERAIENT
PHONETISERAIENT	PHOTOGRAPHIQUES	PIROUETTASSIONS	PLURIANNUALITES
PHONOGRAPHIQUES	PHOTOMAGNETIQUE	PIROUETTERAIENT	PLURICELLULAIRE
PHOSPHATASSIONS	PHOTOMECANIQUES	PITHECANTHROPES	PLURICULTURELLE
PHOSPHATERAIENT	PHOTOPERIODIQUE	PITTORESQUEMENT	PLURILINGUISMES
PHOSPHOCALCIQUE	PHOTOPERIODISME	PIXELLISASSIONS	PLURINATIONALES
PHOSPHOPROTEIDE	PHOTORECEPTEURS	PIXELLISERAIENT	PLURISECULAIRES
PHOSPHOPROTEINE	PHOTORECEPTRICE	PLACARDISASSENT	PLUVIOMETRIQUES
PHOSPHORASSIONS	PHOTOREPORTAGES	PLACARDISASSIEZ	PNEUMALLERGENES
PHOSPHORERAIENT	PHOTOREPORTEURS	PLACARDISATIONS	PNEUMOGASTRIQUE
PHOSPHORESCENCE	PHOTOREPORTRICE	PLACARDISERIONS	PNEUMOMEDIASTIN
PHOSPHORESCENTE	PHOTORESISTANCE	PLAISANTASSIONS	PNEUMONECTOMIES
PHOSPHORESCENTS	PHOTORESISTANTE	PLAISANTERAIENT	PNEUMOPERITOINE
PHOSPHORISATION	PHOTORESISTANTS	PLANCHEIASSIONS	POCHETRONNAIENT*
PHOSPHORYLAIENT	PHOTOSTOPPEUSES	PLANCHEIERAIENT	POCHETRONNASSES*
PHOSPHORYLASSES	PHOTOTRANSISTOR	PLANETARISAIENT	POCHETRONNERAIS*
PHOSPHORYLATION	PHOTOVOLTAIQUES	PLANETARISASSES	POCHETRONNERAIT*
PHOSPHORYLERAIS	PHRASEOLOGIQUES	PLANETARISATION	POCHETRONNERENT*
PHOSPHORYLERAIT	PHTISIOLOGIQUES	PLANETARISERAIS	POCHETRONNERIEZ*
PHOSPHORYLERENT	PHYCOERYTHRINES	PLANETARISERAIT	POCHETRONNERONS*
PHOSPHORYLERIEZ	PHYLLOXERIENNES	PLANETARISERENT	POCHETRONNERONT*
PHOSPHORYLERONS	PHYLOGENETIQUES	PLANETARISERIEZ	POCHTRONNASSENT*
PHOSPHORYLERONT	PHYSICOCHIMIQUE	PLANETARISERONS	POCHTRONNASSIEZ*
PHOTOCHROMIQUES	PHYSICOCHIMISTE	PLANETARISERONT	POCHTRONNERIONS*
PHOTOCHROMISMES	PHYSIOCRATIQUES	PLANETOLOGIQUES	PODZOLISASSIONS
PHOTOCOMPOSAMES	PHYSIOGNOMONIES	PLANIFICATRICES	PODZOLISERAIENT
PHOTOCOMPOSASSE	PHYSIOTHERAPIES	PLANTUREUSEMENT	POECILOTHERMIES
PHOTOCOMPOSATES	PHYTOCOSMETIQUE	PLASMIFIASSIONS	POIGNARDASSIONS
PHOTOCOMPOSERAI	PHYTOGEOGRAPHES	PLASMIFIERAIENT	POIGNARDERAIENT
PHOTOCOMPOSERAS	PHYTOGEOGRAPHIE	PLASTIFIASSIONS	POIKILOTHERMIES
PHOTOCOMPOSEREZ	PHYTOPATHOLOGIE	PLASTIFICATIONS	POINCONNASSIONS
PHOTOCOMPOSEURS	PHYTOPHARMACIES	PLASTIFIERAIENT	POINCONNERAIENT
PHOTOCOMPOSEUSE	PHYTOSANITAIRES	PLASTIQUASSIONS	POINTILLASSIONS
PHOTOCOMPOSIONS	PHYTOSOCIOLOGIE	PLASTIQUERAIENT	POINTILLERAIENT
PHOTOCONDUCTEUR	PHYTOTHERAPEUTE	PLASTRONNASSENT	POIREAUTASSIONS
PHOTOCONDUCTION	PICTOGRAPHIQUES	PLASTRONNASSIEZ	POIREAUTERAIENT
PHOTOCOPIASSENT	PIETONNISASSENT	PLASTRONNERIONS	POLARIMETRIQUES
PHOTOCOPIASSIEZ	PIETONNISASSIEZ	PLATINISASSIONS	POLDERISASSIONS
PHOTOCOPIERIONS	PIETONNISATIONS	PLATINISERAIENT	POLDERISERAIENT
PHOTOCOPILLAGES	PIETONNISERIONS	PLEBISCITASSENT	POLEMIQUASSIONS
PHOTOELASTICITE	PIEZOELECTRIQUE	PLEBISCITASSIEZ	POLEMIQUERAIENT
PHOTOELECTRIQUE	PIGOUILLASSIONS	PLEBISCITERIONS	POLIOMYELITIQUE
PHOTOEMETTRICES	PIGOUILLERAIENT	PLEURNICHASSENT	POLISSONNASSENT
PHOTOGRAMMETRIE	PINCEAUTASSIONS	PLEURNICHASSIEZ	POLISSONNASSIEZ
PHOTOGRAPHIAMES	PINCEAUTERAIENT	PLEURNICHEMENTS	POLISSONNERIONS
PHOTOGRAPHIASSE	PINDARISASSIONS	PLEURNICHERIONS	POLITICAILLERIE
PHOTOGRAPHIATES	PINDARISERAIENT	PLEUROPNEUMONIE	POLITIQUASSIONS


Mots de 15 lettres de POLITIQUERAIENT à PREFIGURERAIENT - Page 44/61

POLITIQUERAIENT	PORTRAITURERONT	POULIETHERAPIES	PREDEFINISSIONS
POLLINISASSIONS	POSITIONNASSENT	POURCHASSASSENT	PREDELINQUANCES
POLLINISATRICES	POSITIONNASSIEZ	POURCHASSASSIEZ	PREDELINQUANTES
POLLINISERAIENT	POSITIONNEMENTS	POURCHASSERIONS	PREDESTINASSENT
POLYCOPIASSIONS	POSITIONNERIONS	POURFENDISSIONS	PREDESTINASSIEZ
POLYCOPIERAIENT	POSSESSIONNELLE	POURLECHASSIONS	PREDESTINATIONS
POLYCRISTALLINE	POSTCOMBUSTIONS	POURLECHERAIENT	PREDESTINERIONS
POLYCRISTALLINS	POSTCOMMUNISMES	POURSUIVISSIONS	PREDETERMINAMES
POLYELECTROLYTE	POSTCOMMUNISTES	PRAGMATIQUEMENT	PREDETERMINANTE
POLYFONCTIONNEL	POSTDOCTORANTES	PREACCENTUATION	PREDETERMINANTS
POLYGONISATIONS	POSTELECTORALES	PREADOLESCENCES	PREDETERMINASSE
POLYHANDICAPEES	POSTERIEUREMENT	PREADOLESCENTES	PREDETERMINATES
POLYMERISASSENT	POSTERISASSIONS	PREANESTHESIQUE	PREDETERMINERAI
POLYMERISASSIEZ	POSTERISERAIENT	PRECARISASSIONS	PREDETERMINERAS
POLYMERISATIONS	POSTILLONNAIENT	PRECARISERAIENT	PREDETERMINEREZ
POLYMERISERIONS	POSTILLONNASSES	PRECAUTIONNAMES	PREDETERMINIONS
POLYMETALLIQUES	POSTILLONNERAIS	PRECAUTIONNASSE	PREDETERMINISME
POLYNUCLEOTIDES	POSTILLONNERAIT	PRECAUTIONNATES	PREDICTIBILITES
POLYPEPTIDIQUES	POSTILLONNERENT	PRECAUTIONNERAI	PREDISPOSASSENT
POLYPLACOPHORES	POSTILLONNERIEZ	PRECAUTIONNERAS	PREDISPOSASSIEZ
POLYSACCHARIDES	POSTILLONNERONS	PRECAUTIONNEREZ	PREDISPOSERIONS
POLYSYLLABIQUES	POSTILLONNERONT	PRECAUTIONNEUSE	PREDISPOSITIONS
POLYSYNTHETIQUE	POSTINDUSTRIELS	PRECAUTIONNIONS	PREDOMINASSIONS
POLYTECHNICIENS	POSTMODERNISMES	PRECHAUFFASSENT	PREDOMINERAIENT
POLYTOXICOMANES	POSTOPERATOIRES	PRECHAUFFASSIEZ	PREELEMENTAIRES
POLYTOXICOMANIE	POSTPRODUCTIONS	PRECHAUFFERIONS	PREENREGISTRAIS
POLYTRANSFUSEES	POSTROMANTIQUES	PRECIPITASSIONS	PREENREGISTRAIT
POLYTRAUMATISEE	POSTSONORISAMES	PRECIPITERAIENT	PREENREGISTRANT
POLYTRAUMATISES	POSTSONORISASSE	PRECISIONNISMES	PREENREGISTREES
POLYTRAUMATISME	POSTSONORISATES	PRECOLOMBIENNES	PREENREGISTRENT
PONCTIONNASSENT	POSTSONORISERAI	PRECOMMANDAIENT	PREENREGISTRERA
PONCTIONNASSIEZ	POSTSONORISERAS	PRECOMMANDASSES	PREENREGISTRIEZ
PONCTIONNERIONS	POSTSONORISEREZ	PRECOMMANDERAIS	PREENREGISTRONS
POPULARISASSENT	POSTSONORISIONS	PRECOMMANDERAIT	PREETABLIRAIENT
POPULARISASSIEZ	POSTSYNAPTIQUES	PRECOMMANDERENT	PREETABLISSIONS
POPULARISATIONS	POSTSYNCHRONISA	PRECOMMANDERIEZ	PREEXISTASSIONS
POPULARISERIONS	POSTSYNCHRONISE	PRECOMMANDERONS	PREEXISTERAIENT
POPULATIONNISTE	POSTTRAUMATIQUE*	PRECOMMANDERONT	PREFABRICATIONS
POPULICULTRICES	POTAMOGETONACEE	PRECOMPTASSIONS	PREFABRIQUAIENT
PORNOGRAPHIQUES	POTENTIALISAMES	PRECOMPTERAIENT	PREFABRIQUASSES
PORPHYROGENETES	POTENTIALISASSE	PRECONCEVRAIENT	PREFABRIQUERAIS
PORTIONNASSIONS	POTENTIALISATES	PRECONISASSIONS	PREFABRIQUERAIT
PORTIONNERAIENT	POTENTIALISERAI	PRECONISATRICES	PREFABRIQUERENT
PORTRAITURAIENT	POTENTIALISERAS	PRECONISERAIENT	PREFABRIQUERIEZ
PORTRAITURASSES	POTENTIALISEREZ	PREDECEDASSIONS	PREFABRIQUERONS
PORTRAITURERAIS	POTENTIALISIONS	PREDECEDERAIENT	PREFABRIQUERONT
PORTRAITURERAIT	POTENTIELLEMENT	PREDECOUPASSENT	PREFERENTIELLES
PORTRAITURERENT	POUBELLISASSENT*	PREDECOUPASSIEZ	PREFEUILLAISONS
PORTRAITURERIEZ	POUBELLISASSIEZ*	PREDECOUPERIONS	PREFIGURASSIONS
PORTRAITURERONS	POUBELLISERIONS*	PREDEFINIRAIENT	PREFIGURERAIENT


Mots de 15 lettres de PREFINANCASSENT à PROPORTIONNIONS - Page 45/61

PREFINANCASSENT	PRESCIENTIFIQUE	PRIMOARRIVANTES*	PROJECTIONNISTE
PREFINANCASSIEZ	PRESCRIVISSIONS	PRIMODELINQUANT	PROLETARISAIENT
PREFINANCEMENTS	PRESELECTIONNAI	PRIMORDIALEMENT	PROLETARISASSES
PREFINANCERIONS	PRESELECTIONNAS	PRINCIPAUTAIRES	PROLETARISATION
PREFORMATASSENT	PRESELECTIONNAT	PRINTANISATIONS	PROLETARISERAIS
PREFORMATASSIEZ	PRESELECTIONNEE	PRIORITAIREMENT	PROLETARISERAIT
PREFORMATERIONS	PRESELECTIONNER	PRISCILLIANISME	PROLETARISERENT
PREHISTORIENNES	PRESELECTIONNES	PRIVATISASSIONS	PROLETARISERIEZ
PREINDUSTRIELLE	PRESELECTIONNEZ	PRIVATISERAIENT	PROLETARISERONS
PREINSCRIPTIONS	PRESIDENTIABLES	PRIVILEGIASSENT	PROLETARISERONT
PREINSCRIRAIENT	PRESIDENTIALISA	PRIVILEGIASSIEZ	PROLIFERASSIONS
PREINSCRIVAIENT	PRESIDENTIALISE	PRIVILEGIERIONS	PROLIFERERAIENT
PREINSCRIVIRENT	PRESIDENTIELLES	PROBATIONNAIRES	PROLONGEASSIONS
PREINSCRIVISSES	PRESONORISAIENT	PROBLEMATISAMES	PROMOTIONNAIENT
PREINSTALLAIENT*	PRESONORISASSES	PROBLEMATISASSE	PROMOTIONNAIRES
PREINSTALLASSES*	PRESONORISATION	PROBLEMATISATES	PROMOTIONNASSES
PREINSTALLATION*	PRESONORISERAIS	PROBLEMATISERAI	PROMOTIONNELLES
PREINSTALLERAIS*	PRESONORISERAIT	PROBLEMATISERAS	PROMOTIONNERAIS
PREINSTALLERAIT*	PRESONORISERENT	PROBLEMATISEREZ	PROMOTIONNERAIT
PREINSTALLERENT*	PRESONORISERIEZ	PROBLEMATISIONS	PROMOTIONNERENT
PREINSTALLERIEZ*	PRESONORISERONS	PROCESSIONNAIRE	PROMOTIONNERIEZ
PREINSTALLERONS*	PRESONORISERONT	PROCESSIONNAMES	PROMOTIONNERONS
PREINSTALLERONT*	PRESSENTIRAIENT	PROCESSIONNASSE	PROMOTIONNERONT
PREJUDICIASSENT	PRESSENTISSIONS	PROCESSIONNATES	PROMULGUASSIONS
PREJUDICIASSIEZ	PRESSURISASSENT	PROCESSIONNELLE	PROMULGUERAIENT
PREJUDICIERIONS	PRESSURISASSIEZ	PROCESSIONNERAI	PRONOMINALEMENT
PREMEDIQUASSENT	PRESSURISATIONS	PROCESSIONNERAS	PRONOSTIQUAIENT
PREMEDIQUASSIEZ	PRESSURISERIONS	PROCESSIONNEREZ	PRONOSTIQUASSES
PREMEDIQUERIONS	PRESTRATEGIQUES	PROCESSIONNIONS	PRONOSTIQUERAIS
PREMEDITASSIONS	PRESUPPOSASSENT	PROCRASTINAIENT	PRONOSTIQUERAIT
PREMEDITERAIENT	PRESUPPOSASSIEZ	PROCRASTINASSES	PRONOSTIQUERENT
PREMENSTRUELLES	PRESUPPOSERIONS	PROCRASTINATEUR	PRONOSTIQUERIEZ
PREOCCUPASSIONS	PRESUPPOSITIONS	PROCRASTINATION	PRONOSTIQUERONS
PREOCCUPERAIENT	PRETENSIONNEURS	PROCRASTINERAIS	PRONOSTIQUERONT
PREPENSIONNAMES	PRETERITASSIONS	PROCRASTINERAIT	PRONOSTIQUEUSES
PREPENSIONNASSE	PRETERITERAIENT	PROCRASTINERENT	PRONUNCIAMIENTO
PREPENSIONNATES	PREVARICATRICES	PROCRASTINERIEZ	PROPHARMACIENNE
PREPENSIONNERAI	PREVARIQUASSENT	PROCRASTINERONS	PROPHETIQUEMENT
PREPENSIONNERAS	PREVARIQUASSIEZ	PROCRASTINERONT	PROPHETISASSENT
PREPENSIONNEREZ	PREVARIQUERIONS	PRODIGIEUSEMENT	PROPHETISASSIEZ
PREPENSIONNIONS	PREVISIONNELLES	PRODUCTIBILITES	PROPHETISERIONS
PREPOSITIONNELS	PREVISIONNISTES	PROFESSIONNELLE	PROPHYLACTIQUES
PREPOSITIVEMENT	PREVISUALISAMES*	PROGRAMMASSIONS	PROPORTIONNAMES
PREPSYCHOTIQUES	PREVISUALISASSE*	PROGRAMMATHEQUE	PROPORTIONNASSE
PREPUBLIASSIONS	PREVISUALISATES*	PROGRAMMATIQUES	PROPORTIONNATES
PREPUBLICATIONS	PREVISUALISERAI*	PROGRAMMATRICES	PROPORTIONNELLE
PREPUBLIERAIENT	PREVISUALISERAS*	PROGRAMMERAIENT	PROPORTIONNERAI
PRERAPHAELISMES	PREVISUALISEREZ*	PROGRESSASSIONS	PROPORTIONNERAS
PRESBYOPHRENIES	PREVISUALISIONS*	PROGRESSERAIENT	PROPORTIONNEREZ
PRESBYTERIENNES	PRIMOACCEDANTES	PROGRESSIVEMENT	PROPORTIONNIONS


Mots de 15 lettres de PROPOSITIONNELS à RADIOASTRONOMIE - Page 46/61

PROPOSITIONNELS	PSYCHANALYSATES	PYROELECTRIQUES	QUITTANCASSIONS
PROPRIOCEPTEURS	PSYCHANALYSERAI	PYROGRAVASSIONS	QUITTANCERAIENT
PROPRIOCEPTIONS	PSYCHANALYSERAS	PYROGRAVERAIENT	QUOTIDIENNEMENT
PROPRIOCEPTIVES	PSYCHANALYSEREZ	PYROSULFURIQUES	RABDOMANCIENNES*
PRORATISASSIONS*	PSYCHANALYSIONS	PYROTECHNICIENS	RABIBOCHASSIONS
PRORATISERAIENT*	PSYCHANALYTIQUE	PYTHAGORICIENNE	RABIBOCHERAIENT
PROSCRIVISSIONS	PSYCHASTHENIQUE	QUADRAGESIMALES	RABOUDINASSIONS
PROSPECTASSIONS	PSYCHIATRISAMES	QUADRANGULAIRES	RABOUDINERAIENT
PROSPECTERAIENT	PSYCHIATRISASSE	QUADRILATERALES	RABOUGRISSAIENT
PROSPECTIVISTES	PSYCHIATRISATES	QUADRILLASSIONS	RABOUGRISSEMENT
PROSTAGLANDINES	PSYCHIATRISERAI	QUADRILLERAIENT	RACCOMMODASSENT
PROSTATECTOMIES	PSYCHIATRISERAS	QUADRIMESTRIELS	RACCOMMODASSIEZ
PROSTERNASSIONS	PSYCHIATRISEREZ	QUADRIPHONIQUES	RACCOMMODEMENTS
PROSTERNERAIENT	PSYCHIATRISIONS	QUADRIPLEGIQUES	RACCOMMODERIONS
PROSTITUASSIONS	PSYCHOAFFECTIFS	QUADRIREACTEURS	RACCOMPAGNAIENT
PROSTITUERAIENT	PSYCHOAFFECTIVE	QUADRUPLASSIONS	RACCOMPAGNASSES
PROSTITUTIONNEL	PSYCHOBIOLOGIES	QUADRUPLERAIENT	RACCOMPAGNATEUR
PROTECTIONNISME	PSYCHOCHIRURGIE	QUALITATIVEMENT	RACCOMPAGNEMENT
PROTECTIONNISTE	PSYCHOCRITIQUES	QUANTIFIASSIONS	RACCOMPAGNERAIS
PROTEINOGRAMMES	PSYCHODYNAMIQUE	QUANTIFICATEURS	RACCOMPAGNERAIT
PROTEOSYNTHESES	PSYCHOGENETIQUE	QUANTIFICATIONS	RACCOMPAGNERENT
PROTESTANTISMES	PSYCHOKINETIQUE	QUANTIFIERAIENT	RACCOMPAGNERIEZ
PROTOCOLASSIONS	PSYCHOLEPTIQUES	QUARDERONNAIENT	RACCOMPAGNERONS
PROTOCOLERAIENT	PSYCHOLINGUISTE	QUARDERONNASSES	RACCOMPAGNERONT
PROTOHISTORIENS	PSYCHOLOGISANTE	QUARDERONNERAIS	RACCOURCIRAIENT
PROTOHISTORIQUE	PSYCHOLOGISANTS	QUARDERONNERAIT	RACCOURCISSEURS
PROTOPLANETAIRE	PSYCHOMETRICIEN	QUARDERONNERENT	RACCOURCISSEUSE
PROTOPLASMIQUES	PSYCHOMETRIQUES	QUARDERONNERIEZ	RACCOURCISSIONS
PROTOTYPASSIONS	PSYCHOMOTRICIEN	QUARDERONNERONS	RACCOUTUMASSENT
PROTOTYPERAIENT	PSYCHOMOTRICITE	QUARDERONNERONT	RACCOUTUMASSIEZ
PROTUBERANTIELS	PSYCHOPATHIQUES	QUARTAGEASSIONS	RACCOUTUMERIONS
PROVERBIALEMENT	PSYCHOPEDAGOGIE	QUATORZIEMEMENT	RACCROCHASSIONS
PROVIDENTIELLES	PSYCHOPEDAGOGUE	QUATTROCENTISTE	RACCROCHERAIENT
PROVINCIALISMES	PSYCHOPHYSIQUES	QUEBECISASSIONS	RACHIANALGESIES
PROVISIONNAIENT	PSYCHORIGIDITES	QUEBECISERAIENT	RACHIANESTHESIE
PROVISIONNASSES	PSYCHOSENSORIEL	QUESTIONNASSENT	RACORNISSEMENTS
PROVISIONNELLES	PSYCHOSOMATIQUE	QUESTIONNASSIEZ	RACRAPOTASSIONS
PROVISIONNERAIS	PSYCHOSTIMULANT	QUESTIONNEMENTS	RACRAPOTERAIENT
PROVISIONNERAIT	PSYCHOTECHNIQUE	QUESTIONNERIONS	RADARASTRONOMIE
PROVISIONNERENT	PSYCHOTHERAPIES	QUINQUAGENAIRES	RADICALISASSENT
PROVISIONNERIEZ	PSYCHROMETRIQUE	QUINTESSENCIAIS	RADICALISASSIEZ
PROVISIONNERONS	PTERIDOSPERMALE	QUINTESSENCIAIT	RADICALISATIONS
PROVISIONNERONT	PTERIDOSPERMEES	QUINTESSENCIANT	RADICALISERIONS
PSALMODIASSIONS	PTERYGOIDIENNES	QUINTESSENCIEES	RADIESTHESIQUES
PSALMODIERAIENT	PUBLIREPORTAGES	QUINTESSENCIENT	RADIESTHESISTES
PSEUDOBULBAIRES	PULVERISASSIONS	QUINTESSENCIERA	RADIOACTIVATION
PSEUDOMEMBRANES	PULVERISERAIENT	QUINTESSENCIIEZ	RADIOALIGNEMENT
PSEUDOSCORPIONS*	PUTRESCIBILITES	QUINTESSENCIONS	RADIOALTIMETRES
PSYCHANALYSAMES	PYRETOTHERAPIES	QUINTUPLASSIONS	RADIOASTRONOMES
PSYCHANALYSASSE	PYROELECTRICITE	QUINTUPLERAIENT	RADIOASTRONOMIE


Mots de 15 lettres de RADIOBALISAIENT à REAPPROPRIAIENT - Page 47/61

RADIOBALISAIENT	RADIOREPORTEURS	RAPPAREILLASSES	RAUGMENTASSIONS
RADIOBALISASSES	RADIOREPORTRICE	RAPPAREILLERAIS	RAUGMENTERAIENT
RADIOBALISERAIS	RADIORESISTANCE	RAPPAREILLERAIT	RAVITAILLASSENT
RADIOBALISERAIT	RADIOTECHNIQUES	RAPPAREILLERENT	RAVITAILLASSIEZ
RADIOBALISERENT	RADIOTELEGRAMME	RAPPAREILLERIEZ	RAVITAILLEMENTS
RADIOBALISERIEZ	RADIOTELEPHONES	RAPPAREILLERONS	RAVITAILLERIONS
RADIOBALISERONS	RADIOTELEPHONIE	RAPPAREILLERONT	REABSORBASSIONS
RADIOBALISERONT	RADIOTELESCOPES	RAPPLIQUASSIONS	REABSORBERAIENT
RADIOBIOLOGIQUE	RADIOTELEVISEES	RAPPLIQUERAIENT	REACCLIMATAIENT
RADIOCHIRURGIES	RADIOTELEVISION	RAPPOINTIRAIENT	REACCLIMATASSES
RADIOCOMMANDAIS	RADIOTHERAPEUTE	RAPPOINTISSIONS	REACCLIMATERAIS
RADIOCOMMANDAIT	RADIOTHERAPIQUE	RAPPROCHASSIONS	REACCLIMATERAIT
RADIOCOMMANDANT	RADIUMTHERAPIES	RAPPROCHERAIENT	REACCLIMATERENT
RADIOCOMMANDEES	RADOUCISSEMENTS	RAPPROPRIASSENT	REACCLIMATERIEZ
RADIOCOMMANDENT	RAFFERMISSAIENT	RAPPROPRIASSIEZ	REACCLIMATERONS
RADIOCOMMANDERA	RAFFERMISSANTES	RAPPROPRIERIONS	REACCLIMATERONT
RADIOCOMMANDIEZ	RAFFERMISSEMENT	RAPPROVISIONNAI	REACCOUTUMAIENT
RADIOCOMMANDONS	RAFISTOLASSIONS	RAPPROVISIONNAS	REACCOUTUMANCES
RADIOCONDUCTEUR	RAFISTOLERAIENT	RAPPROVISIONNAT	REACCOUTUMASSES
RADIODETECTIONS	RAFRAICHIRAIENT	RAPPROVISIONNEE	REACCOUTUMERAIS
RADIODIAGNOSTIC	RAFRAICHISSANTE	RAPPROVISIONNER	REACCOUTUMERAIT
RADIODIFFUSAMES	RAFRAICHISSANTS	RAPPROVISIONNES	REACCOUTUMERENT
RADIODIFFUSASSE	RAFRAICHISSEURS	RAPPROVISIONNEZ	REACCOUTUMERIEZ
RADIODIFFUSATES	RAFRAICHISSIONS	RASSEMBLASSIONS	REACCOUTUMERONS
RADIODIFFUSERAI	RAFRAICHISSOIRS	RASSEMBLERAIENT	REACCOUTUMERONT
RADIODIFFUSERAS	RAGAILLARDIRAIS	RASSERENASSIONS	REACTUALISAIENT
RADIODIFFUSEREZ	RAGAILLARDIRAIT	RASSERENERAIENT	REACTUALISASSES
RADIODIFFUSEURS	RAGAILLARDIRENT	RASSORTISSAIENT	REACTUALISATION
RADIODIFFUSIONS	RAGAILLARDIRIEZ	RATATOUILLAIENT	REACTUALISERAIS
RADIOELECTRIQUE	RAGAILLARDIRONS	RATATOUILLASSES	REACTUALISERAIT
RADIOFREQUENCES	RAGAILLARDIRONT	RATATOUILLERAIS	REACTUALISERENT
RADIOGONIOMETRE	RAGAILLARDISSES	RATATOUILLERAIT	REACTUALISERIEZ
RADIOGRAPHIAMES	RAGAILLARDISSEZ	RATATOUILLERENT	REACTUALISERONS
RADIOGRAPHIASSE	RAGRANDISSAIENT*	RATATOUILLERIEZ	REACTUALISERONT
RADIOGRAPHIATES	RAISONNABLEMENT	RATATOUILLERONS	REAFFECTASSIONS
RADIOGRAPHIERAI	RAJEUNISSEMENTS	RATATOUILLERONT	REAFFECTERAIENT
RADIOGRAPHIERAS	RALENTISSEMENTS	RATIBOISASSIONS	REAFFILIASSIONS
RADIOGRAPHIEREZ	RALLONGEASSIONS	RATIBOISERAIENT	REAFFILIERAIENT
RADIOGRAPHIIONS	RAMOLLISSEMENTS	RATIOCINASSIONS	REAFFIRMASSIONS
RADIOGRAPHIQUES	RANDOMISASSIONS	RATIOCINERAIENT	REAFFIRMERAIENT
RADIOGUIDASSENT	RANDOMISERAIENT	RATIONALISAIENT	REALIMENTASSENT
RADIOGUIDASSIEZ	RAPATRONNASSENT	RATIONALISASSES	REALIMENTASSIEZ
RADIOGUIDERIONS	RAPATRONNASSIEZ	RATIONALISATION	REALIMENTERIONS
RADIOMESSAGERIE	RAPATRONNERIONS	RATIONALISERAIS	REAMENAGEASSENT
RADIONAVIGANTES	RAPETASSASSIONS	RATIONALISERAIT	REAMENAGEASSIEZ
RADIONAVIGATION	RAPETASSERAIENT	RATIONALISERENT	REAMENAGERAIENT
RADIOPATHOLOGIE	RAPETISSASSIONS	RATIONALISERIEZ	REAPPARAISSIONS
RADIOPROTECTION	RAPETISSERAIENT	RATIONALISERONS	REAPPARAITRIONS
RADIORECEPTEURS	RAPOINTISSAIENT	RATIONALISERONT	REAPPRENDRAIENT
RADIOREPORTAGES	RAPPAREILLAIENT	RATIONNELLEMENT	REAPPROPRIAIENT


Mots de 15 lettres de REAPPROPRIASSES à RECONSTITUANTES - Page 48/61

REAPPROPRIASSES	RECALCULERAIENT	RECOMMANDASSENT	RECONDITIONNERA
REAPPROPRIATION	RECALIBRASSIONS	RECOMMANDASSIEZ	RECONDITIONNIEZ
REAPPROPRIERAIS	RECALIBRERAIENT	RECOMMANDATAIRE	RECONDITIONNONS
REAPPROPRIERAIT	RECAPITALISAMES	RECOMMANDATIONS	RECONDUISISSENT
REAPPROPRIERENT	RECAPITALISASSE	RECOMMANDERIONS	RECONDUISISSIEZ
REAPPROPRIERIEZ	RECAPITALISATES	RECOMMENCASSENT	RECONFIGURAIENT
REAPPROPRIERONS	RECAPITALISERAI	RECOMMENCASSIEZ	RECONFIGURASSES
REAPPROPRIERONT	RECAPITALISERAS	RECOMMENCEMENTS	RECONFIGURATION
REAPPROVISIONNA	RECAPITALISEREZ	RECOMMENCERIONS	RECONFIGURERAIS
REAPPROVISIONNE	RECAPITALISIONS	RECOMPARAISSAIS	RECONFIGURERAIT
REARGENTASSIONS	RECAPITULASSENT	RECOMPARAISSAIT	RECONFIGURERENT
REARGENTERAIENT	RECAPITULASSIEZ	RECOMPARAISSANT	RECONFIGURERIEZ
REARRANGEASSENT	RECAPITULATIONS	RECOMPARAISSENT	RECONFIGURERONS
REARRANGEASSIEZ	RECAPITULATIVES	RECOMPARAISSIEZ	RECONFIGURERONT
REARRANGERAIENT	RECAPITULERIONS	RECOMPARAISSONS	RECONFIRMASSENT
REASSIGNASSIONS	RECARRELASSIONS	RECOMPARAITRAIS	RECONFIRMASSIEZ
REASSIGNERAIENT	RECARRELERAIENT*	RECOMPARAITRAIT	RECONFIRMERIONS
REASSORTIRAIENT	RECARRELLERIONS	RECOMPARAITRIEZ	RECONFORTASSENT
REASSORTISSIONS	RECEPTIONNAIENT	RECOMPARAITRONS	RECONFORTASSIEZ
REATTRIBUASSENT	RECEPTIONNAIRES	RECOMPARAITRONT	RECONFORTERIONS
REATTRIBUASSIEZ	RECEPTIONNASSES	RECOMPARUSSIONS	RECONGELASSIONS
REATTRIBUERIONS	RECEPTIONNERAIS	RECOMPENSASSENT	RECONGELERAIENT
REBAPTISASSIONS	RECEPTIONNERAIT	RECOMPENSASSIEZ	RECONNAISSABLES
REBAPTISERAIENT	RECEPTIONNERENT	RECOMPENSERIONS	RECONNAISSAIENT
REBLANCHIRAIENT	RECEPTIONNERIEZ	RECOMPILASSIONS	RECONNAISSANCES
REBLANCHISSIONS	RECEPTIONNERONS	RECOMPILERAIENT	RECONNAISSANTES
REBONDISSEMENTS	RECEPTIONNERONT	RECOMPOSASSIONS	RECONNAITRAIENT
REBOUTONNASSENT	RECEPTIONNISTES	RECOMPOSERAIENT	RECONNECTASSENT
REBOUTONNASSIEZ	RECHAMPISSAIENT	RECONCENTRAIENT	RECONNECTASSIEZ
REBOUTONNERIONS	RECHANGEASSIONS	RECONCENTRASSES	RECONNECTERIONS
REBRAGUETTAIENT	RECHARGEASSIONS	RECONCENTRERAIS	RECONQUERRAIENT
REBRAGUETTASSES	RECHAUFFASSIONS	RECONCENTRERAIT	RECONSIDERAIENT
REBRAGUETTERAIS	RECHAUFFERAIENT	RECONCENTRERENT	RECONSIDERASSES
REBRAGUETTERAIT	RECHAUSSASSIONS	RECONCENTRERIEZ	RECONSIDERATION
REBRAGUETTERENT	RECHAUSSERAIENT	RECONCENTRERONS	RECONSIDERERAIS
REBRAGUETTERIEZ	RECHERCHASSIONS	RECONCENTRERONT	RECONSIDERERAIT
REBRAGUETTERONS	RECHERCHERAIENT	RECONCILIASSENT	RECONSIDERERENT
REBRAGUETTERONT	RECHRISTIANISAI	RECONCILIASSIEZ	RECONSIDERERIEZ
REBRANCHASSIONS	RECHRISTIANISAS	RECONCILIATEURS	RECONSIDERERONS
REBRANCHERAIENT	RECHRISTIANISAT	RECONCILIATIONS	RECONSIDERERONT
REBROUSSASSIONS	RECHRISTIANISEE	RECONCILIATRICE	RECONSOLIDAIENT
REBROUSSERAIENT	RECHRISTIANISER	RECONCILIERIONS	RECONSOLIDASSES
RECACHETASSIONS	RECHRISTIANISES	RECONDAMNASSENT	RECONSOLIDERAIS
RECACHETERAIENT*	RECHRISTIANISEZ	RECONDAMNASSIEZ	RECONSOLIDERAIT
RECACHETTERIONS	RECIPROQUASSENT	RECONDAMNERIONS	RECONSOLIDERENT
RECALCIFIASSENT	RECIPROQUASSIEZ	RECONDITIONNAIS	RECONSOLIDERIEZ
RECALCIFIASSIEZ	RECIPROQUERIONS	RECONDITIONNAIT	RECONSOLIDERONS
RECALCIFICATION	RECLUSIONNAIRES	RECONDITIONNANT	RECONSOLIDERONT
RECALCIFIERIONS	RECOMBINASSIONS	RECONDITIONNEES	RECONSTITUAIENT
RECALCULASSIONS	RECOMBINERAIENT	RECONDITIONNENT	RECONSTITUANTES


Mots de 15 lettres de RECONSTITUASSES à REFECTIONNERONS - Page 49/61

RECONSTITUASSES	RECRISTALLISONS	REDISCUTERAIENT	REENREGISTRERAI
RECONSTITUERAIS	RECROQUEVILLAIS	REDISTRIBUAIENT	REENREGISTRERAS
RECONSTITUERAIT	RECROQUEVILLAIT	REDISTRIBUASSES	REENREGISTREREZ
RECONSTITUERENT	RECROQUEVILLANT	REDISTRIBUERAIS	REENREGISTRIONS
RECONSTITUERIEZ	RECROQUEVILLEES	REDISTRIBUERAIT	REENSEMENCAIENT
RECONSTITUERONS	RECROQUEVILLENT	REDISTRIBUERENT	REENSEMENCASSES
RECONSTITUERONT	RECROQUEVILLERA	REDISTRIBUERIEZ	REENSEMENCEMENT
RECONSTITUTIONS	RECROQUEVILLIEZ	REDISTRIBUERONS	REENSEMENCERAIS
RECONSTRUCTEURS	RECROQUEVILLONS	REDISTRIBUERONT	REENSEMENCERAIT
RECONSTRUCTIONS	RECTIFICATRICES	REDISTRIBUTEURS	REENSEMENCERENT
RECONSTRUCTRICE	RECTOSIGMOIDIEN	REDISTRIBUTIONS	REENSEMENCERIEZ
RECONSTRUIRIONS	RECUEILLERAIENT	REDISTRIBUTIVES	REENSEMENCERONS
RECONSTRUISIMES	RECUEILLISSIONS	REDISTRIBUTRICE	REENSEMENCERONT
RECONSTRUISIONS	RECULOTTASSIONS	REDUCTIONNISMES	REENTENDISSIONS
RECONSTRUISISSE	RECULOTTERAIENT	REDUCTIONNISTES	REENVISAGEAIENT
RECONSTRUISITES	REDACTIONNELLES	REDYNAMISASSENT	REENVISAGEASSES
RECONTACTASSENT	REDECOLLASSIONS	REDYNAMISASSIEZ	REENVISAGERIONS
RECONTACTASSIEZ	REDECOLLERAIENT	REDYNAMISATIONS	REEQUILIBRAIENT
RECONTACTERIONS	REDECOUPASSIONS	REDYNAMISERIONS	REEQUILIBRASSES
RECONVENTIONNEL	REDECOUPERAIENT	REECHELONNAIENT	REEQUILIBRERAIS
RECONVERTIRIONS	REDECOUVRIRIONS	REECHELONNASSES	REEQUILIBRERAIT
RECONVERTISSAIS	REDECOUVRISSENT	REECHELONNEMENT	REEQUILIBRERENT
RECONVERTISSAIT	REDECOUVRISSIEZ	REECHELONNERAIS	REEQUILIBRERIEZ
RECONVERTISSANT	REDEFINISSAIENT	REECHELONNERAIT	REEQUILIBRERONS
RECONVERTISSENT	REDEMANDASSIONS	REECHELONNERENT	REEQUILIBRERONT
RECONVERTISSIEZ	REDEMANDERAIENT	REECHELONNERIEZ	REESCOMPTASSENT
RECONVERTISSONS	REDEMARRASSIONS	REECHELONNERONS	REESCOMPTASSIEZ
RECONVOQUASSENT	REDEMARRERAIENT	REECHELONNERONT	REESCOMPTERIONS
RECONVOQUASSIEZ	REDEMPTORISTINE	REEMBARQUASSENT	REEXAMINASSIONS
RECONVOQUERIONS	REDEPLOIERAIENT	REEMBARQUASSIEZ	REEXAMINERAIENT
RECOQUILLASSENT	REDEPLOYASSIONS	REEMBARQUERIONS	REEXECUTASSIONS
RECOQUILLASSIEZ	REDESCENDISSENT	REEMBAUCHASSENT	REEXECUTERAIENT
RECOQUILLERIONS	REDESCENDISSIEZ	REEMBAUCHASSIEZ	REEXPEDIASSIONS
RECORRIGEASSENT	REDESCENDRAIENT	REEMBAUCHERIONS	REEXPEDIERAIENT
RECORRIGEASSIEZ	REDESSINASSIONS	REEMMENAGEAIENT*	REEXPLIQUASSENT
RECORRIGERAIENT	REDESSINERAIENT	REEMMENAGEASSES*	REEXPLIQUASSIEZ
RECOUPONNASSENT	REDEVIENDRAIENT	REEMMENAGERIONS*	REEXPLIQUERIONS
RECOUPONNASSIEZ	REDIFFUSASSIONS	REEMPLOIERAIENT	REEXPORTASSIONS
RECOUPONNERIONS	REDIFFUSERAIENT	REEMPLOYASSIONS	REEXPORTERAIENT
RECRIMINASSIONS	REDIMENSIONNAIS	REEMPRUNTASSENT	REFACONNASSIONS
RECRIMINATOIRES	REDIMENSIONNAIT	REEMPRUNTASSIEZ	REFACONNERAIENT
RECRIMINATRICES	REDIMENSIONNANT	REEMPRUNTERIONS	REFACTURASSIONS
RECRIMINERAIENT	REDIMENSIONNEES	REENCHANTASSENT	REFACTURERAIENT
RECRISTALLISAIS	REDIMENSIONNENT	REENCHANTASSIEZ	REFECTIONNAIENT*
RECRISTALLISAIT	REDIMENSIONNERA	REENCHANTEMENTS	REFECTIONNASSES*
RECRISTALLISANT	REDIMENSIONNIEZ	REENCHANTERIONS	REFECTIONNERAIS*
RECRISTALLISEES	REDIMENSIONNONS	REENGAGEASSIONS	REFECTIONNERAIT*
RECRISTALLISENT	REDINTEGRATIONS	REENREGISTRAMES	REFECTIONNERENT*
RECRISTALLISERA	REDIRIGEASSIONS	REENREGISTRASSE	REFECTIONNERIEZ*
RECRISTALLISIEZ	REDISCUTASSIONS	REENREGISTRATES	REFECTIONNERONS*


Mots de 15 lettres de REFECTIONNERONT à REMOUILLASSIONS - Page 50/61

REFECTIONNERONT*	REGULARISATIONS	REINJECTASSIONS	REMARQUABLEMENT
REFERENCASSIONS	REGULARISERIONS	REINJECTERAIENT	REMASTERISAIENT
REFERENCERAIENT	REGURGITASSIONS	REINSCRIPTIBLES	REMASTERISASSES
REFERMENTASSENT	REGURGITERAIENT	REINSCRIVISSENT	REMASTERISATION
REFERMENTASSIEZ	REHABILITASSENT	REINSCRIVISSIEZ	REMASTERISERAIS
REFERMENTATIONS	REHABILITASSIEZ	REINSTALLASSENT	REMASTERISERAIT
REFERMENTERIONS	REHABILITATIONS	REINSTALLASSIEZ	REMASTERISERENT
REFINANCASSIONS	REHABILITERIONS	REINSTALLATIONS	REMASTERISERIEZ
REFINANCERAIENT	REHABITUASSIONS	REINSTALLERIONS	REMASTERISERONS
REFLECHISSAIENT	REHABITUERAIENT	REINSTAURASSENT	REMASTERISERONT
REFLECHISSANTES	REHYDRATASSIONS	REINSTAURASSIEZ	REMASTIQUASSENT
REFLEURISSAIENT	REHYDRATERAIENT	REINSTAURERIONS	REMASTIQUASSIEZ
REFLEURISSEMENT	REIMPLANTASSENT	REINTEGRASSIONS	REMASTIQUERIONS
REFLEXOTHERAPIE	REIMPLANTASSIEZ	REINTEGRERAIENT	REMBARQUASSIONS
REFORMATASSIONS	REIMPLANTATIONS	REINTERPRETAMES	REMBARQUERAIENT
REFORMATERAIENT	REIMPLANTERIONS	REINTERPRETASSE	REMBAUCHASSIONS
REFORMULASSIONS	REIMPORTASSIONS	REINTERPRETATES	REMBAUCHERAIENT
REFORMULERAIENT	REIMPORTERAIENT	REINTERPRETERAI	REMBOBINASSIONS
REFOUILLASSIONS	REIMPRIMASSIONS	REINTERPRETERAS	REMBOBINERAIENT
REFOUILLERAIENT	REIMPRIMERAIENT	REINTERPRETEREZ	REMBOUGEASSIONS
REFOURGUASSIONS	REINCARCERAIENT	REINTERPRETIONS	REMBOURRASSIONS
REFOURGUERAIENT	REINCARCERASSES	REINTRODUCTIONS	REMBOURRERAIENT
REFRACTIONNISTE	REINCARCERATION	REINTRODUIRIONS	REMBOURSASSIONS
REFRACTOMETRIES	REINCARCERERAIS	REINTRODUISIMES	REMBOURSERAIENT
REFRANGIBILITES	REINCARCERERAIT	REINTRODUISIONS	REMBRUNISSAIENT
REFRIGERASSIONS	REINCARCERERENT	REINTRODUISISSE	REMBRUNISSEMENT
REFRIGERERAIENT	REINCARCERERIEZ	REINTRODUISITES	REMILITARISAMES
REFROIDISSAIENT	REINCARCERERONS	REINVENTASSIONS	REMILITARISASSE
REFROIDISSEMENT	REINCARCERERONT	REINVENTERAIENT	REMILITARISATES
REGAZONNASSIONS	REINCARNASSIONS	REINVESTIRAIENT	REMILITARISERAI
REGAZONNERAIENT	REINCARNERAIENT	REINVESTISSIONS	REMILITARISERAS
REGIONALISAIENT	REINCORPORAIENT	REJAILLISSAIENT	REMILITARISEREZ
REGIONALISASSES	REINCORPORASSES	REJAILLISSEMENT	REMILITARISIONS
REGIONALISATION	REINCORPORERAIS	REJOINTOIEMENTS	REMMAILLASSIONS
REGIONALISERAIS	REINCORPORERAIT	REJOINTOIERIONS	REMMAILLERAIENT
REGIONALISERAIT	REINCORPORERENT	REJOINTOYASSENT	REMMAILLOTAIENT
REGIONALISERENT	REINCORPORERIEZ	REJOINTOYASSIEZ	REMMAILLOTASSES
REGIONALISERIEZ	REINCORPORERONS	RELATIVISASSENT	REMMAILLOTERAIS
REGIONALISERONS	REINCORPORERONT	RELATIVISASSIEZ	REMMAILLOTERAIT
REGIONALISERONT	REINDUSTRIALISA	RELATIVISATIONS	REMMAILLOTERENT
REGLEMENTARISME	REINDUSTRIALISE	RELATIVISERIONS	REMMAILLOTERIEZ
REGLEMENTARISTE	REINFECTASSIONS	RELOCALISASSENT	REMMAILLOTERONS
REGLEMENTASSENT	REINFECTERAIENT	RELOCALISASSIEZ	REMMAILLOTERONT
REGLEMENTASSIEZ	REINITIALISAMES	RELOCALISATIONS	REMMANCHASSIONS
REGLEMENTATIONS	REINITIALISASSE	RELOCALISERIONS	REMMANCHERAIENT
REGLEMENTERIONS	REINITIALISATES	RELOQUETASSIONS	REMOBILISASSENT
REGRETTABLEMENT	REINITIALISERAI	RELOQUETERAIENT	REMOBILISASSIEZ
REGROSSISSAIENT	REINITIALISERAS	REMAQUILLASSENT	REMOBILISATIONS
REGULARISASSENT	REINITIALISEREZ	REMAQUILLASSIEZ	REMOBILISERIONS
REGULARISASSIEZ	REINITIALISIONS	REMAQUILLERIONS	REMOUILLASSIONS


Mots de 15 lettres de REMOUILLERAIENT à RESSEMELERAIENT - Page 51/61

REMOUILLERAIENT	RENSEIGNASSIONS	REPOSITIONNERAS	REQUINQUASSIONS
REMPAILLASSIONS	RENSEIGNERAIENT	REPOSITIONNEREZ	REQUINQUERAIENT
REMPAILLERAIENT	RENTABILISABLES	REPOSITIONNIONS	REQUISITIONNAIS
REMPAQUETASSENT	RENTABILISAIENT	REPOURVOIRAIENT	REQUISITIONNAIT
REMPAQUETASSIEZ	RENTABILISASSES	REPRECISASSIONS	REQUISITIONNANT
REMPAQUETERIONS*	RENTABILISATION	REPRECISERAIENT	REQUISITIONNEES
REMPAQUETTERAIS	RENTABILISERAIS	REPRESENTASSENT	REQUISITIONNENT
REMPAQUETTERAIT	RENTABILISERAIT	REPRESENTASSIEZ	REQUISITIONNERA
REMPAQUETTERIEZ	RENTABILISERENT	REPRESENTATIONS	REQUISITIONNIEZ
REMPAQUETTERONS	RENTABILISERIEZ	REPRESENTATIVES	REQUISITIONNONS
REMPAQUETTERONT	RENTABILISERONS	REPRESENTERIONS	REQUISITORIALES
REMPOISSONNAMES	RENTABILISERONT	REPRIMANDASSENT	RESOCIALISAIENT
REMPOISSONNASSE	RENUMEROTASSENT	REPRIMANDASSIEZ	RESOCIALISASSES
REMPOISSONNATES	RENUMEROTASSIEZ	REPRIMANDERIONS	RESOCIALISATION
REMPOISSONNERAI	RENUMEROTERIONS	REPRODUISISSENT	RESOCIALISERAIS
REMPOISSONNERAS	REORCHESTRAIENT	REPRODUISISSIEZ	RESOCIALISERAIT
REMPOISSONNEREZ	REORCHESTRASSES	REPROFILASSIONS	RESOCIALISERENT
REMPOISSONNIONS	REORCHESTRATION	REPROFILERAIENT	RESOCIALISERIEZ
REMPRUNTASSIONS	REORCHESTRERAIS	REPROGRAMMAIENT	RESOCIALISERONS
REMPRUNTERAIENT	REORCHESTRERAIT	REPROGRAMMASSES	RESOCIALISERONT
RENCAISSASSIONS	REORCHESTRERENT	REPROGRAMMATION	RESPECTABILISAI
RENCAISSERAIENT	REORCHESTRERIEZ	REPROGRAMMERAIS	RESPECTABILISAS
RENCHAINASSIONS	REORCHESTRERONS	REPROGRAMMERAIT	RESPECTABILISAT
RENCHAINERAIENT	REORCHESTRERONT	REPROGRAMMERENT	RESPECTABILISEE
RENCHAUSSASSENT	REORDONNASSIONS	REPROGRAMMERIEZ	RESPECTABILISER
RENCHAUSSASSIEZ	REORDONNERAIENT	REPROGRAMMERONS	RESPECTABILISES
RENCHAUSSERIONS	REORGANISASSENT	REPROGRAMMERONT	RESPECTABILISEZ
RENCHERISSAIENT	REORGANISASSIEZ	REPROGRAPHIAMES	RESPECTABILITES
RENCHERISSEMENT	REORGANISATEURS	REPROGRAPHIASSE	RESPLENDIRAIENT
RENCHERISSEUSES	REORGANISATIONS	REPROGRAPHIATES	RESPLENDISSANTE
RENCONTRASSIONS	REORGANISATRICE	REPROGRAPHIERAI	RESPLENDISSANTS
RENCONTRERAIENT	REORGANISERIONS	REPROGRAPHIERAS	RESPLENDISSIONS
RENEGOCIASSIONS	REORIENTASSIONS	REPROGRAPHIEREZ	RESPONSABILISAI
RENEGOCIERAIENT	REORIENTERAIENT	REPROGRAPHIIONS	RESPONSABILISAS
RENFLAMMASSIONS	REOXYGENASSIONS	REPROGRAPHIQUES	RESPONSABILISAT
RENFLAMMERAIENT	REOXYGENERAIENT	REPROPOSASSIONS*	RESPONSABILISEE
RENFORCISSAIENT	REPARTAGEASSENT	REPROPOSERAIENT*	RESPONSABILISER
RENFORMISSAIENT	REPARTAGEASSIEZ	REPUBLICANISAIS	RESPONSABILISES
RENFROGNASSIONS	REPARTAGERAIENT	REPUBLICANISAIT	RESPONSABILISEZ
RENFROGNERAIENT	REPERCUTASSIONS	REPUBLICANISANT	RESPONSABILITES
RENGORGEASSIONS	REPERCUTERAIENT	REPUBLICANISEES	RESQUILLASSIONS
RENGRAISSASSENT	REPERTORIASSENT	REPUBLICANISENT	RESQUILLERAIENT
RENGRAISSASSIEZ	REPERTORIASSIEZ	REPUBLICANISERA	RESSAIGNASSIONS
RENGRAISSERIONS	REPERTORIERIONS	REPUBLICANISIEZ	RESSAIGNERAIENT
RENOUVELASSIONS	REPLONGEASSIONS	REPUBLICANISMES	RESSAISISSAIENT
RENOUVELERAIENT*	REPOSITIONNABLE	REPUBLICANISONS	RESSAISISSEMENT
RENOUVELLEMENTS	REPOSITIONNAMES	REQUALIFIASSENT	RESSEMBLASSIONS
RENOUVELLERIONS	REPOSITIONNASSE	REQUALIFIASSIEZ	RESSEMBLERAIENT
RENQUILLASSIONS	REPOSITIONNATES	REQUALIFICATION	RESSEMELASSIONS
RENQUILLERAIENT	REPOSITIONNERAI	REQUALIFIERIONS	RESSEMELERAIENT*


Mots de 15 lettres de RESSEMELLERIONS à RONEOTYPASSIONS - Page 52/61

RESSEMELLERIONS	RETRACTABILITES	RETROPEDALERAIS	REVITALISERIONS
RESSORTISSAIENT	RETRACTIBILITES	RETROPEDALERAIT	REVIVIFIASSIONS
RESSORTISSANTES	RETRADUISISSENT	RETROPEDALERENT	REVIVIFICATIONS
RESSOURCASSIONS	RETRADUISISSIEZ	RETROPEDALERIEZ	REVIVIFIERAIENT
RESSOURCERAIENT	RETRANCHASSIONS	RETROPEDALERONS	REVOLUTIONNAIRE
RESSOUVIENDRAIS	RETRANCHERAIENT	RETROPEDALERONT	REVOLUTIONNAMES
RESSOUVIENDRAIT	RETRANSCRIPTION	RETROPROJECTEUR	REVOLUTIONNASSE
RESSOUVIENDRIEZ	RETRANSCRIRIONS	RETROPROJECTION	REVOLUTIONNATES
RESSOUVIENDRONS	RETRANSCRIVIMES	RETROPROPULSION	REVOLUTIONNERAI
RESSOUVIENDRONT	RETRANSCRIVIONS	RETROTRANSPOSON*	REVOLUTIONNERAS
RESSOUVINSSIONS	RETRANSCRIVISSE	RETROUSSASSIONS	REVOLUTIONNEREZ
RESSURGISSAIENT	RETRANSCRIVITES	RETROUSSERAIENT	REVOLUTIONNIONS
RESSUSCITASSENT	RETRANSMETTEURS	REUTILISASSIONS	REVOLVERISAIENT
RESSUSCITASSIEZ	RETRANSMETTIONS	REUTILISERAIENT	REVOLVERISASSES
RESSUSCITERIONS	RETRANSMETTRAIS	REVACCINASSIONS	REVOLVERISERAIS
RESTREIGNISSENT	RETRANSMETTRAIT	REVACCINERAIENT	REVOLVERISERAIT
RESTREIGNISSIEZ	RETRANSMETTRIEZ	REVALORISASSENT	REVOLVERISERENT
RESTREINDRAIENT	RETRANSMETTRONS	REVALORISASSIEZ	REVOLVERISERIEZ
RESTRUCTURAIENT	RETRANSMETTRONT	REVALORISATIONS	REVOLVERISERONS
RESTRUCTURASSES	RETRANSMISSIONS	REVALORISERIONS	REVOLVERISERONT
RESTRUCTURATION	RETRAVAILLAIENT	REVASCULARISAIS	RHABDOMANCIENNE
RESTRUCTURERAIS	RETRAVAILLASSES	REVASCULARISAIT	RHINOLARYNGITES
RESTRUCTURERAIT	RETRAVAILLERAIS	REVASCULARISANT	RHINOPHARYNGEES
RESTRUCTURERENT	RETRAVAILLERAIT	REVASCULARISEES	RHINOPHARYNGIEN
RESTRUCTURERIEZ	RETRAVAILLERENT	REVASCULARISENT	RHINOPHARYNGITE
RESTRUCTURERONS	RETRAVAILLERIEZ	REVASCULARISERA	RHOMBENCEPHALES
RESTRUCTURERONT	RETRAVAILLERONS	REVASCULARISIEZ	RHUMATOLOGIQUES
RESURCHAUFFAMES	RETRAVAILLERONT	REVASCULARISONS	RHUMATOLOGISTES
RESURCHAUFFASSE	RETRAVERSASSENT	REVEILLONNAIENT	RHYNCHOCEPHALES
RESURCHAUFFATES	RETRAVERSASSIEZ	REVEILLONNASSES	RIDICULISASSENT
RESURCHAUFFERAI	RETRAVERSERIONS	REVEILLONNERAIS	RIDICULISASSIEZ
RESURCHAUFFERAS	RETRECISSEMENTS	REVEILLONNERAIT	RIDICULISATIONS
RESURCHAUFFEREZ	RETREIGNISSIONS	REVEILLONNERENT	RIDICULISERIONS
RESURCHAUFFEURS	RETROACTIVATION	REVEILLONNERIEZ	RIGIDIFIASSIONS
RESURCHAUFFIONS	RETROACTIVEMENT	REVEILLONNERONS	RIGIDIFIERAIENT
RESURRECTIONNEL	RETROAGISSAIENT	REVEILLONNERONT	RINGARDISASSENT
RETABLISSEMENTS	RETROCEDASSIONS	REVEILLONNEUSES*	RINGARDISASSIEZ
RETAPISSASSIONS	RETROCEDERAIENT	REVENDICATRICES	RINGARDISATIONS
RETAPISSERAIENT	RETROCHARGEUSES	REVENDIQUASSENT	RINGARDISERIONS
RETELEPHONAIENT	RETROCOMMISSION	REVENDIQUASSIEZ	RISTOURNASSIONS
RETELEPHONASSES	RETROCROISEMENT	REVENDIQUERIONS	RISTOURNERAIENT
RETELEPHONERAIS	RETROECLAIRAGES	REVERBERASSIONS	RITUALISASSIONS
RETELEPHONERAIT	RETROFUTURISMES*	REVERBERERAIENT	RITUALISERAIENT
RETELEPHONERENT	RETROFUTURISTES*	REVERDISSEMENTS	ROBESPIERRISMES
RETELEPHONERIEZ	RETROGRADASSENT	REVERENDISSIMES	ROBESPIERRISTES
RETELEPHONERONS	RETROGRADASSIEZ	REVERIFIASSIONS	ROMANTISASSIONS
RETELEPHONERONT	RETROGRADATIONS	REVERIFIERAIENT	ROMANTISERAIENT
RETENTIONNAIRES	RETROGRADERIONS	REVITALISASSENT	RONCHONNASSIONS
RETENTISSEMENTS	RETROPEDALAIENT	REVITALISASSIEZ	RONCHONNERAIENT
RETICULOSARCOME	RETROPEDALASSES	REVITALISATIONS	RONEOTYPASSIONS


Mots de 15 lettres de RONEOTYPERAIENT à SENSIBILISAIENT - Page 53/61

RONEOTYPERAIENT	SANCTUARISASSES	SCHAERBEEKOISES	SECTORISASSIONS
RONSARDISASSENT	SANCTUARISATION	SCHAFFHOUSOISES	SECTORISERAIENT
RONSARDISASSIEZ	SANCTUARISERAIS	SCHELINGUASSENT	SECULARISASSENT
RONSARDISERIONS	SANCTUARISERAIT	SCHELINGUASSIEZ	SECULARISASSIEZ
RONTGENTHERAPIE	SANCTUARISERENT	SCHELINGUERIONS	SECULARISATIONS
ROUSCAILLASSENT	SANCTUARISERIEZ	SCHEMATIQUEMENT	SECULARISERIONS
ROUSCAILLASSIEZ	SANCTUARISERONS	SCHEMATISASSENT	SEDENTARISAIENT
ROUSCAILLERIONS	SANCTUARISERONT	SCHEMATISASSIEZ	SEDENTARISASSES
ROUSSELLERAIENT	SANDWICHASSIONS	SCHEMATISATIONS	SEDENTARISATION
ROUSSILLONNAISE	SANDWICHERAIENT	SCHEMATISERIONS	SEDENTARISERAIS
ROUYNORANDIENNE	SAPONIFIASSIONS	SCHISTOSOMIASES	SEDENTARISERAIT
RUISSELLERAIENT	SAPONIFICATIONS	SCHIZOMETAMERIE	SEDENTARISERENT
SACCARIFIASSENT*	SAPONIFIERAIENT	SCHIZOPHRENIQUE	SEDENTARISERIEZ
SACCARIFIASSIEZ*	SARCASTIQUEMENT	SCHIZOTHYMIQUES	SEDENTARISERONS
SACCARIFICATION*	SARCOPLASMIQUES	SCHLINGUASSIONS	SEDENTARISERONT
SACCARIFIERIONS*	SARDANAPALESQUE	SCHLINGUERAIENT	SEDIMENTASSIONS
SACCARIMETRIQUE*	SARREBRUCKOISES	SCHNEUQUASSIONS*	SEDIMENTERAIENT
SACCHARIFIABLES	SASKATCHEWANAIS	SCHNEUQUERAIENT*	SEDIMENTOLOGIES
SACCHARIFIAIENT	SATELLISASSIONS	SCINTIGRAPHIQUE	SEDIMENTOLOGUES
SACCHARIFIASSES	SATELLISERAIENT	SCINTILLASSIONS	SEISMOGRAPHIQUE
SACCHARIFIERAIS	SATISFIABILITES	SCINTILLERAIENT	SEISMOTHERAPIES
SACCHARIFIERAIT	SAUCISSONNAIENT	SCINTILLOGRAMME	SELECTIONNABLES
SACCHARIFIERENT	SAUCISSONNASSES	SCINTILLOMETRES	SELECTIONNAIENT
SACCHARIFIERIEZ	SAUCISSONNERAIS	SCISSIONNASSENT	SELECTIONNASSES
SACCHARIFIERONS	SAUCISSONNERAIT	SCISSIONNASSIEZ	SELECTIONNERAIS
SACCHARIFIERONT	SAUCISSONNERENT	SCISSIONNERIONS	SELECTIONNERAIT
SACCHARIMETRIES	SAUCISSONNERIEZ	SCLEROPROTEINES	SELECTIONNERENT
SACRALISASSIONS	SAUCISSONNERONS	SCLEROTHERAPIES	SELECTIONNERIEZ
SACRALISERAIENT	SAUCISSONNERONT	SCOLARISASSIONS	SELECTIONNERONS
SACRIFICATOIRES	SAUCISSONNEUSES	SCOLARISERAIENT	SELECTIONNERONT
SACRIFICATRICES	SAUPOUDRASSIONS	SCOTOMISASSIONS	SELECTIONNEUSES
SADOMASOCHISMES	SAUPOUDRERAIENT	SCOTOMISERAIENT	SELECTIONNISMES
SADOMASOCHISTES	SAUVEGARDASSENT	SCRIBOUILLAIENT	SELENOGRAPHIQUE
SALIDIURETIQUES	SAUVEGARDASSIEZ	SCRIBOUILLARDES	SEMASIOLOGIQUES
SALMONICULTEURS	SAUVEGARDERIONS	SCRIBOUILLASSES	SEMESTRIALISAIS
SALMONICULTRICE	SAUVETERRIENNES	SCRIBOUILLERAIS	SEMESTRIALISAIT
SALMONICULTURES	SCANDALEUSEMENT	SCRIBOUILLERAIT	SEMESTRIALISANT
SALPETRISATIONS	SCANDALISASSENT	SCRIBOUILLERENT	SEMESTRIALISEES
SALPINGECTOMIES	SCANDALISASSIEZ	SCRIBOUILLERIEZ	SEMESTRIALISENT
SALPINGOGRAPHIE	SCANDALISERIONS	SCRIBOUILLERONS	SEMESTRIALISERA
SALTATIONNISMES	SCANNERISASSENT	SCRIBOUILLERONT	SEMESTRIALISIEZ
SANCTIFIASSIONS	SCANNERISASSIEZ	SCRIBOUILLEUSES	SEMESTRIALISONS
SANCTIFICATEURS	SCANNERISATIONS	SCRIPOPHILIQUES	SENEGALISASSENT
SANCTIFICATIONS	SCANNERISERIONS	SCROFULARIACEES	SENEGALISASSIEZ
SANCTIFICATRICE	SCANOGRAPHIQUES	SCRUPULEUSEMENT	SENEGALISATIONS
SANCTIFIERAIENT	SCAPULOHUMERALE	SECESSIONNISMES	SENEGALISERIONS
SANCTIONNASSENT	SCAPULOHUMERAUX	SECESSIONNISTES	SENSATIONNELLES
SANCTIONNASSIEZ	SCENARISASSIONS	SECTIONNASSIONS	SENSATIONNISMES
SANCTIONNERIONS	SCENARISERAIENT	SECTIONNERAIENT	SENSATIONNISTES
SANCTUARISAIENT	SCENOGRAPHIQUES	SECTORIELLEMENT	SENSIBILISAIENT


Mots de 15 lettres de SENSIBILISANTES à SPIRITUALISEREZ - Page 54/61

SENSIBILISANTES	SHAWINIGANAISES	SOCIOEDUCATIVES	SOUMISSIONNAIRE
SENSIBILISASSES	SHERARDISATIONS	SOCIOHISTORIQUE	SOUMISSIONNAMES
SENSIBILISATEUR	SIDEROLITHIQUES	SOCIOLINGUISTES	SOUMISSIONNASSE
SENSIBILISATION	SIERRALEONAISES	SOCIOPOLITIQUES	SOUMISSIONNATES
SENSIBILISERAIS	SIGILLOGRAPHIES	SOCIOTECHNIQUES	SOUMISSIONNERAI
SENSIBILISERAIT	SIGNALISASSIONS	SOLENNISASSIONS	SOUMISSIONNERAS
SENSIBILISERENT	SIGNALISERAIENT	SOLENNISERAIENT	SOUMISSIONNEREZ
SENSIBILISERIEZ	SILENCIEUSEMENT	SOLIDARISASSENT	SOUMISSIONNIONS
SENSIBILISERONS	SILHOUETTASSENT	SOLIDARISASSIEZ	SOUPCONNASSIONS
SENSIBILISERONT	SILHOUETTASSIEZ	SOLIDARISATIONS	SOUPCONNERAIENT
SENSITOMETRIQUE	SILHOUETTERIONS	SOLIDARISERIONS	SOURCILLASSIONS
SENSORIMETRIQUE	SIMPLIFIASSIONS	SOLIDIFIASSIONS	SOURCILLERAIENT
SENSORIMOTRICES	SIMPLIFICATEURS	SOLIDIFICATIONS	SOUSCRIVISSIONS
SENTIMENTALISME	SIMPLIFICATIONS	SOLIDIFIERAIENT	SOUTERRAINEMENT
SENTIMENTALISTE	SIMPLIFICATRICE	SOLILOQUASSIONS	SOVIETISASSIONS
SENTIMENTALITES	SIMPLIFIERAIENT	SOLILOQUERAIENT	SOVIETISERAIENT
SEPTENTRIONALES	SINGAPOURIENNES	SOLLICITASSIONS	SPANIOMENORRHEE
SEPTICOPYOHEMIE	SINGULARISAIENT	SOLLICITERAIENT	SPASMOPHILIQUES
SEQUESTRASSIONS	SINGULARISASSES	SOLUBILISASSENT	SPATIABILISAMES
SEQUESTRERAIENT	SINGULARISATION	SOLUBILISASSIEZ	SPATIABILISASSE
SERICICULTRICES	SINGULARISERAIS	SOLUBILISATIONS	SPATIABILISATES
SERIGRAPHIAIENT	SINGULARISERAIT	SOLUBILISERIONS	SPATIABILISERAI
SERIGRAPHIASSES	SINGULARISERENT	SOLUTIONNASSENT	SPATIABILISERAS
SERIGRAPHIERAIS	SINGULARISERIEZ	SOLUTIONNASSIEZ	SPATIABILISEREZ
SERIGRAPHIERAIT	SINGULARISERONS	SOLUTIONNERIONS	SPATIABILISIONS
SERIGRAPHIERENT	SINGULARISERONT	SOLVABILISAIENT	SPATIALISASSENT
SERIGRAPHIERIEZ	SINTERISASSIONS	SOLVABILISASSES	SPATIALISASSIEZ
SERIGRAPHIERONS	SINTERISERAIENT	SOLVABILISERAIS	SPATIALISATIONS
SERIGRAPHIERONT	SISMOGRAPHIQUES	SOLVABILISERAIT	SPATIALISERIONS
SEROCONVERSIONS	SITOGONIOMETRES	SOLVABILISERENT	SPATIONAUTIQUES
SERODIAGNOSTICS	SITUATIONNELLES	SOLVABILISERIEZ	SPATIOTEMPORELS
SERODISCORDANTE	SITUATIONNISMES	SOLVABILISERONS	SPECIALISASSENT
SERODISCORDANTS	SITUATIONNISTES	SOLVABILISERONT	SPECIALISASSIEZ
SERONEGATIVITES	SOCIABILISAIENT	SOMATOTROPHINES	SPECIALISATIONS
SEROPOSITIVITES	SOCIABILISASSES	SOMMEILLASSIONS	SPECIALISERIONS
SEROTHERAPIQUES	SOCIABILISATION*	SOMMEILLERAIENT	SPECTROCHIMIQUE
SEROVACCINATION	SOCIABILISERAIS	SONNAILLASSIONS	SPECTROGRAPHIES
SERRAVALLIENNES	SOCIABILISERAIT	SONNAILLERAIENT	SPECTROMETRIQUE
SERVODIRECTIONS	SOCIABILISERENT	SOPHISTICATIONS	SPECTROSCOPIQUE
SERVOMECANISMES	SOCIABILISERIEZ	SOPHISTIQUAIENT	SPECULATIVEMENT
SEXOTHERAPEUTES	SOCIABILISERONS	SOPHISTIQUASSES	SPERMATOGENESES
SEXUALISASSIONS	SOCIABILISERONT	SOPHISTIQUERAIS	SPHENISCIFORMES
SEXUALISERAIENT	SOCIALISASSIONS	SOPHISTIQUERAIT	SPHEROIDISATION
SHAKESPEARIENNE	SOCIALISERAIENT	SOPHISTIQUERENT	SPHINCTERIENNES
SHAMPOOINASSENT	SOCIOBIOLOGIQUE	SOPHISTIQUERIEZ	SPIRITUALISAMES
SHAMPOOINASSIEZ	SOCIOBIOLOGISTE	SOPHISTIQUERONS	SPIRITUALISASSE
SHAMPOOINERIONS	SOCIOCENTRISMES	SOPHISTIQUERONT	SPIRITUALISATES
SHAMPOUINASSENT	SOCIOCULTURELLE	SOUFFLETASSIONS	SPIRITUALISERAI
SHAMPOUINASSIEZ	SOCIODRAMATIQUE	SOUFFLETERAIENT*	SPIRITUALISERAS
SHAMPOUINERIONS	SOCIOECONOMIQUE	SOUFFLETTERIONS	SPIRITUALISEREZ


Mots de 15 lettres de SPIRITUALISIONS à SUPRATERRESTRES - Page 55/61

SPIRITUALISIONS	STEREOCHIMIQUES	SUBDIVISASSIONS	SUPERCARBURANTS
SPIRITUELLEMENT	STEREOGRAPHIQUE	SUBDIVISERAIENT	SUPERCELLULAIRE*
SPLANCHNOLOGIES	STEREOMETRIQUES	SUBEQUATORIALES	SUPERCENTENAIRE*
SPLENOMEGALIQUE	STEREOPHONIQUES	SUBKILOTONNIQUE	SUPERCHAMPIONNE
SPONDYLARTHRITE	STEREOREGULIERE	SUBMERGEASSIONS	SUPERCONTINENTS
SPONDYLARTHROSE	STEREOREGULIERS	SUBORDONNASSENT	SUPERFETATOIRES
SPONSORISASSENT	STEREOSCOPIQUES	SUBORDONNASSIEZ	SUPERFICIALITES
SPONSORISASSIEZ	STEREOSPONDYLES	SUBORDONNERIONS	SUPERFORTERESSE
SPONSORISATIONS	STEREOTYPASSENT	SUBSIDIAIREMENT	SUPERHETERODYNE
SPONSORISERIONS	STEREOTYPASSIEZ	SUBSTANTIALISME	SUPERINTENDANTS
SQUATTERISAIENT	STEREOTYPERIONS	SUBSTANTIALISTE	SUPERLATIVEMENT
SQUATTERISASSES	STERILISASSIONS	SUBSTANTIALITES	SUPERLUMINIQUES
SQUATTERISERAIS	STERILISATRICES	SUBSTANTIFIQUES	SUPERMINISTERES*
SQUATTERISERAIT	STERILISERAIENT	SUBSTANTIVAIENT	SUPERORDINATEUR
SQUATTERISERENT	STIGMATISASSENT	SUBSTANTIVASSES	SUPEROVULATIONS
SQUATTERISERIEZ	STIGMATISASSIEZ	SUBSTANTIVATION	SUPERPETROLIERS
SQUATTERISERONS	STIGMATISATIONS	SUBSTANTIVEMENT	SUPERPHOSPHATES
SQUATTERISERONT	STIGMATISERIONS	SUBSTANTIVERAIS	SUPERPLASTICITE
STABILISASSIONS	STIPENDIASSIONS	SUBSTANTIVERAIT	SUPERPLASTIQUES
STABILISATRICES	STIPENDIERAIENT	SUBSTANTIVERENT	SUPERPOSASSIONS
STABILISERAIENT	STOECHIOMETRIES	SUBSTANTIVERIEZ	SUPERPOSERAIENT
STALAGMOMETRIES	STOMATOLOGIQUES	SUBSTANTIVERONS	SUPERPRIVILEGES
STANDARDISABLES	STOMATOLOGISTES	SUBSTANTIVERONT	SUPERPRODUCTION
STANDARDISAIENT	STOMATOPLASTIES	SUBSTITUABILITE	SUPERPUISSANCES
STANDARDISASSES	STOMATORRAGIQUE	SUBSTITUASSIONS	SUPERSTITIEUSES
STANDARDISATION	STRANGULASSIONS	SUBSTITUERAIENT	SUPERSTRUCTURES
STANDARDISERAIS	STRANGULERAIENT	SUBTILISASSIONS	SUPERVISASSIONS
STANDARDISERAIT	STRASBOURGEOISE	SUBTILISERAIENT	SUPERVISERAIENT
STANDARDISERENT	STRATEGIQUEMENT	SUBVENTIONNAMES	SUPPLANTASSIONS
STANDARDISERIEZ	STRATIFIASSIONS	SUBVENTIONNASSE	SUPPLANTERAIENT
STANDARDISERONS	STRATIFICATIONS	SUBVENTIONNATES	SUPPLEMENTAIENT
STANDARDISERONT	STRATIFIERAIENT	SUBVENTIONNELLE	SUPPLEMENTAIRES
STAPHYLOCOCCIES	STRATIGRAPHIQUE	SUBVENTIONNERAI	SUPPLEMENTASSES
STATIONNASSIONS	STRATOSPHERIQUE	SUBVENTIONNERAS	SUPPLEMENTATION
STATIONNERAIENT	STREPTOBACILLES	SUBVENTIONNEREZ	SUPPLEMENTERAIS
STATISTICIENNES	STREPTOCOCCIQUE	SUBVENTIONNIONS	SUPPLEMENTERAIT
STATISTIQUEMENT	STROBOSCOPIQUES	SUBVERTISSAIENT	SUPPLEMENTERENT
STATUROPONDERAL	STRUCTURALEMENT	SUCCESSIBILITES	SUPPLEMENTERIEZ
STEGANOGRAPHIES	STRUCTURALISMES	SUGGESTIBILITES	SUPPLEMENTERONS
STELLIONATAIRES	STRUCTURALISTES	SUGGESTIONNAMES	SUPPLEMENTERONT
STENOGRAPHIAMES	STRUCTURASSIONS	SUGGESTIONNASSE	SUPPLICIASSIONS
STENOGRAPHIASSE	STRUCTURERAIENT	SUGGESTIONNATES	SUPPLICIERAIENT
STENOGRAPHIATES	STRUCTUROLOGIES	SUGGESTIONNERAI	SUPRACONDUCTEUR
STENOGRAPHIERAI	STRUTHIONIFORME	SUGGESTIONNERAS	SUPRACONDUCTION
STENOGRAPHIERAS	STYLISTICIENNES	SUGGESTIONNEREZ	SUPRALIMINAIRES
STENOGRAPHIEREZ	STYLOGRAPHIQUES	SUGGESTIONNIONS	SUPRALUMINIQUES
STENOGRAPHIIONS	SUBANTARCTIQUES	SULFHEMOGLOBINE	SUPRANATIONALES
STENOGRAPHIQUES	SUBDELEGUASSENT	SULFOCARBONATES	SUPRASEGMENTALE
STENOTYPASSIONS	SUBDELEGUASSIEZ	SULFOCARBONIQUE	SUPRASEGMENTAUX
STENOTYPERAIENT	SUBDELEGUERIONS	SULFOCHROMIQUES	SUPRATERRESTRES


Mots de 15 lettres de SURABONDASSIONS à SURVALORISERONS - Page 56/61

SURABONDASSIONS	SURDETERMINASSE	SUREXPLOITERIEZ	SURMEDIATISERAI
SURABONDERAIENT	SURDETERMINATES	SUREXPLOITERONS	SURMEDIATISERAS
SURACCUMULATION	SURDETERMINERAI	SUREXPLOITERONT	SURMEDIATISEREZ
SURACTIVASSIONS	SURDETERMINERAS	SUREXPOSASSIONS	SURMEDIATISIONS
SURACTIVERAIENT	SURDETERMINEREZ	SUREXPOSERAIENT	SURMEDICALISAIS
SURAJOUTASSIONS	SURDETERMINIONS	SUREXPRIMASSENT	SURMEDICALISAIT
SURAJOUTERAIENT	SURDIMENSIONNAI	SUREXPRIMASSIEZ	SURMEDICALISANT
SURALIMENTAIENT	SURDIMENSIONNAS	SUREXPRIMERIONS	SURMEDICALISEES
SURALIMENTASSES	SURDIMENSIONNAT	SURFACTURASSENT	SURMEDICALISENT
SURALIMENTATION	SURDIMENSIONNEE	SURFACTURASSIEZ	SURMEDICALISERA
SURALIMENTERAIS	SURDIMENSIONNER	SURFACTURATIONS	SURMEDICALISIEZ
SURALIMENTERAIT	SURDIMENSIONNES	SURFACTURERIONS	SURMEDICALISONS
SURALIMENTERENT	SURDIMENSIONNEZ	SURFRAPPASSIONS	SURMOTIVASSIONS*
SURALIMENTERIEZ	SURENCHERIRIONS	SURFRAPPERAIENT	SURMOTIVERAIENT*
SURALIMENTERONS	SURENCHERISSAIS	SURGENERATRICES	SURMULTIPLIAMES
SURALIMENTERONT	SURENCHERISSAIT	SURGEONNASSIONS	SURMULTIPLIASSE
SURBAISSASSIONS	SURENCHERISSANT	SURGEONNERAIENT	SURMULTIPLIATES
SURBAISSERAIENT	SURENCHERISSENT	SURGONFLASSIONS	SURMULTIPLIERAI
SURCHARGEASSENT	SURENCHERISSEUR	SURGONFLERAIENT	SURMULTIPLIERAS
SURCHARGEASSIEZ	SURENCHERISSIEZ	SURGREFFASSIONS	SURMULTIPLIEREZ
SURCHARGERAIENT	SURENCHERISSONS	SURGREFFERAIENT	SURMULTIPLIIONS
SURCHAUFFASSENT	SURENCOMBREMENT	SURHAUSSASSIONS	SURNATURALISMES
SURCHAUFFASSIEZ	SURENDETTASSENT	SURHAUSSERAIENT	SURPLOMBASSIONS
SURCHAUFFERIONS	SURENDETTASSIEZ	SURIMPOSASSIONS	SURPLOMBERAIENT
SURCLASSASSIONS	SURENDETTEMENTS	SURIMPOSERAIENT	SURPRODUCTRICES
SURCLASSERAIENT	SURENDETTERIONS	SURINFECTASSENT	SURPRODUIRAIENT
SURCOMPENSAIENT	SURENTRAINAIENT	SURINFECTASSIEZ	SURPRODUISAIENT
SURCOMPENSASSES	SURENTRAINASSES	SURINFECTERIONS	SURPRODUISIRENT
SURCOMPENSATION	SURENTRAINEMENT	SURINFORMASSENT	SURPRODUISISSES
SURCOMPENSERAIS	SURENTRAINERAIS	SURINFORMASSIEZ	SURPROTECTRICES
SURCOMPENSERAIT	SURENTRAINERAIT	SURINFORMATIONS	SURPROTEGEAIENT
SURCOMPENSERENT	SURENTRAINERENT	SURINFORMERIONS	SURPROTEGEASSES
SURCOMPENSERIEZ	SURENTRAINERIEZ	SURINTERPRETAIS	SURPROTEGERIONS
SURCOMPENSERONS	SURENTRAINERONS	SURINTERPRETAIT	SURREAGISSAIENT
SURCOMPENSERONT	SURENTRAINERONT	SURINTERPRETANT	SURREGENERATEUR
SURCOMPRESSIONS	SUREQUIPASSIONS	SURINTERPRETEES	SURREGENERATION
SURCOMPRIMAIENT	SUREQUIPERAIENT	SURINTERPRETENT	SURREPRESENTEES
SURCOMPRIMASSES	SURESTIMASSIONS	SURINTERPRETERA	SURRESERVATIONS
SURCOMPRIMERAIS	SURESTIMERAIENT	SURINTERPRETIEZ	SURSATURASSIONS
SURCOMPRIMERAIT	SUREVALUASSIONS	SURINTERPRETONS	SURSATURERAIENT
SURCOMPRIMERENT	SUREVALUERAIENT	SURINVESTIRIONS	SURSTOCKASSIONS
SURCOMPRIMERIEZ	SUREXCITABILITE	SURINVESTISSAIS	SURSTOCKERAIENT
SURCOMPRIMERONS	SUREXCITASSIONS	SURINVESTISSAIT	SURVALORISAIENT
SURCOMPRIMERONT	SUREXCITERAIENT	SURINVESTISSANT	SURVALORISASSES
SURCONSOMMATION	SUREXPLOITAIENT	SURINVESTISSENT	SURVALORISATION
SURCONTRASSIONS	SUREXPLOITASSES	SURINVESTISSIEZ	SURVALORISERAIS
SURCONTRERAIENT	SUREXPLOITATION	SURINVESTISSONS	SURVALORISERAIT
SURDETERMINAMES	SUREXPLOITERAIS	SURMEDIATISAMES	SURVALORISERENT
SURDETERMINANTE	SUREXPLOITERAIT	SURMEDIATISASSE	SURVALORISERIEZ
SURDETERMINANTS	SUREXPLOITERENT	SURMEDIATISATES	SURVALORISERONS


Mots de 15 lettres de SURVALORISERONT à TELEVANGELISTES - Page 57/61

SURVALORISERONT	SYNTONISASSIONS	TECHNOCRATISEES	TELEGRAPHIERAIT
SURVEILLASSIONS	SYNTONISERAIENT	TECHNOCRATISENT	TELEGRAPHIERENT
SURVEILLERAIENT	SYPHILIGRAPHIES	TECHNOCRATISERA	TELEGRAPHIERIEZ
SUSCEPTIBILITES	SYPHILOGRAPHIES	TECHNOCRATISIEZ	TELEGRAPHIERONS
SUSPICIEUSEMENT	SYSTEMATICIENNE	TECHNOCRATISMES	TELEGRAPHIERONT
SYMBOLISASSIONS	SYSTEMATISAIENT	TECHNOCRATISONS	TELEGUIDASSIONS
SYMBOLISERAIENT	SYSTEMATISASSES	TECHNOSTRUCTURE	TELEGUIDERAIENT
SYMETRISASSIONS	SYSTEMATISATION	TECTONOPHYSIQUE	TELEIMPRESSIONS
SYMETRISERAIENT	SYSTEMATISERAIS	TELANGIECTASIES	TELEMAINTENANCE
SYMPATHECTOMIES	SYSTEMATISERAIT	TELEASSISTANCES	TELEMATISASSENT
SYMPATHICOTONIE	SYSTEMATISERENT	TELEAVERTISSEUR	TELEMATISASSIEZ
SYMPATHIQUEMENT	SYSTEMATISERIEZ	TELECHARGEABLES	TELEMATISATIONS
SYMPATHISASSENT	SYSTEMATISERONS	TELECHARGEAIENT	TELEMATISERIONS
SYMPATHISASSIEZ	SYSTEMATISERONT	TELECHARGEASSES	TELEMECANICIENS
SYMPATHISERIONS	TACHYGENETIQUES	TELECHARGEMENTS	TELEMERCATIQUES
SYMPATHOLYTIQUE	TACHYGRAPHIQUES	TELECHARGERIONS	TELEMESSAGERIES
SYMPHONIQUEMENT	TALENTUEUSEMENT	TELECOMMANDAMES	TELEMETRASSIONS
SYMPTOMATOLOGIE	TAMBOURINASSENT	TELECOMMANDASSE	TELEMETRERAIENT
SYNALLAGMATIQUE	TAMBOURINASSIEZ	TELECOMMANDATES	TELEOPERATRICES
SYNCHRONISAIENT	TAMBOURINEMENTS	TELECOMMANDERAI	TELEPHONASSIONS
SYNCHRONISASSES	TAMBOURINERIONS	TELECOMMANDERAS	TELEPHONERAIENT
SYNCHRONISATION	TANANARIVIENNES	TELECOMMANDEREZ	TELEPORTASSIONS
SYNCHRONISERAIS	TARABISCOTAIENT	TELECOMMANDIONS	TELEPORTERAIENT
SYNCHRONISERAIT	TARABISCOTASSES	TELECONFERENCES	TELEPROSPECTEUR
SYNCHRONISERENT	TARABISCOTERAIS	TELECONSEILLERE	TELEPROSPECTION*
SYNCHRONISERIEZ	TARABISCOTERAIT	TELECONSEILLERS	TELEREPORTRICES*
SYNCHRONISERONS	TARABISCOTERENT	TELECOPIASSIONS	TELESCOPASSIONS
SYNCHRONISERONT	TARABISCOTERIEZ	TELECOPIERAIENT	TELESCOPERAIENT
SYNCHRONISEUSES	TARABISCOTERONS	TELEDECLARAIENT	TELESECRETARIAT
SYNCHROTRONIQUE	TARABISCOTERONT	TELEDECLARANTES	TELESPECTATEURS
SYNCRISTALLISAI	TARABUSTASSIONS	TELEDECLARASSES	TELESPECTATRICE
SYNCRISTALLISAS	TARABUSTERAIENT	TELEDECLARATION	TELETACHYMETRES
SYNCRISTALLISAT	TARDENOISIENNES	TELEDECLARERAIS	TELETRAITEMENTS
SYNCRISTALLISER	TATAOUINASSIONS	TELEDECLARERAIT	TELETRANSMETTES
SYNCRISTALLISES	TATAOUINERAIENT	TELEDECLARERENT	TELETRANSMETTEZ
SYNCRISTALLISEZ	TATILLONNASSENT	TELEDECLARERIEZ	TELETRANSMETTRA
SYNDICALISAIENT	TATILLONNASSIEZ	TELEDECLARERONS	TELETRANSMETTRE
SYNDICALISASSES	TATILLONNERIONS	TELEDECLARERONT	TELETRANSMIRENT
SYNDICALISATION	TAYLORISASSIONS	TELEDIAGNOSTICS	TELETRANSMISSES
SYNDICALISERAIS	TAYLORISERAIENT	TELEDIFFUSAIENT	TELETRAVAILLAIS
SYNDICALISERAIT	TCHECOSLOVAQUES	TELEDIFFUSASSES	TELETRAVAILLAIT
SYNDICALISERENT	TECHNETRONIQUES	TELEDIFFUSERAIS	TELETRAVAILLANT
SYNDICALISERIEZ	TECHNICISASSENT	TELEDIFFUSERAIT	TELETRAVAILLENT
SYNDICALISERONS	TECHNICISASSIEZ	TELEDIFFUSERENT	TELETRAVAILLERA
SYNDICALISERONT	TECHNICISATIONS	TELEDIFFUSERIEZ	TELETRAVAILLEUR
SYNTACTICIENNES	TECHNICISERIONS	TELEDIFFUSERONS	TELETRAVAILLIEZ
SYNTHETIQUEMENT	TECHNOCRATIQUES	TELEDIFFUSERONT	TELETRAVAILLONS
SYNTHETISASSENT	TECHNOCRATISAIS	TELEGRAPHIAIENT	TELEUNIVERSITES
SYNTHETISASSIEZ	TECHNOCRATISAIT	TELEGRAPHIASSES	TELEVANGELISMES*
SYNTHETISERIONS	TECHNOCRATISANT	TELEGRAPHIERAIS	TELEVANGELISTES


Mots de 15 lettres de TELEVERSASSIONS à TRANQUILLISEREZ - Page 58/61

TELEVERSASSIONS*	THERMOFORMERAIS	TIREBOUCHONNAIS	TOURNICOTASSIEZ
TELEVERSERAIENT*	THERMOFORMERAIT	TIREBOUCHONNAIT	TOURNICOTERIONS
TELLURHYDRIQUES	THERMOFORMERENT	TIREBOUCHONNANT	TOURNIQUASSIONS
TELOLECITHIQUES	THERMOFORMERIEZ	TIREBOUCHONNEES	TOURNIQUERAIENT
TEMISCABITIBIEN	THERMOFORMERONS	TIREBOUCHONNENT	TOUSSAILLASSENT
TEMPERAMENTALES	THERMOFORMERONT	TIREBOUCHONNERA	TOUSSAILLASSIEZ
TEMPORISASSIONS	THERMOGRAPHIQUE	TIREBOUCHONNIEZ	TOUSSAILLERIONS
TEMPORISATRICES	THERMOMECANIQUE	TIREBOUCHONNONS	TOXICODEPENDANT
TEMPORISERAIENT	THERMOMETRIQUES	TITULARISASSENT	TOXICOMANIAQUES
TENSIOACTIVITES	THERMONUCLEAIRE	TITULARISASSIEZ	TOXICOMANOGENES
TERGIVERSASSENT	THERMOPLASTIQUE	TITULARISATIONS	TOXICOVIGILANCE
TERGIVERSASSIEZ	THERMOPLONGEURS	TITULARISERIONS	TOXIINFECTIEUSE*
TERGIVERSATIONS	THERMOPROPULSEE	TOMODENSIMETRES	TRACHEOTOMISAIS
TERGIVERSERIONS	THERMOPROPULSES	TORCHONNASSIONS	TRACHEOTOMISAIT
TERMINOLOGIQUES	THERMOPROPULSIF	TORCHONNERAIENT	TRACHEOTOMISANT
TERREAUTASSIONS	THERMORECEPTEUR	TORRAILLASSIONS	TRACHEOTOMISEES
TERREAUTERAIENT	THERMORESISTANT	TORRAILLERAIENT	TRACHEOTOMISENT
TERREBONNIENNES	THERMOSENSIBLES	TOURBILLONNAIRE	TRACHEOTOMISERA
TERRITORIALITES	THERMOSPHERIQUE	TOURBILLONNAMES	TRACHEOTOMISIEZ
TERRORISASSIONS	THERMOSTABILITE	TOURBILLONNANTE	TRACHEOTOMISONS
TERRORISERAIENT	THERMOSTATIQUES	TOURBILLONNANTS	TRADIPRATICIENS
TERTIAIRISATION	THERMOTACTISMES	TOURBILLONNASSE	TRADITIONALISME
TERTIARISATIONS	THERMOTHERAPIES	TOURBILLONNATES	TRADITIONALISTE
TETRASYLLABIQUE	THERMOTROPISMES	TOURBILLONNERAI	TRADITIONNAIRES
TEXTURISASSIONS	THESAURISASSENT	TOURBILLONNERAS	TRADITIONNELLES
TEXTURISERAIENT	THESAURISASSIEZ	TOURBILLONNEREZ	TRADITIONNISTES
THALASSOCRATIES	THESAURISATIONS	TOURBILLONNIONS	TRAFICOTASSIONS
THANATOLOGIQUES	THESAURISERIONS	TOURILLONNAIENT	TRAFICOTERAIENT
THANATOPRACTEUR	THIOBACTERIALES	TOURILLONNASSES	TRAINAILLASSENT
THAUMATURGIQUES	THIOSULFURIQUES	TOURILLONNERAIS	TRAINAILLASSIEZ
THEATRALISAIENT	THORACOCENTESES	TOURILLONNERAIT	TRAINAILLERIONS
THEATRALISASSES	THORACOPLASTIES	TOURILLONNERENT	TRAINASSASSIONS
THEATRALISATION	THROMBOLYTIQUES	TOURILLONNERIEZ	TRAINASSERAIENT
THEATRALISERAIS	THROMBOPENIQUES	TOURILLONNERONS	TRAJECTOGRAPHIE
THEATRALISERAIT	THROMBOPHLEBITE	TOURILLONNERONT	TRANCHEFILAIENT
THEATRALISERENT	THROMBOPLASTINE	TOURILLONNEUSES	TRANCHEFILASSES
THEATRALISERIEZ	THYREOGLOBULINE	TOURMENTASSIONS	TRANCHEFILERAIS
THEATRALISERONS	THYREOSTIMULINE	TOURMENTERAIENT	TRANCHEFILERAIT
THEATRALISERONT	THYROGLOBULINES	TOURNAILLASSENT	TRANCHEFILERENT
THEATROTHERAPIE	THYROIDECTOMIES	TOURNAILLASSIEZ	TRANCHEFILERIEZ
THEMATISASSIONS	TIBIOTARSIENNES*	TOURNAILLERIONS	TRANCHEFILERONS
THEMATISERAIENT	TINTINNABULAMES	TOURNEBOULAIENT	TRANCHEFILERONT
THEOLOGIQUEMENT	TINTINNABULANTE	TOURNEBOULASSES	TRANQUILLISAMES
THERMIDORIENNES	TINTINNABULANTS	TOURNEBOULERAIS	TRANQUILLISANTE
THERMOCHIMIQUES	TINTINNABULASSE	TOURNEBOULERAIT	TRANQUILLISANTS
THERMOCOLLANTES	TINTINNABULATES	TOURNEBOULERENT	TRANQUILLISASSE
THERMODYNAMIQUE	TINTINNABULERAI	TOURNEBOULERIEZ	TRANQUILLISATES
THERMOFIXATIONS	TINTINNABULERAS	TOURNEBOULERONS	TRANQUILLISERAI
THERMOFORMAIENT	TINTINNABULEREZ	TOURNEBOULERONT	TRANQUILLISERAS
THERMOFORMASSES	TINTINNABULIONS	TOURNICOTASSENT	TRANQUILLISEREZ


Mots de 15 lettres de TRANQUILLISIONS à TRESSAILLERIONS - Page 59/61

TRANQUILLISIONS	TRANSFIGURERONT	TRANSLITTERERAI	TRANSPORTASSIEZ
TRANSACTIONNELS	TRANSFILASSIONS	TRANSLITTERERAS	TRANSPORTATIONS
TRANSAFRICAINES	TRANSFILERAIENT	TRANSLITTEREREZ	TRANSPORTERIONS
TRANSAMAZONIENS	TRANSFORMASSENT	TRANSLITTERIONS	TRANSPOSASSIONS
TRANSATLANTIQUE	TRANSFORMASSIEZ	TRANSMETTRAIENT	TRANSPOSERAIENT
TRANSBAHUTAIENT	TRANSFORMATEURS	TRANSMIGRASSENT	TRANSPOSITRICES
TRANSBAHUTASSES	TRANSFORMATIONS	TRANSMIGRASSIEZ	TRANSPYRENEENNE
TRANSBAHUTERAIS	TRANSFORMATRICE	TRANSMIGRATIONS	TRANSSAHARIENNE
TRANSBAHUTERAIT	TRANSFORMERIONS	TRANSMIGRERIONS	TRANSSEXUALISME
TRANSBAHUTERENT	TRANSFRONTALIER	TRANSMODULATION	TRANSSEXUALITES
TRANSBAHUTERIEZ	TRANSFUSASSIONS	TRANSMUTABILITE	TRANSSIBERIENNE
TRANSBAHUTERONS	TRANSFUSERAIENT	TRANSMUTASSIONS	TRANSSUDASSIONS
TRANSBAHUTERONT	TRANSFUSIONNELS	TRANSMUTERAIENT	TRANSSUDERAIENT
TRANSBORDASSENT	TRANSGRESSAIENT	TRANSNATIONALES	TRANSTYMPANIQUE
TRANSBORDASSIEZ	TRANSGRESSASSES	TRANSNEPTUNIENS	TRANSURANIENNES
TRANSBORDEMENTS	TRANSGRESSERAIS	TRANSOCEANIENNE	TRANSVASASSIONS
TRANSBORDERIONS	TRANSGRESSERAIT	TRANSOCEANIQUES	TRANSVASERAIENT
TRANSCANADIENNE	TRANSGRESSERENT	TRANSPACIFIQUES	TRANSVERSALITES
TRANSCASPIENNES	TRANSGRESSERIEZ	TRANSPARAISSAIS	TRANSVIDASSIONS
TRANSCAUCASIENS	TRANSGRESSERONS	TRANSPARAISSAIT	TRANSVIDERAIENT
TRANSCENDANTALE	TRANSGRESSERONT	TRANSPARAISSANT	TRANSYLVANIENNE
TRANSCENDANTAUX	TRANSHUMANISMES*	TRANSPARAISSENT	TRAUMATISASSENT
TRANSCENDASSENT	TRANSHUMANISTES*	TRANSPARAISSIEZ	TRAUMATISASSIEZ
TRANSCENDASSIEZ	TRANSHUMASSIONS	TRANSPARAISSONS	TRAUMATISERIONS
TRANSCENDERIONS	TRANSHUMERAIENT	TRANSPARAITRAIS	TRAUMATOLOGIQUE
TRANSCODASSIONS	TRANSIGEASSIONS	TRANSPARAITRAIT	TRAUMATOLOGISTE
TRANSCODERAIENT	TRANSISTORISAIS	TRANSPARAITRIEZ	TRAVAILLASSIONS
TRANSCONTENEURS	TRANSISTORISAIT	TRANSPARAITRONS	TRAVAILLERAIENT
TRANSCRANIENNES*	TRANSISTORISANT	TRANSPARAITRONT	TRAVAILLOTAIENT
TRANSCRIPTRICES	TRANSISTORISEES	TRANSPARTISANES*	TRAVAILLOTASSES
TRANSCRIVISSENT	TRANSISTORISENT	TRANSPARUSSIONS	TRAVAILLOTERAIS
TRANSCRIVISSIEZ	TRANSISTORISERA	TRANSPERCASSENT	TRAVAILLOTERAIT
TRANSCULTURELLE	TRANSISTORISIEZ	TRANSPERCASSIEZ	TRAVAILLOTERENT
TRANSEUROPEENNE	TRANSISTORISONS	TRANSPERCEMENTS	TRAVAILLOTERIEZ
TRANSFECTASSENT	TRANSITIONNELLE	TRANSPERCERIONS	TRAVAILLOTERONS
TRANSFECTASSIEZ	TRANSITOIREMENT	TRANSPHRASTIQUE	TRAVAILLOTERONT
TRANSFECTERIONS	TRANSLATASSIONS	TRANSPIRASSIONS	TRAVESTISSAIENT
TRANSFERABILITE	TRANSLATERAIENT	TRANSPIRERAIENT	TRAVESTISSEMENT
TRANSFERASSIONS	TRANSLITERAIENT	TRANSPLANTABLES	TREILLAGEASSENT
TRANSFERENTIELS	TRANSLITERASSES	TRANSPLANTAIENT	TREILLAGEASSIEZ
TRANSFERERAIENT	TRANSLITERATION	TRANSPLANTASSES	TREILLAGERAIENT
TRANSFIGURAIENT	TRANSLITERERAIS	TRANSPLANTATION	TREILLISSASSENT
TRANSFIGURASSES	TRANSLITERERAIT	TRANSPLANTEMENT	TREILLISSASSIEZ
TRANSFIGURATEUR	TRANSLITERERENT	TRANSPLANTERAIS	TREILLISSERIONS
TRANSFIGURATION	TRANSLITERERIEZ	TRANSPLANTERAIT	TREMBLOTASSIONS
TRANSFIGURERAIS	TRANSLITERERONS	TRANSPLANTERENT	TREMBLOTERAIENT
TRANSFIGURERAIT	TRANSLITERERONT	TRANSPLANTERIEZ	TREMOUSSASSIONS
TRANSFIGURERENT	TRANSLITTERAMES	TRANSPLANTERONS	TREMOUSSERAIENT
TRANSFIGURERIEZ	TRANSLITTERASSE	TRANSPLANTERONT	TRESSAILLEMENTS
TRANSFIGURERONS	TRANSLITTERATES	TRANSPORTASSENT	TRESSAILLERIONS*


Mots de 15 lettres de TRESSAILLIRIONS à VIBRIONNERAIENT - Page 60/61

TRESSAILLIRIONS	TROPICALISERONT	TYPOGRAPHIERIEZ	VASECTOMISASSES
TRESSAILLISSENT	TROPOSPHERIQUES	TYPOGRAPHIERONS	VASECTOMISERAIS
TRESSAILLISSIEZ	TRUFFICULTRICES	TYPOGRAPHIERONT	VASECTOMISERAIT
TRESSAUTASSIONS	TRUSQUINASSIONS	TYRANNISASSIONS	VASECTOMISERENT
TRESSAUTERAIENT	TRUSQUINERAIENT	TYRANNISERAIENT	VASECTOMISERIEZ
TRIANGULASSIONS	TRYPANOSOMIASES	ULTRAFILTRATION	VASECTOMISERONS
TRIANGULERAIENT	TUBERCULINAIENT	ULTRAMICROSCOPE	VASECTOMISERONT
TRIATHLONIENNES	TUBERCULINASSES	ULTRAMONTANISME	VASODILATATEURS
TRIBOELECTRIQUE	TUBERCULINATION	ULTRAORTHODOXES	VASODILATATIONS
TRICARBOXYLIQUE	TUBERCULINERAIS	ULTRARESISTANTE	VASODILATATRICE
TRICHOCEPHALOSE	TUBERCULINERAIT	ULTRARESISTANTS	VASOUILLASSIONS
TRICONTINENTALE	TUBERCULINERENT	ULTRAROYALISTES	VASOUILLERAIENT
TRICONTINENTAUX	TUBERCULINERIEZ	UNIDIMENSIONNEL	VASSALISASSIONS
TRIDIMENSIONNEL	TUBERCULINERONS	UNIDIRECTIONNEL	VASSALISERAIENT
TRIFONCTIONNELS	TUBERCULINERONT	UNIFORMISASSENT	VAUDEVILLESQUES
TRIFOUILLASSENT	TUBERCULINIQUES	UNIFORMISASSIEZ	VECTORISASSIONS
TRIFOUILLASSIEZ	TUBERCULINISAIS	UNIFORMISATIONS	VECTORISERAIENT
TRIFOUILLERIONS	TUBERCULINISAIT	UNIFORMISERIONS	VEDETTISASSIONS
TRIGONOCEPHALES	TUBERCULINISANT	UNILATERALEMENT	VEDETTISERAIENT
TRIGONOMETRIQUE	TUBERCULINISEES	UNILATERALISMES	VEGETALISASSENT
TRIMBALLASSIONS	TUBERCULINISENT	UNILATERALISTES	VEGETALISASSIEZ
TRIMBALLERAIENT	TUBERCULINISERA	UNIPERSONNELLES	VEGETALISATIONS
TRINITROBENZENE	TUBERCULINISIEZ	UNIVERSALISAMES	VEGETALISERIONS
TRINITROTOLUENE	TUBERCULINISONS	UNIVERSALISASSE	VELIPLANCHISTES
TRIPATOUILLAGES	TUBERCULISAIENT	UNIVERSALISATES	VENDANGEASSIONS
TRIPATOUILLAMES	TUBERCULISASSES	UNIVERSALISERAI	VERBALISASSIONS
TRIPATOUILLASSE	TUBERCULISATION	UNIVERSALISERAS	VERBALISATRICES
TRIPATOUILLATES	TUBERCULISERAIS	UNIVERSALISEREZ	VERBALISERAIENT
TRIPATOUILLERAI	TUBERCULISERAIT	UNIVERSALISIONS	VERDUNISASSIONS
TRIPATOUILLERAS	TUBERCULISERENT	UNIVERSELLEMENT	VERDUNISERAIENT
TRIPATOUILLEREZ	TUBERCULISERIEZ	UNTERWALDIENNES	VERMIFUGEASSENT
TRIPATOUILLEURS	TUBERCULISERONS	VACCINOTHERAPIE	VERMIFUGEASSIEZ
TRIPATOUILLEUSE	TUBERCULISERONT	VACUOLISASSIONS	VERMIFUGERAIENT
TRIPATOUILLIONS	TUMULTUEUSEMENT	VACUOLISERAIENT	VERMILLONNAIENT
TRIPLOBLASTIQUE	TURBOCOMPRESSEE	VADROUILLASSENT	VERMILLONNASSES
TRISSYLLABIQUES	TURBOCOMPRESSES	VADROUILLASSIEZ	VERMILLONNERAIS
TROCHANTERIENNE	TURBOPROPULSEUR	VADROUILLERIONS	VERMILLONNERAIT
TROMPETTASSIONS*	TURBOSOUFFLANTE	VAGABONDASSIONS	VERMILLONNERENT
TROMPETTERAIENT	TURLUPINASSIONS	VAGABONDERAIENT	VERMILLONNERIEZ
TRONCONNASSIONS	TURLUPINERAIENT	VALDINGUASSIONS	VERMILLONNERONS
TRONCONNERAIENT	TYMPANISASSIONS	VALDINGUERAIENT	VERMILLONNERONT
TROPHOBLASTIQUE	TYMPANISERAIENT	VALENCIENNOISES	VERROUILLASSENT
TROPICALISAIENT	TYMPANOPLASTIES	VALVULOPLASTIES	VERROUILLASSIEZ
TROPICALISASSES	TYNDALLISATIONS	VAMPIRISASSIONS	VERROUILLERIONS
TROPICALISATION	TYPHOBACILLOSES	VAMPIRISERAIENT	VERSIFICATRICES
TROPICALISERAIS	TYPOGRAPHIAIENT	VANDALISASSIONS	VESTIMENTIFERES
TROPICALISERAIT	TYPOGRAPHIASSES	VANDALISERAIENT	VIABILISASSIONS
TROPICALISERENT	TYPOGRAPHIERAIS	VASCULARISATION	VIABILISERAIENT
TROPICALISERIEZ	TYPOGRAPHIERAIT	VASCULONERVEUSE*	VIBRIONNASSIONS
TROPICALISERONS	TYPOGRAPHIERENT	VASECTOMISAIENT	VIBRIONNERAIENT


Mots de 15 lettres de VICTIMISASSIONS à ZOOTECHNICIENNE - Page 61/61

VICTIMISASSIONS	VOLUPTUEUSEMENT		
VICTIMISERAIENT	VULCANISASSIONS		
VICTIMOLOGIQUES	VULCANISERAIENT		
VICTORIAVILLOIS	VULCANOLOGIQUES		
VICTORIEUSEMENT	VULGARISASSIONS		
VIDEOCONFERENCE	VULGARISATRICES		
VIDEOFREQUENCES	VULGARISERAIENT		
VIDEOGRAPHIQUES	VULNERABILISAIS		
VIDEOPROJECTEUR	VULNERABILISAIT		
VIDEOPROJECTION	VULNERABILISANT		
VIDEOPROTECTION	VULNERABILISEES		
VIEILLISSEMENTS	VULNERABILISENT		
VILIPENDASSIONS	VULNERABILISERA		
VILIPENDERAIENT	VULNERABILISIEZ		
VILLAFRANCHIENS	VULNERABILISONS		
VILLEGIATURAMES	WASHINGTONIENNE		
VILLEGIATURASSE	WELTANSCHAUUNGS		
VILLEGIATURATES	WURTEMBERGEOISE		
VILLEGIATURERAI	YAMOUSSOUKROISE		
VILLEGIATURERAS	YELLOWKNIFIENNE		
VILLEGIATUREREZ	ZIGOUILLASSIONS		
VILLEGIATURIONS	ZIGOUILLERAIENT		
VILLEURBANNAISE	ZIGUINCHOROISES		
VINDICATIVEMENT	ZINZINULASSIONS		
VIOLONCELLISTES	ZINZINULERAIENT		
VIREVOLTASSIONS	ZOOGEOGRAPHIQUE		
VIREVOLTERAIENT	ZOOTECHNICIENNE		
VIRTUALISASSENT			
VIRTUALISASSIEZ			
VIRTUALISATIONS			
VIRTUALISERIONS			
VISCOELASTICITE			
VISCOELASTIQUES			
VISCOPLASTICITE			
VISCOPLASTIQUES			
VISCOREDUCTEURS			
VISCOREDUCTIONS			
VISIOCONFERENCE			
VISUALISASSIONS			
VISUALISERAIENT			
VITIVINICULTURE			
VITROCERAMIQUES			
VOLATILISASSENT			
VOLATILISASSIEZ			
VOLATILISATIONS			
VOLATILISERIONS			
VOLCANISASSIONS			
VOLCANISERAIENT			
VOLCANOLOGIQUES			
VOLTAIRIANISMES			


