AA: AA
AB: BA
AC: CA
AD: DA
AF: FA
AH: AH
    HA
AI: AI
AK: KA
AL: LA
AM: MA
AN: AN
    NA
AR: RA
AS: AS
    SA
AT: TA
AU: AU
AV: VA
AY: AY
BE: BE
BI: BI
BU: BU
CE: CE
CI: CI
CO: OC
DE: DE
DO: DO
DU: DU
    UD
EH: EH
    HE
EJ: JE
EL: LE
EM: ME
EN: EN
    NE
ER: RE
ES: ES
    SE
ET: ET
    TE
EU: EU
EV: VE
EX: EX
FI: FI
    IF
GO: GO
HI: HI
HO: HO
    OH
IL: IL
    LI
IM: MI
IN: IN
    NI
IP: PI
IR: RI
IS: SI
IX: XI
LU: LU
MO: OM
MU: MU
NO: NO
    ON
NU: NU
    UN
OR: OR
OS: OS
OT: TO
OU: OU
PU: PU
RU: RU
SU: SU
    US
SV: VS
TU: TU
    UT
UV: VU
UW: WU
