AAD: ADA
AAG: AGA
AAN: ANA
AAR: ARA
AAS: AAS
     ASA
AAX: AXA
ABC: BAC
     CAB
ABD: DAB
ABE: BEA
ABH: BAH
ABI: BAI
ABJ: JAB
ABL: BAL
ABN: BAN
ABO: BOA
     OBA
ABR: BAR
     RAB
ABS: BAS
ABT: BAT
ABU: BAU
ACE: ACE
ACF: CAF
     FAC
ACL: CAL
     LAC
ACM: MAC
ACN: NAC
ACP: CAP
ACR: ARC
     CAR
     RAC
ACS: CAS
     SAC
ACT: TAC
ADH: DAH
ADI: AID
     DIA
ADL: DAL
     LAD
ADM: DAM
ADN: DAN
ADO: ADO
     DAO
ADR: RAD
ADW: DAW
     WAD
AEG: AGE
AEI: AIE
AEK: KEA
AEL: ALE
AEM: AME
AEN: ANE
AER: ARE
     REA
AES: ASE
AET: ETA
AEU: EAU
AEV: AVE
AEX: AXE
AFF: FAF
AFI: FIA
AFL: FLA
AFN: FAN
AFP: PAF
AFQ: FAQ
AFR: FAR
AFT: FAT
     TAF
AFX: FAX
AGG: GAG
AGI: AGI
     GAI
AGL: GAL
AGN: GAN
AGP: GAP
AGT: TAG
AGY: GAY
AGZ: GAZ
AHI: HAI
     HIA
AHN: HAN
AHU: HUA
AIL: AIL
     LAI
     LIA
AIM: AMI
     MAI
AIN: ANI
     NIA
AIP: API
AIR: AIR
     IRA
     RAI
     RIA
AIS: AIS
     SAI
AIT: AIT
AIV: VIA
AIX: IXA
AJM: JAM
AJN: JAN
AJR: JAR
AJS: JAS
AKN: KAN
AKO: OKA
AKS: KAS
     SKA
AKT: KAT
AKW: KWA
AKY: YAK
ALM: MAL
ALO: LAO
     LOA
     OLA
ALP: PAL
ALS: LAS
     SAL
ALU: ALU
ALV: VAL
AMN: MAN
AMO: MAO
     MOA
AMR: RAM
AMS: MAS
AMT: MAT
AMU: MUA
AMX: MAX
AMY: YAM
ANN: NAN
ANP: PAN
ANS: ANS
ANT: TAN
ANU: NUA
ANV: VAN
ANY: NAY
AOS: OSA
AOT: OTA
     TAO
APP: PAP
APR: PAR
     RAP
APS: PAS
     SPA
APT: PAT
APU: PUA
APW: WAP
AQT: QAT
ARS: ARS
     RAS
     SAR
ART: ART
     RAT
     TAR
ARU: RUA
ARV: VAR
ARY: RAY
ARZ: RAZ
ASS: SAS
AST: TAS
ASU: SUA
     USA
ASV: VAS
ASX: SAX
ASY: AYS
ATT: TAT
ATU: TAU
     TUA
AUV: VAU
AUX: AUX
AWX: WAX
BBO: BOB
BCE: BEC
BCI: BIC
BCO: COB
BDE: DEB
BDU: DUB
BEE: BEE
BEL: BEL
     BLE
BEN: BEN
BER: BER
BEU: BEU
     BUE
BEW: WEB
BEY: BEY
     BYE
BFO: BOF
     FOB
BGO: BOG
BGU: BUG
BHU: HUB
BIN: IBN
     NIB
BIO: BIO
     IBO
     OBI
BIP: BIP
BIS: BIS
BIT: BIT
BJO: JOB
BKO: KOB
BLO: BOL
     LOB
BMO: MOB
BNO: BON
BNU: BUN
BOP: BOP
BOR: ROB
BOT: BOT
BOX: BOX
BOY: BOY
BOZ: ZOB
BPU: PUB
BRU: BRU
BSU: BUS
BTU: BUT
     TUB
CDO: DOC
CDU: DUC
CEL: CLE
CEM: MEC
CEO: ECO
CEP: CEP
     PEC
CER: CRE
CES: CES
     SEC
CET: CET
     TEC
CEU: ECU
CEZ: ZEC
CFI: CIF
     FIC
CFO: FOC
CHI: HIC
CHU: CHU
CII: ICI
CIL: CIL
CIO: COI
CIP: PIC
CIR: CRI
CIS: CIS
     SIC
CIT: TIC
CLO: COL
CLU: CUL
CMO: COM
CNO: CON
     ONC
COQ: COQ
COR: COR
     ROC
COS: SOC
COT: COT
     TOC
COU: COU
COV: VOC
COX: COX
CRU: CRU
CSU: SUC
CTU: CUT
DEI: IDE
DEL: LED
DEM: DEM
DEO: DEO
     ODE
DER: DER
DES: DES
DEU: DUE
DEY: DEY
DIK: KID
DIN: DIN
     NID
DIS: DIS
DIT: DIT
DIX: DIX
DLO: DOL
DMO: DOM
DNO: DON
DOP: DOP
DOS: DOS
DOT: DOT
DOU: DUO
     OUD
DOY: YOD
DOZ: DZO
DRU: DRU
     DUR
DRY: DRY
DSU: DUS
     SUD
     UDS
DTU: DUT
EEF: FEE
EEN: NEE
EER: ERE
     REE
EET: ETE
     TEE
EEU: EUE
EEV: EVE
EEW: EWE
EEZ: ZEE
EFI: FIE
EFN: NEF
EFR: FER
EFU: FEU
EFZ: FEZ
     ZEF
EGL: GEL
EGO: EGO
     GEO
EGR: ERG
     GRE
     REG
EGU: GUE
EGX: GEX
EHI: HIE
EHM: HEM
EHO: OHE
EHP: HEP
EHR: RHE
EHT: THE
EHU: EUH
     HEU
     HUE
EIL: ILE
     LEI
     LIE
EIM: MIE
EIN: NIE
EIO: OIE
EIP: EPI
     IPE
     PIE
EIR: IRE
     RIE
EIV: IVE
     VIE
EIX: IXE
EJT: JET
EJU: JEU
EKL: LEK
EKN: KEN
EKT: KET
     TEK
EKZ: ZEK
ELM: LEM
     MEL
ELO: OLE
ELS: LES
     SEL
ELT: LET
     TEL
ELU: ELU
     LEU
     LUE
ELV: LEV
ELZ: LEZ
EMN: NEM
EMO: MEO
EMR: MER
     REM
EMS: MES
EMT: MET
EMU: EMU
     MUE
EMY: MYE
ENO: EON
     NEO
ENS: NES
     SEN
ENT: NET
ENU: NUE
     UNE
ENY: NEY
     YEN
ENZ: NEZ
     ZEN
EOP: OPE
EOR: ORE
EOS: OSE
EOT: OTE
EOV: OVE
EOX: EXO
EOY: OYE
EOZ: ZOE
EPP: PEP
EPR: PRE
EPS: SEP
EPT: PET
     TEP
EPU: PEU
     PUE
EQU: QUE
ERS: ERS
ERT: TER
ERU: RUE
     URE
ERV: VER
ERY: RYE
ERZ: REZ
ESS: SES
EST: EST
     SET
     TES
ESU: EUS
     SUE
     USE
ESV: VES
ETT: TET
ETU: EUT
     TUE
     UTE
ETV: VET
ETX: TEX
ETY: YET
EUV: VUE
EUX: EUX
EUY: YUE
FFO: OFF
FFP: PFF
FGI: GIF
FGO: FOG
FIK: KIF
FIL: FIL
FIN: FIN
     NIF
FIO: FOI
FIP: PIF
FIR: RIF
FIS: FIS
     IFS
FIT: FIT
     TIF
FIU: FIU
     FUI
FIV: VIF
FLO: FOL
     LOF
FNO: FON
FNU: FUN
FOR: FOR
FOT: TOF
FOU: FOU
     OUF
FOX: FOX
FRU: FUR
FSU: FUS
FTU: FUT
     TUF
GIN: GIN
GIO: GOI
GIS: GIS
GIT: GIT
GIU: GUI
GIZ: ZIG
GLO: LOG
GLU: GLU
GMU: MUG
GMY: GYM
GNO: GON
GOS: GOS
GOY: GOY
GRU: GUR
GSU: GUS
HIK: KHI
HIP: HIP
     PHI
HIT: HIT
HIU: HUI
HMO: OHM
HMU: HUM
HNU: HUN
HOP: HOP
     PHO
HOR: RHO
HOT: HOT
HOU: HOU
     OUH
HOW: WOH
IKL: KIL
IKO: KOI
IKP: KIP
IKR: KIR
IKS: KSI
     SKI
IKT: KIT
ILM: MIL
ILN: LIN
ILO: LOI
     OIL
ILP: PLI
ILS: ILS
     LIS
     SIL
ILT: LIT
ILU: LUI
ILV: VIL
IMN: MIN
     NIM
IMO: MOI
IMR: MIR
IMS: MIS
IMT: MIT
IMX: MIX
INO: ION
INP: PIN
INQ: QIN
INT: NIT
     TIN
INU: NUI
     UNI
INV: VIN
INY: YIN
IOR: RIO
     ROI
IOS: ISO
     OIS
     SOI
IOT: OIT
     TOI
IOU: OUI
IPS: PIS
     PSI
     SPI
IPT: TIP
IPU: PIU
IPZ: ZIP
IQU: QUI
IRS: RIS
     SIR
IRT: RIT
     TIR
     TRI
IRZ: RIZ
ISS: SIS
ISV: VIS
ISX: SIX
ITV: VIT
JSU: JUS
KOP: KOP
KOT: KOT
KOW: WOK
KRU: KRU
KUY: KYU
LLO: LOL
LMO: MOL
LNU: NUL
LOS: LOS
     SOL
LOT: LOT
LOU: LUO
LOV: VOL
LPU: PLU
LSU: LUS
LSY: LYS
LTU: LUT
LUX: LUX
MMM: MMM
MNO: MON
     NOM
MOR: MOR
     ROM
MOS: MOS
     SOM
MOT: MOT
     TOM
MOU: MOU
MOX: MOX
MRU: MUR
MSU: MUS
MTU: MUT
NNO: NON
NOS: NOS
     SON
NOT: ONT
     TON
NOW: WON
NSU: NUS
     UNS
OOX: OXO
OOZ: ZOO
OPP: POP
OPR: PRO
OPT: POT
     TOP
OPU: POU
ORS: ORS
     ROS
ORT: ROT
OST: OST
     SOT
     TOS
OSU: SOU
OSV: VOS
OTT: TOT
OTU: OUT
OUZ: ZOU
PRU: PUR
PST: PST
PSU: PUS
     SUP
PSY: PSY
PTU: PUT
PUY: PUY
PUZ: ZUP
RSU: RUS
     SUR
RTU: RUT
RUZ: RUZ
SSU: SUS
STU: SUT
     TUS
SUV: VUS
SUW: WUS
TTU: TUT
TUZ: ZUT
