AABB: BABA
AABD: BADA
      DABA
AABG: GABA
AABS: BASA
AABT: ABAT
      BATA
AABV: BAVA
AABY: BAYA
AACC: CACA
AACD: ADAC
AACI: ACAI
AACL: CALA
      LACA
AACM: CAMA
AACN: CANA
AACP: CAPA
      PACA
AACR: ACRA
      ARAC
      RACA
AACS: CASA
AACT: ACTA
      CATA
AACV: CAVA
AADD: DADA
AADF: FADA
AADI: AIDA
AADM: DAMA
AADR: RADA
AADS: ADAS
AADT: DATA
AADV: ADAV
AAEL: ALEA
AAER: AERA
AAFL: ALFA
AAFN: FANA
AAFR: AFAR
AAFT: AFAT
AAFX: FAXA
AAGG: GAGA
AAGH: AGHA
AAGL: GALA
AAGN: NAGA
AAGR: GARA
      RAAG
      RAGA
AAGS: AGAS
      SAGA
AAGT: GATA
AAGV: GAVA
AAGZ: GAZA
AAHK: HAKA
AAHL: HALA
AAHN: AHAN
AAHT: HATA
AAHV: HAVA
AAIM: AIMA
      MAIA
AAIR: AIRA
      ARIA
      RAIA
AAIX: AXAI
AAJJ: JAJA
AAJN: NAJA
AAJR: RAJA
AAJS: JASA
AAJV: JAVA
AAKN: AKAN
      KANA
AAKR: ARAK
AAKT: KATA
      TAKA
AAKV: KAVA
AAKW: KAWA
AAKY: YAKA
AALL: ALLA
      LALA
AALM: LAMA
AALN: ANAL
AALP: ALPA
      LAPA
      PALA
AALR: RALA
AALS: SALA
AALT: TAAL
      TALA
AALU: AULA
AALV: AVAL
      LAVA
AALY: ALYA
      LAYA
AAMM: MAMA
AAMN: AMAN
      MANA
AAMP: PAMA
AAMR: ARMA
      MAAR
      MARA
      RAMA
AAMS: AMAS
AAMT: MATA
      TAMA
AAMY: MAYA
AAMZ: MAZA
AANN: NAAN
      NANA
AANP: PANA
AANR: ANAR
AANS: ANAS
      SANA
AANU: AUNA
AAOX: AXOA
AAPP: PAPA
AAPR: PARA
      RAPA
AAPS: SAPA
AAPT: TAPA
AAPV: PAVA
AAPX: APAX
AAPY: PAYA
AARS: ARAS
      RASA
      SARA
AART: RATA
      TARA
AARU: AURA
AARV: VARA
AARY: RAYA
AASV: VASA
AASX: AXAS
AATT: TATA
AATX: AXAT
      TAXA
ABBE: ABBE
ABBY: BABY
ABCN: BANC
ABCS: BACS
      CABS
ABCU: CUBA
      UBAC
ABDE: BADE
      DABE
ABDR: BARD
ABDS: DABS
ABDU: BAUD
ABEE: ABEE
ABEI: BAIE
      BEAI
ABEL: ABLE
      BALE
      BELA
ABER: ABER
      RABE
ABES: BAES
      BASE
      BEAS
ABET: BATE
      BEAT
      BETA
      EBAT
ABEU: AUBE
      BEAU
ABEV: BAVE
ABEY: BAYE
ABGN: BANG
ABGO: GOBA
ABHT: BAHT
      BATH
ABIL: BAIL
      BILA
ABIN: BAIN
      BANI
      BINA
      NABI
ABIO: ABOI
ABIP: BIPA
ABIR: ABRI
      BRAI
ABIS: BAIS
      BASI
      BISA
      ISBA
ABIT: BATI
      BITA
ABIW: BIWA
ABJS: JABS
ABLM: LAMB
ABLO: LABO
      LOBA
ABLS: BALS
ABNR: BARN
      BRAN
ABNS: BANS
ABNU: BUNA
      NUBA
ABOR: BORA
      ROBA
ABOS: BOAS
      OBAS
ABOT: ABOT
ABOU: BAOU
ABOX: BOXA
ABRS: BARS
      BRAS
      RABS
ABRZ: ZARB
ABST: BATS
ABSU: ABUS
      BUSA
ABTU: BUTA
      TUBA
ABUX: BAUX
ACCL: CLAC
ACCO: COCA
ACCR: CRAC
ACCU: ACCU
ACDE: CADE
      CEDA
      DACE
      DECA
ACDI: CADI
      CAID
ACDO: CODA
ACEF: CAFE
      FACE
ACEG: CAGE
ACEH: ACHE
      ECHA
ACEK: CAKE
ACEL: CALE
      CELA
      LACE
ACEM: ACME
      CAME
ACEN: ACNE
      CANE
ACEP: CAPE
ACER: ACRE
      AREC
      CREA
      RACE
      REAC
ACES: ACES
      CASE
ACET: ACTE
      CATE
ACEV: AVEC
      CAVE
ACEY: CAYE
ACFL: CALF
      FLAC
ACFR: FRAC
ACFS: FACS
ACHH: CHAH
ACHI: CHAI
      CHIA
ACHM: MACH
ACHN: CHAN
ACHO: HOCA
ACHR: ARCH
      CHAR
ACHS: CASH
      CHAS
ACHT: CHAT
ACHV: CHVA
ACIL: LAIC
ACIM: MICA
ACIN: INCA
ACIO: CIAO
ACIP: PICA
ACIR: CARI
      CIRA
      CRIA
ACIS: ASIC
      SCIA
ACIT: CATI
      CITA
ACJK: JACK
ACJO: JACO
ACKL: LACK
ACKP: PACK
ACKR: RACK
ACKT: TACK
ACKY: YACK
ACLL: CALL
ACLM: CLAM
ACLN: CLAN
ACLO: CALO
      COLA
ACLP: CLAP
ACLS: CALS
      LACS
ACLT: TALC
ACLU: ACUL
      CULA
ACLY: CLAY
ACMO: COMA
ACMP: CAMP
ACMR: MARC
ACMS: MACS
ACNO: ACON
      NOCA
ACNR: CRAN
ACNS: NACS
      SCAN
ACNT: CANT
ACNY: CYAN
ACOP: CAPO
ACOR: OCRA
ACOT: COTA
      OCTA
      TACO
ACOX: COXA
ACPR: PARC
ACPS: CAPS
      PACS
ACPU: PUCA
ACRS: ARCS
      CARS
ACRT: TRAC
ACRU: CRAU
      CURA
ACRV: VRAC
ACRY: CARY
ACRZ: CZAR
ACSS: SACS
ACST: SCAT
      TACS
ACSU: SUCA
ACSY: SACY
ACTT: TACT
ACTU: ACTU
ACUV: CUVA
ADDR: DARD
ADEE: AEDE
ADEF: FADE
ADEG: GADE
ADEI: AIDE
ADEJ: DEJA
      JADE
ADEL: DEAL
      DELA
ADEM: DAME
      EDAM
ADEN: ADNE
ADER: RADE
ADET: DATE
ADEV: VEDA
ADFO: FADO
ADFR: FARD
ADGO: GODA
ADGR: DRAG
ADHJ: HADJ
ADHN: HAND
ADHR: HARD
ADHS: DAHS
ADHU: DAHU
ADIK: KADI
ADIL: DAIL
      DIAL
      LAID
ADIM: DAIM
      DIAM
ADIN: DINA
      NIDA
ADIO: IODA
ADIR: DARI
      DIRA
      RAID
      RIAD
      RIDA
ADIS: AIDS
      DAIS
      DIAS
      SIDA
ADIV: DIVA
      VIDA
ADJR: JARD
ADLN: LAND
ADLO: DOLA
ADLR: LARD
ADLS: LADS
ADLU: DUAL
ADLY: LADY
ADMR: DRAM
ADMS: DAMS
ADNO: ADON
      DONA
ADNR: NARD
      RAND
ADNS: DANS
ADOP: DOPA
ADOR: DORA
      RODA
ADOS: ADOS
      DAOS
      DOSA
      SADO
      SODA
ADOT: DOTA
ADOU: DOUA
ADOX: DOXA
ADPR: DRAP
ADPU: DUPA
ADQU: QUAD
ADRS: RADS
ADRT: TARD
ADRU: ARDU
      DURA
ADRY: RYAD
      YARD
ADSW: DAWS
      WADS
ADTU: TAUD
ADUW: DAUW
AEEG: AGEE
AEEN: ANEE
AEER: AERE
AEEX: AXEE
AEFL: FEAL
      FELA
AEFM: FAME
      MAFE
AEFN: FANE
      NAFE
AEFR: FARE
      FERA
AEFT: FATE
      FETA
AEFX: FAXE
AEGG: GAGE
AEGI: AGIE
      GAIE
      GEAI
AEGL: EGAL
      GALE
      GELA
AEGM: MAGE
      MEGA
AEGN: ANGE
      GENA
      NAGE
AEGP: PAGE
AEGR: AREG
      GARE
      GERA
      GREA
      RAGE
AEGS: AGES
      SAGE
      SEGA
AEGT: GATE
AEGU: AUGE
      GUEA
AEGV: GAVE
AEGZ: GAZE
AEHI: HAIE
AEHJ: HAJE
AEHL: HALE
      HELA
AEHS: HASE
AEHT: HATE
AEHV: HAVE
AEIL: AILE
      ELIA
      LAIE
AEIM: AIME
      AMIE
      EMIA
      MAIE
AEIN: AINE
AEIP: EPIA
      PAIE
AEIR: AIRE
      RAIE
      REAI
AEIS: AIES
      AISE
      SAIE
AEIT: ETAI
      TAIE
AEJL: JALE
AEJM: MAJE
AEJN: JEAN
AEJS: JASE
AEJT: JETA
AEKL: KALE
AEKN: KENA
AEKS: KEAS
      SAKE
AELL: ALLE
AELM: ALEM
      LAME
      MALE
      MELA
AELN: ANEL
      ELAN
AELP: ALPE
      LAPE
      PALE
      PELA
AELR: LARE
      RALE
      REAL
AELS: ALES
      LESA
      SALE
AELT: ETAL
      TAEL
      TALE
AELU: ELUA
AELV: LAVE
      LEVA
      VELA
AELW: WALE
AELX: AXEL
AELY: LAYE
AELZ: LAZE
AEMM: MAME
AEMN: AMEN
      MENA
AEMP: PAME
AEMR: AMER
      ARME
      MARE
      RAME
AEMS: AMES
      MESA
      SAME
      SEMA
AEMT: MATE
      MEAT
      META
      TEAM
AEMX: EXAM
AEMY: MAYE
AEMZ: MAZE
AENP: PANE
      PEAN
AENS: ANES
      ANSE
      NASE
AENT: ANTE
      ENTA
AENU: AUNE
AENV: AVEN
      NAVE
AENZ: NAZE
AEPP: PAPE
AEPR: APRE
      EPAR
      PARE
      RAPE
AEPS: ASPE
      PESA
      SAPE
AEPT: APTE
      PATE
      PETA
      TAPE
AEPU: PEAU
AEPV: PAVE
      VAPE
AEPX: APEX
AEPY: PAYE
AERR: ERRA
      RARE
AERS: ARES
      RASE
      REAS
      SERA
AERT: ATRE
      RATE
      REAT
      TARE
AERU: AREU
AERV: RAVE
      REVA
AERX: AXER
AERY: EYRA
      RAYE
AESS: ASES
      ASSE
AEST: ASTE
      SATE
AESU: SEAU
AESV: VASE
AESX: AXES
      SAXE
      SEXA
AETT: ETAT
      TATE
      TETA
AETU: ETAU
AETX: TAXE
AETZ: ZETA
AEUV: AVEU
      VEAU
AEUX: EAUX
AEVX: VEXA
AEVZ: AVEZ
AEXZ: AXEZ
AEYZ: AYEZ
AFFS: FAFS
AFGL: FLAG
AFGN: FANG
AFGR: GRAF
AFII: FIAI
AFIK: KIFA
AFIL: FILA
AFIM: FAIM
AFIN: AFIN
      NAIF
AFIP: PIAF
      PIFA
AFIR: FRAI
AFIS: FAIS
      FIAS
AFIT: FAIT
      FIAT
AFIX: FAIX
      FIXA
AFLN: FLAN
AFLO: LOFA
AFLP: PLAF
AFLT: FLAT
AFLU: FLUA
AFMU: FUMA
AFNO: FAON
AFNS: FANS
AFOR: AFRO
      FARO
      FORA
AFOS: SOFA
AFPS: PAFS
AFQS: FAQS
AFRS: FARS
AFRT: FART
      RAFT
AFST: FATS
      TAFS
AFSU: FUSA
      SAUF
AFTU: FAUT
AFUX: FAUX
AGGI: GIGA
AGGN: GANG
AGGS: GAGS
AGIN: AGNI
      GAIN
      NAGI
AGIO: AGIO
AGIP: PAGI
AGIR: AGIR
      GARI
AGIS: AGIS
      GAIS
AGIT: AGIT
      GITA
AGIU: AGUI
      AIGU
      GUAI
AGIV: VAGI
AGLO: GOAL
AGLS: GALS
      GLAS
AGLU: GLUA
AGMO: OGAM
AGMR: GRAM
AGNR: RANG
AGNS: GANS
      SANG
AGNT: GANT
AGNY: YANG
AGOY: GOYA
      YOGA
AGPS: GAPS
AGRS: GARS
      GRAS
AGRU: GAUR
      GRAU
AGRY: GRAY
AGST: TAGS
AGSY: GAYS
AHHS: SHAH
AHII: HIAI
AHIK: HAIK
AHIR: HAIR
AHIS: HAIS
      HIAS
AHIT: HAIT
      HIAT
      THAI
AHIU: HUAI
AHIV: HAVI
AHKL: LAKH
AHKN: ANKH
      KHAN
AHKT: KHAT
AHLL: HALL
AHLO: HALO
      HOLA
AHMT: MATH
AHMU: HUMA
AHNS: HANS
      SHAN
AHOR: HARO
      HORA
AHOU: HOUA
      OUAH
AHOV: HOVA
AHOX: HOAX
AHRS: RASH
AHRT: HART
AHST: HAST
AHSU: HUAS
AHTU: HAUT
      HUAT
AIIL: LIAI
AIIN: NIAI
AIIR: IRAI
AIIX: IXAI
      IXIA
AIJN: JAIN
AIJS: JAIS
AIJT: JATI
AIKK: KAKI
AIKL: KALI
AIKM: KAMI
      MAKI
AIKN: KINA
AIKR: RAKI
AIKS: SAKI
      SKAI
      SKIA
AIKT: IKAT
AIKV: KIVA
AIKW: KAWI
AILM: LIMA
      MAIL
      MALI
AILN: ANIL
AILO: ALOI
AILP: PALI
      PILA
      PLIA
AILR: LARI
      LIRA
      RAIL
      RIAL
AILS: AILS
      LAIS
      LIAS
      SALI
      SIAL
      SILA
AILT: ALTI
      LAIT
      LIAT
      LITA
AILW: WALI
AIMM: AMMI
      IMAM
      MIAM
      MIMA
AIMN: IMAN
      MAIN
      MINA
AIMO: MOAI
AIMR: MARI
      MIRA
      RAMI
      RIMA
AIMS: AMIS
      MAIS
      MISA
      SAMI
      SIMA
AIMT: MATI
      MITA
AIMU: AMUI
      MUAI
AIMX: MAXI
      MIXA
AINN: NAIN
AINP: PAIN
      PIAN
AINR: RANI
AINS: ANIS
      ASIN
      NAIS
      NIAS
      SAIN
AINT: NAIT
      NIAT
      TAIN
      TIAN
AINU: NUAI
AINV: VAIN
      VINA
AINW: IWAN
AINZ: NAZI
      ZAIN
      ZANI
AIOS: OSAI
AIOT: IOTA
      OTAI
AIPP: PAPI
      PIPA
AIPR: PAIR
      PARI
      PRIA
      RIPA
AIPS: APIS
      ASPI
      PAIS
AIPT: PAIT
      PATI
      PITA
      TAPI
      TIPA
AIPU: PUAI
AIPX: PAIX
AIQU: QUAI
      QUIA
AIRR: RIRA
AIRS: AIRS
      IRAS
      RAIS
      RIAS
      SARI
AIRT: RAIT
      TARI
      TIRA
      TRIA
AIRU: RUAI
AIRV: RAVI
      RIVA
      VAIR
      VIRA
      VRAI
AISS: ISSA
      SAIS
AIST: ASTI
      SAIT
      SATI
      TAIS
      TISA
AISU: SUAI
      USAI
AISV: AVIS
      VAIS
      VISA
AISX: AXIS
      IXAS
AISY: AISY
AITT: TAIT
      TATI
AITU: TUAI
AITX: IXAT
      TAXI
AJMS: JAMS
AJNS: JANS
AJOS: SOJA
AJOT: JOTA
AJOU: JOUA
AJPU: PUJA
AJRS: JARS
AJRU: JURA
AJSS: JASS
AJTU: AJUT
      JUTA
AJZZ: JAZZ
AKKO: KOKA
AKKR: KRAK
AKLO: KOLA
AKMO: AMOK
      MOKA
AKMR: MARK
AKNO: KAON
      KOAN
AKNS: KANS
AKNT: TANK
AKNU: KUNA
AKOP: KAPO
AKOR: KORA
      OKRA
AKOS: OKAS
AKOT: KOTA
AKRS: KSAR
AKRT: KART
AKRU: RAKU
AKSS: SKAS
AKST: KATS
      SKAT
AKSU: SKUA
AKSV: KVAS
AKSW: KWAS
AKSY: YAKS
AKTY: KYAT
ALLO: ALLO
ALMM: MALM
ALMS: MALS
      SLAM
ALMT: MALT
ALMU: LUMA
      MAUL
ALNP: PLAN
ALNU: ALUN
      ULNA
ALNV: VLAN
ALOR: AROL
      ORAL
ALOS: LAOS
      LOAS
      OLAS
ALOT: ALTO
      TOLA
ALOU: LOUA
ALOV: LOVA
      VOLA
ALPS: LAPS
      PALS
ALPT: PLAT
ALPU: PALU
      PULA
ALRY: LYRA
      RYAL
ALSS: SALS
ALST: LATS
ALSU: ALUS
ALSV: VALS
ALSY: LYSA
ALTU: LUTA
ALUV: UVAL
      VALU
ALUX: AULX
      LUXA
ALWY: YAWL
AMMU: UMMA
AMMY: MAMY
AMNO: NOMA
AMNS: MANS
AMNX: MANX
AMOR: OMRA
AMOS: MAOS
      MASO
      MOAS
      SOMA
AMOT: TOMA
AMOX: MOXA
AMOY: MAYO
      MOYA
AMPS: SPAM
AMPU: PUMA
AMPV: VAMP
AMRS: MARS
AMRT: TRAM
AMRU: ARUM
      MURA
AMST: MATS
AMSU: MUAS
      MUSA
      SAMU
AMSY: YAMS
AMTU: MATU
      MUAT
      MUTA
AMUX: MAUX
AMUZ: ZAMU
ANNO: ANON
ANNS: NANS
ANNT: TANN
ANOP: PAON
ANOR: ORNA
ANOS: NAOS
ANOT: NOTA
      TAON
ANOU: NOUA
ANOV: NOVA
ANOY: NOYA
ANOZ: ZONA
ANPS: PANS
ANPU: PUNA
ANRZ: RANZ
ANSS: SANS
ANST: TANS
ANSU: ANUS
      NUAS
ANSV: VANS
ANSY: NAYS
ANTT: TANT
ANTU: NUAT
      TUNA
ANUU: UNAU
ANUY: YUAN
AOPR: PRAO
AOPS: POSA
      SOAP
AOPT: OPTA
      TOPA
AOPV: VAPO
AOPY: POYA
AORS: ROSA
AORT: ROTA
      TARO
AORU: ROUA
AOSS: OSAS
AOST: OSAT
      OTAS
      TAOS
      TOSA
AOSX: SAXO
AOSY: SOYA
AOTT: OTAT
AOTU: AOUT
      AUTO
      TOUA
AOTV: VOTA
AOTY: OYAT
AOUV: VOUA
APPY: PAPY
APRS: PARS
      RAPS
APRT: PART
      RAPT
APRU: PARU
      RUPA
APRW: WRAP
APSS: PASS
      SPAS
APST: PATS
      SPAT
APSU: PUAS
      SUPA
      UPAS
APSW: SWAP
      WAPS
      WASP
APSY: PAYS
APTU: PUAT
APTY: TYPA
AQST: QATS
ARSS: SARS
      SRAS
ARST: ARTS
      RATS
      SART
      STAR
      TARS
      TSAR
ARSU: RUAS
      RUSA
      SAUR
ARSV: VARS
ARSY: RAYS
ARTU: RUAT
ARTX: TRAX
ARTY: ARTY
ARTZ: TZAR
ARUZ: AZUR
ASSU: SUAS
      USAS
ASSY: YASS
ASTT: STAT
      TATS
ASTU: SAUT
      SUAT
      TUAS
      USAT
ATTU: TUAT
ATTW: WATT
ATUV: VATU
      VAUT
ATUX: TAUX
AUVX: VAUX
BBEE: BEBE
BBII: BIBI
BBLU: BULB
BBOO: BOBO
BBOS: BOBS
BCEE: CEBE
BCEH: CHEB
BCES: BECS
BCEU: CUBE
BCIR: CRIB
BCIS: BICS
BCIU: CUBI
BCKO: BOCK
BCLO: BLOC
BCLU: CLUB
BCOR: BROC
BCOS: COBS
BCOU: BOUC
BCSU: BUSC
BDEE: BEDE
BDEI: BIDE
BDEL: BLED
BDES: DEBS
BDII: DIBI
BDNO: BOND
BDOR: BORD
BDOY: BODY
BDSU: DUBS
BEEK: BEKE
BEEL: BELE
BEEN: BENE
BEER: BEER
BEES: BEES
BEET: BETE
BEEU: BUEE
BEEZ: BEEZ
BEFI: BIEF
BEFR: BREF
BEGI: BIGE
BEGO: BOGE
      GOBE
BEGU: BEGU
BEHU: BEUH
BEIL: BILE
BEIN: BENI
      BIEN
      BINE
BEIO: OBEI
BEIP: BIPE
BEIR: BRIE
BEIS: BISE
BEIT: BETI
      BITE
BEJU: JUBE
BEKR: BERK
BELO: LOBE
      OBEL
BELS: BELS
      BLES
BELT: BLET
BELU: BLEU
BEMO: BOME
BEMU: EMBU
BENR: BREN
BENS: BENS
BEOR: BOER
      BORE
      ORBE
      ROBE
BEOT: BOTE
BEOU: BOUE
BEOX: BOXE
BERS: BERS
BERU: BEUR
      BURE
      REBU
BESU: BEUS
      BUES
      BUSE
BESW: WEBS
BESY: BEYS
BETU: BUTE
      TUBE
BETY: BYTE
BEUZ: ZEBU
BGIN: BING
BGIO: BIGO
      IGBO
BGIU: GUIB
BGLO: BLOG
BGOS: BOGS
BGRU: BURG
BGSU: BUGS
BHOU: BOUH
BHSU: BUSH
      HUBS
BIIS: IBIS
BIKR: BRIK
BILL: BILL
BILO: LOBI
BIMU: IMBU
BINO: BONI
BINR: BRIN
BINS: IBNS
BINZ: BINZ
BIOR: BRIO
BIOS: BIOS
      BOIS
      IBOS
      OBIS
BIOT: BOIT
      OBIT
BIPS: BIPS
BIRR: BIRR
BIRS: BRIS
BIRU: BRUI
BIST: BITS
BISU: BUIS
      SUBI
BITU: BITU
BJOS: JOBS
BKOO: BOOK
BKOS: KOBS
BLLU: BULL
BLOR: BROL
BLOS: BOLS
      LOBS
BLOT: BLOT
BMOO: BOOM
BMOS: MOBS
BMOU: BOUM
BMRU: RUMB
BNOS: BONS
      SNOB
BNRU: BRUN
BNSU: BUNS
BOOT: BOOT
BOPS: BOPS
BORS: ROBS
BORT: BORT
BORU: BOUR
      BROU
BOSS: BOSS
BOST: BOTS
BOSU: BOUS
      OBUS
BOSY: BOYS
BOSZ: ZOBS
BOTU: BOUT
      BUTO
BOTY: TOBY
BPSU: PUBS
BRRR: BRRR
BRSU: BRUS
BRTU: BRUT
BSTU: BUTS
      TUBS
BUZZ: BUZZ
CCEI: CECI
CCHI: CHIC
CCHO: CHOC
CCIL: CLIC
CCIR: CRIC
CCOO: COCO
CCOR: CROC
CCOU: COCU
CCUU: CUCU
CDEE: CEDE
CDEI: CEDI
      DECI
CDEK: DECK
CDEO: CODE
      DECO
CDEU: DECU
      DUCE
CDIO: DICO
CDKO: DOCK
CDNO: DONC
CDOS: DOCS
CDOU: COUD
      DOCU
CDSU: DUCS
      SCUD
CEEH: ECHE
CEEL: CELE
CEEN: CENE
CEEP: CEPE
CEER: CREE
CEFH: CHEF
CEFL: CLEF
CEFO: COEF
CEFR: CERF
CEGR: GREC
CEHI: CHIE
CEHO: ECHO
CEHR: CHER
CEHU: CHUE
      ECHU
CEHW: WECH
CEHZ: CHEZ
CEIL: CIEL
      LICE
CEIM: CIME
CEIN: CINE
CEIR: CIRE
      CRIE
CEIS: SCIE
CEIT: CITE
CEIV: CIVE
      VICE
CEKN: NECK
CEKO: COKE
CEKR: RECK
CEKT: TECK
CELS: CLES
CELU: CLUE
      CULE
CEMS: MECS
CEMY: CYME
CENO: CONE
      NOCE
      ONCE
CENS: CENS
CENT: CENT
CEOR: CORE
      OCRE
CEOS: ECOS
CEOT: COTE
      ECOT
      ETOC
CEOX: COXE
CEPS: CEPS
      PECS
CEPU: PUCE
CERS: CERS
CERT: CRET
CERU: CRUE
      CURE
      ECRU
      RECU
CESS: SECS
CESU: ECUS
      SECU
      SUCE
CESZ: ZECS
CEUV: CUVE
      VECU
CEUX: CEUX
CFIL: FLIC
CFIR: FRIC
CFIS: FICS
      FISC
CFLO: FLOC
CFOR: FROC
CFOS: FOCS
CHIN: INCH
CHIP: CHIP
CHIT: CHTI
CHLO: LOCH
CHMU: CHUM
CHOP: CHOP
CHOU: CHOU
      OUCH
CHSU: CHUS
CHTU: CHUT
CIKK: KICK
CILM: CLIM
CILN: CLIN
CILO: LOCI
CILP: CLIP
CILS: CILS
CIMS: SMIC
CINO: COIN
CINQ: CINQ
CINR: CRIN
CINZ: ZINC
CIOR: COIR
CIOS: COIS
CIOT: COIT
      COTI
CIOV: VIOC
CIPS: PICS
      SPIC
CIRS: CRIS
CIRT: TRIC
CIRU: CUIR
CIST: TICS
CISU: CUIS
CITU: CUIT
      CUTI
CJNO: JONC
CKOR: ROCK
CKPU: PUCK
CLOO: COLO
      COOL
      LOCO
CLOP: PLOC
CLOS: CLOS
      COLS
CLOT: CLOT
      COLT
CLOU: CLOU
CLSU: CULS
CMOO: MOCO
      MOOC
CMOS: COMS
CMSU: MUSC
CNOS: CONS
CNOU: NOUC
CNOY: CYON
COOP: POCO
COPR: PORC
COPS: COPS
COPU: COUP
COQS: COQS
CORS: CORS
      ROCS
CORT: TROC
CORU: COUR
CORW: CROW
COSS: SOCS
COST: COTS
      TOCS
COSU: COUS
COSV: VOCS
COSY: COSY
COTU: COUT
COUV: COUV
CRSU: CRUS
CRTU: CRUT
      TRUC
      TURC
CSSU: SUCS
CSTU: CUTS
      STUC
DDJU: JUDD
DDOO: DODO
DDOU: DODU
DEEF: FEDE
DEEI: IDEE
DEEM: DEME
      MEDE
DEEN: EDEN
DEEP: PEDE
DEFI: DEFI
DEFN: FEND
DEGO: DOGE
      GODE
DEGU: DEUG
DEHS: SHED
DEIL: LIED
DEIM: DEMI
      DIME
      IDEM
DEIN: DENI
      DINE
      INDE
DEIO: IODE
DEIP: PIED
DEIR: DIRE
      RIDE
DEIS: DISE
      IDES
      SIED
DEIT: DITE
      EDIT
DEIU: DIEU
DEIV: DEVI
      DIVE
      VIDE
DEKS: DESK
DEKY: DYKE
DELO: DOLE
DELS: LEDS
DELU: DUEL
DELV: VELD
DEMO: DEMO
      DOME
      MODE
DEMS: DEMS
DENO: ONDE
DENP: PEND
DENR: NERD
      REND
DENT: DENT
      TEND
DENU: DUNE
DENV: VEND
DENY: DYNE
DENZ: ZEND
DEOP: DOPE
DEOR: DORE
      RODE
DEOS: DEOS
      DOSE
      ODES
      SODE
DEOT: DOTE
DEOU: DOUE
      OUED
DEPR: PERD
DEPU: DUPE
DERS: DERS
DERU: DRUE
      DURE
      REDU
      RUDE
DESU: DUES
      DUSE
DESY: DEYS
DEUX: DEUX
DFNO: DONF
      FOND
DGIN: DING
DGNO: DONG
      GOND
DGOR: GORD
DIIM: MIDI
DIIS: SIDI
DIKS: KIDS
DILO: DIOL
      LIDO
DIMU: MUID
DINS: NIDS
DINU: INDU
DIOR: ORDI
DIOS: DOIS
DIOT: DIOT
      DITO
      DOIT
DIQU: QUID
DIST: DITS
DITU: DUIT
DJOO: DOJO
DJOU: JUDO
DKNU: DUNK
DLOO: DOLO
DLOR: LORD
DLOS: DOLS
      LODS
DMOR: MORD
DMOS: DOMS
DMOU: DOUM
      MOUD
DNOP: POND
DNOR: NORD
      ROND
DNOS: DONS
DNOT: DONT
      TOND
DOOR: ORDO
DOPR: DROP
      PROD
DOPS: DOPS
DORS: DORS
DORT: DORT
      TORD
DOST: DOTS
DOSU: DUOS
      OUDS
DOSY: YODS
DOSZ: DZOS
DOUX: DOUX
DRSU: DRUS
      DURS
DRSY: DRYS
DRUU: URDU
DSTU: STUD
EEEP: EPEE
EEEW: EWEE
EEFI: FIEE
EEFL: ELFE
      FELE
EEFS: FEES
EEFT: FETE
EEFU: FEUE
EEFV: FEVE
EEGK: GEEK
EEGL: GELE
      LEGE
EEGN: GENE
EEGR: GERE
      GREE
EEGU: GUEE
EEHI: HIEE
EEHL: HELE
EEHM: HEME
EEHR: HERE
EEHU: HUEE
EEIL: ELIE
      LIEE
EEIM: EMIE
EEIN: NIEE
EEIP: EPIE
EEIS: SIEE
EEIX: IXEE
EEJP: JEEP
EEJS: JESE
EEJT: EJET
      JETE
EEJZ: JEZE
EEKK: KEKE
EEKT: TEKE
EELL: ELLE
EELM: MELE
EELP: PELE
EELR: REEL
EELS: LESE
EELT: TELE
EELU: ELUE
EELV: LEVE
      VELE
EELZ: ZELE
EEMM: MEME
EEMN: MENE
      NEEM
EEMR: MERE
EEMS: SEME
EEMT: EMET
EEMU: EMEU
      EMUE
      MUEE
EEMZ: MEZE
EENN: NENE
EENP: NEPE
      PENE
EENR: NERE
      RENE
EENS: NEES
      SENE
EENT: ENTE
EENU: NUEE
EENV: NEVE
      VENE
EEOR: OREE
EEOS: OSEE
EEOT: OTEE
EEOV: EVOE
      OVEE
EEPP: PEPE
EEPR: PERE
EEPS: PESE
EEPT: PETE
EEPU: PUEE
EEPZ: PEZE
EERR: ERRE
      REER
EERS: ERES
      ERSE
      REES
      SERE
EERT: ETRE
EERU: RUEE
      UREE
EERV: REVE
EERZ: REEZ
EESS: ESSE
EEST: ESTE
      ETES
      TEES
EESU: EUES
      SUEE
      USEE
EESV: EVES
      SEVE
EESW: EWES
EESX: SEXE
EESZ: ZEES
EETT: TETE
EETU: TUEE
EETV: TEVE
      VETE
EEUV: UVEE
EEVX: VEXE
EEYY: YEYE
EFFI: FIEF
EFGI: FIGE
EFIK: KIEF
      KIFE
EFIL: FIEL
      FILE
EFIN: FINE
      NIFE
EFIO: FOIE
EFIP: PIFE
EFIR: FIER
EFIS: FIES
EFIU: FIEU
      FUIE
EFIX: FIXE
EFIZ: FIEZ
EFJU: FEUJ
EFKU: KEUF
EFLO: FLOE
      LOFE
EFLS: SELF
EFLT: FLET
EFLU: FLUE
      FUEL
EFMU: FUME
      MEUF
EFNR: NERF
EFNS: NEFS
EFNU: FUNE
      NEUF
EFOR: FORE
EFOU: OEUF
EFOX: FOXE
EFPR: PERF
EFPU: PEUF
EFRS: FERS
      SERF
EFRT: FRET
EFRU: FERU
EFSU: FEUS
      FUSE
EFSZ: ZEFS
EFTU: FETU
      FUTE
      TEUF
EFUV: VEUF
EFUX: FEUX
EGGO: GOGE
EGIL: GLIE
      LIGE
EGIM: GEMI
      MEGI
EGIN: IGNE
EGIP: PIGE
EGIR: REGI
EGIT: GITE
      TIGE
EGIU: IGUE
EGJU: JUGE
EGLO: LEGO
      LOGE
EGLS: GELS
      LEGS
EGLU: GLUE
      LUGE
EGLY: GLEY
EGMU: MUGE
EGNO: GONE
EGNS: GENS
EGNT: GENT
EGOR: GORE
      OGRE
      ORGE
EGOS: GEOS
EGOT: TOGE
EGRS: ERGS
      GRES
      REGS
EGRU: GRUE
      URGE
EGRY: GYRE
EGSU: GUES
EGTU: GUET
EHIL: HILE
EHIN: HEIN
EHIR: HIER
EHIS: HIES
EHIZ: HIEZ
EHLM: LEHM
EHMO: HOME
EHMU: HUME
      MEUH
EHNU: HUNE
EHOR: HERO
EHOT: HOTE
EHOU: HOUE
EHPU: PEUH
EHPY: HYPE
EHRS: RHES
EHRU: HEUR
      HUER
      HURE
EHST: THES
EHSU: HUES
EHUZ: HUEZ
EIJO: JOIE
EIJV: JIVE
EIKN: KINE
EIKP: KEPI
EIKS: SKIE
EIKT: KITE
EILM: LIME
      MIEL
      MILE
EILN: LIEN
EILO: OEIL
EILP: PILE
      PLIE
EILR: LIER
      LIRE
      RIEL
EILS: ELIS
      ILES
      LIES
      LISE
      SILE
EILT: ELIT
      ILET
      LITE
EILU: IULE
      LIEU
EILV: LIVE
      VILE
EILX: EXIL
EILZ: LIEZ
EIMM: MIME
EIMN: MIEN
      MINE
      NEMI
EIMO: EMOI
      MOIE
EIMR: EMIR
      MIRE
      RIME
EIMS: EMIS
      ISME
      MIES
      MISE
EIMT: EMIT
      ITEM
      MITE
EIMX: MIXE
EINN: INNE
EINO: NOIE
EINP: PINE
EINR: NIER
      REIN
      RIEN
EINS: NIES
      SEIN
      SIEN
EINT: NIET
      TIEN
      TINE
EINU: UNIE
EINV: ENVI
      NIVE
      VINE
EINX: NIXE
EINZ: NIEZ
EIOP: EPOI
EIOS: OIES
      SOIE
EIOU: OUIE
EIOV: VOIE
EIPP: PIPE
EIPR: PERI
      PIER
      PIRE
      PRIE
      RIPE
EIPS: EPIS
      IPES
      PIES
      PISE
EIPT: PITE
      TIPE
EIPU: PIEU
EIPV: PIVE
EIRR: RIRE
EIRS: IRES
      REIS
      RIES
      SIRE
EIRT: RITE
      TIRE
      TRIE
EIRV: IVRE
      RIVE
      VIRE
EIRX: IXER
      RIXE
EIRZ: IREZ
      RIEZ
      ZIRE
EISS: SISE
EIST: SITE
      TISE
EISU: SUIE
EISV: IVES
      SEVI
      VIES
      VISE
EISX: IXES
EITU: ETUI
EITV: VIET
      VITE
EITX: EXIT
EITY: YETI
EIVV: VIVE
EIXZ: IXEZ
EJKR: JERK
EJNU: JEUN
EJOU: JOUE
EJPU: JUPE
EJRU: JURE
EJST: JETS
EJTU: JUTE
      TEJU
EJUX: JEUX
EKLP: KELP
EKLS: LEKS
EKMU: KEUM
EKNR: KERN
EKNS: KENS
EKOR: KORE
EKOT: KOTE
EKRT: TREK
EKST: KETS
      TEKS
EKSZ: ZEKS
ELLN: NELL
ELLO: OLLE
ELLT: TELL
ELMO: MELO
      MOLE
ELMR: MERL
ELMS: LEMS
      MELS
ELMU: MULE
ELNO: ENOL
      LONE
      NOEL
ELNT: LENT
ELNU: LUNE
ELOP: LOPE
      POLE
ELOR: ORLE
      ROLE
ELOS: SOLE
ELOT: LOTE
      TOLE
ELOU: LOUE
ELOV: LOVE
      VELO
      VOLE
ELOY: YOLE
ELPU: PEUL
ELQU: QUEL
ELRU: LEUR
      RELU
ELRY: LYRE
ELSS: SELS
ELST: LEST
      TELS
ELSU: ELUS
      LEUS
      LUES
      SEUL
ELSV: LEVS
ELSY: LYSE
ELTU: ELUT
      LUTE
ELUV: ULVE
      VELU
ELUX: LUXE
EMMO: MEMO
      MOME
EMNO: NOME
EMNS: MENS
      NEMS
EMNT: MENT
EMNU: MENU
EMOR: MORE
      ORME
EMOS: MEOS
EMOT: OMET
      TOME
EMOU: EMOU
      MOUE
EMOY: MOYE
EMPR: PERM
EMRS: MERS
      REMS
EMRU: MUER
      MURE
EMSS: MESS
EMST: METS
      STEM
EMSU: EMUS
      MEUS
      MUES
      MUSE
EMSY: MYES
EMTU: EMUT
      MEUT
      MUET
      MUTE
EMUZ: MUEZ
ENNO: NEON
      NONE
ENOP: OPEN
      PEON
ENOR: ORNE
ENOS: EONS
      NEOS
      SONE
ENOT: NOTE
ENOU: NOUE
ENOV: NOVE
ENOX: EXON
ENOY: NOYE
ENOZ: ONZE
      ZONE
ENPU: PNEU
ENRU: NUER
      RUNE
      URNE
ENSS: SENS
ENST: NETS
      SENT
ENSU: NUES
      UNES
ENSW: NEWS
ENSY: NEYS
      YENS
ENSZ: ZENS
ENTU: TENU
      TUNE
ENTV: VENT
ENUV: VENU
ENUZ: NUEZ
EOPP: POPE
EOPR: PORE
EOPS: OPES
      PESO
      POSE
EOPT: OPTE
      POTE
      TOPE
EOPX: EXPO
      OPEX
EORS: EROS
      ORES
      OSER
      ROSE
      SORE
EORT: OTER
      ROTE
      TORE
EORU: EURO
      ROUE
EORX: OXER
EORZ: ZERO
EOSS: OSES
EOST: OTES
EOSU: SOUE
EOSV: OVES
EOSX: EXOS
EOSY: OYES
EOSZ: OSEZ
      ZOES
EOTU: TOUE
EOTV: VETO
      VOTE
EOTZ: OTEZ
EOUV: VOEU
      VOUE
EOYZ: OYEZ
EPPS: PEPS
EPPU: PUPE
EPRS: PERS
      PRES
      REPS
EPRT: PRET
EPRU: PEUR
      PUER
      PURE
      REPU
      RUPE
EPSS: SEPS
EPST: PETS
      SEPT
      SPET
      STEP
EPSU: PUES
      SUPE
EPTU: PEUT
      PUTE
EPTY: TYPE
EPUX: PEUX
EPUZ: PUEZ
ERRU: RUER
ERSS: SERS
ERST: RETS
      SERT
      TRES
ERSU: RUES
      RUSE
      SUER
      SURE
      URES
      USER
ERSV: VERS
ERSY: RYES
ERTU: TUER
ERTV: VERT
ERUV: REVU
ERUZ: RUEZ
ESST: SETS
ESSU: SUES
      USES
ESTT: TEST
      TETS
ESTU: SUET
      TUES
      UTES
ESTV: VETS
ESTY: YETS
ESTZ: ZEST
ESUV: VUES
ESUY: YUES
ESUZ: SUEZ
      USEZ
ESXY: SEXY
ETTU: TETU
ETUV: VETU
      VEUT
ETUZ: TUEZ
EUVX: VEUX
EUXY: YEUX
FFII: FIFI
FFIR: RIFF
FFPT: PFFT
FGIS: GIFS
FGIT: GIFT
FGLO: GOLF
FGOS: FOGS
FGUU: FUGU
FHII: HIFI
FHIQ: FIQH
FHNO: FOHN
FIIN: FINI
FIIW: WIFI
FIJU: JUIF
FIKS: KIFS
      SKIF
FILM: FILM
FILO: FILO
      FOIL
FILP: FLIP
FILS: FILS
FILT: LIFT
FINN: FINN
FINO: FION
      FOIN
      INFO
FINS: FINS
      NIFS
      SNIF
FINU: UNIF
FIOS: FOIS
      SOIF
FIOU: FOUI
FIPS: PIFS
FIRS: FRIS
      RIFS
FIRT: FRIT
      RIFT
FIRU: FUIR
FIST: FITS
      TIFS
FISU: FIUS
      FUIS
      SUFI
      SUIF
FISV: VIFS
FITU: FUIT
FIZZ: FIZZ
FKLO: FOLK
FKNU: FUNK
FLLU: FULL
FLOP: FLOP
FLOS: LOFS
FLOT: FLOT
      LOFT
FLOU: FLOU
      FLUO
      LOUF
FLOW: FLOW
FLUX: FLUX
FNOS: FONS
FNOT: FONT
FNSU: FUNS
FOOR: ROOF
FOOT: FOOT
FOPR: PROF
FOPU: POUF
FORS: FORS
FORT: FORT
FORU: FOUR
      ROUF
FOST: SOFT
FOSU: FOUS
      OUFS
FOTU: FOUT
      TOFU
FPTU: PFUT
FRSU: SURF
FRTU: TURF
FSTU: FUTS
      TUFS
GGNO: GONG
GGOO: GOGO
GGOR: GROG
GHIW: WHIG
GHOT: GOTH
GHTU: THUG
GIJO: GOJI
GILR: GIRL
      GRIL
GILU: GLUI
GIMN: MING
GIMO: GOIM
GIMU: MUGI
GINO: OING
GINQ: QING
GINR: RING
GINS: GINS
GINU: UGNI
GIOS: GOIS
GIOY: YOGI
GIPR: GRIP
GIRS: GRIS
GIRU: RUGI
GISU: GUIS
GISZ: ZIGS
GJOU: JOUG
GLNO: LONG
GLOO: LOGO
GLOS: LOGS
GLSU: GLUS
GMOS: SMOG
GMOU: GOUM
GMOY: GOYM
GMSU: MUGS
GMSY: GYMS
GNNO: GNON
GNOS: GONS
      SONG
GNOT: TONG
GNOU: GNOU
GNUZ: GUNZ
GOOP: POGO
GORS: GROS
GORU: GOUR
GOSY: GOYS
GOTU: GOUT
GRRR: GRRR
GRSU: GURS
GRUU: GURU
GSSU: GUSS
HIKO: HOKI
HIKS: SIKH
HIOP: HOPI
HIOR: HOIR
HIPW: WHIP
HIST: HITS
      SHIT
HISU: HUIS
HITU: HUIT
HKLO: KHOL
HLTU: LUTH
HMOO: HOMO
      MOHO
HMOS: OHMS
HMRU: RHUM
HMTY: THYM
HNOT: THON
HNSU: HUNS
HOPS: PHOS
HOPT: PHOT
HOPU: HOUP
      POUH
HORS: HORS
HOST: HOST
      HOTS
HOSW: SHOW
HOTU: HOTU
HOUX: HOUX
HRSU: RUSH
HTUU: HUTU
IIKK: KIKI
IIKT: TIKI
IIKW: KIWI
      WIKI
IIMM: MIMI
IIMN: MINI
IINT: INTI
IIPP: PIPI
IIPT: TIPI
IIRS: IRIS
IITT: TITI
IIZZ: ZIZI
IJLO: JOLI
IJNU: JUIN
IJOU: JOUI
IKLO: KILO
IKLS: KILS
IKLT: KILT
IKNS: SKIN
IKNU: INUK
IKOS: KOIS
IKPS: KIPS
      SKIP
IKRS: KIRS
IKRZ: ZIKR
IKSS: SKIS
IKST: KITS
ILMO: OLIM
ILMS: MILS
      SLIM
ILNO: LINO
      LION
      LOIN
ILNS: LINS
ILOP: POIL
      POLI
ILOR: LOIR
      LORI
ILOS: LOIS
      SILO
      SOLI
ILOT: ILOT
      LOTI
ILOV: VIOL
ILPS: LISP
      PILS
      PLIS
      SLIP
ILSS: SILS
ILST: LITS
      SILT
ILSU: LUIS
ILSV: VILS
ILSY: SILY
      SYLI
ILTT: TILT
ILTU: LUIT
IMNS: MINS
      NIMS
IMNU: MUNI
IMOR: MIRO
IMOS: MISO
      MOIS
      OMIS
IMOT: OMIT
IMOV: VOMI
IMPS: MIPS
IMRS: MIRS
IMRU: MURI
IMSS: MISS
IMSU: SIUM
INNU: INNU
INOP: PION
INOR: NOIR
      NORI
      ORIN
INOS: IONS
      OINS
      SOIN
INOT: OINT
INOU: OUIN
INOV: NOVI
      OVIN
      OVNI
INOX: INOX
      NOIX
INPS: PINS
      SPIN
INPU: PUNI
INQS: QINS
INRT: TRIN
INRU: UNIR
INST: NITS
      TINS
INSU: INSU
      NUIS
      UNIS
INSV: VINS
INSW: SWIN
INSY: YINS
INTT: TINT
INTU: NUIT
      UNIT
INTV: VINT
INTW: TWIN
INUV: UNIV
IOPP: PIPO
IOPS: POIS
      SIPO
IOPX: POIX
IOQU: QUOI
IORS: RIOS
      ROIS
      ROSI
      SOIR
IORT: ROTI
      TRIO
IORU: OUIR
      ROUI
IORV: VOIR
IOSS: SOIS
IOST: SOIT
IOSU: OUIS
IOSV: VOIS
IOTT: TOIT
IOTU: ITOU
      OUIT
IOTV: VOIT
IOVX: VOIX
IPRS: PRIS
IPRT: PRIT
      TRIP
IPRX: PRIX
IPSS: SPIS
IPST: TIPS
IPSU: PUIS
IPSZ: ZIPS
IPTU: TUPI
IQUZ: QUIZ
IRSS: RISS
      SIRS
IRST: RITS
      TIRS
      TRIS
IRSU: SURI
ISSU: ISSU
      SUIS
ISTU: SUIT
ISTV: VITS
ISTZ: ZIST
ISUV: VISU
ITWZ: WITZ
JJOO: JOJO
JKNU: JUNK
JMPU: JUMP
JORU: JOUR
JRUY: JURY
KLOO: LOOK
KMOO: MOKO
KMOS: SMOK
KNPU: PUNK
KOOT: KOTO
KOPS: KOPS
KORY: YORK
KOST: KOTS
KOSU: SOUK
KOSW: WOKS
KOUY: YUKO
KOUZ: ZOUK
KRSU: KRUS
KRUU: KURU
KSUY: KYUS
LLMU: MULL
LLOO: LOLO
LLPU: PULL
LLUU: LULU
LMOO: LOMO
LMOY: MOLY
LMPU: LUMP
LNSU: NULS
LNXY: LYNX
LOOP: POLO
      POOL
LOOS: SOLO
LOOT: LOTO
LOPT: PLOT
LOPU: LOUP
LOPY: POLY
LORS: LORS
LOSS: SOLS
LOST: LOTS
LOSU: LUOS
      SOUL
LOSV: VOLS
LOSW: SLOW
LOTU: TOLU
LOTV: VOLT
LPSU: PLUS
LPTU: PLUT
LSTU: LUTS
LTUZ: LUTZ
MNOO: MONO
MNOS: MONS
      NOMS
MNOT: MONT
MNOU: MUON
MOOT: MOTO
MOOZ: ZOOM
MOPU: POUM
MORS: MORS
      ROMS
MORT: MORT
MOSS: SOMS
MOST: MOTS
      TOMS
MOSU: MOUS
      SOUM
      SUMO
MOTU: MOUT
MRSU: MURS
MRUW: WURM
MSTU: MUST
NNOO: NONO
NOOS: SONO
NOOV: NOVO
NOPT: PONT
NOSS: SONS
NOST: SONT
      TONS
NOSU: NOUS
NOSW: WONS
NOTV: VONT
NOXY: ONYX
NPTU: PUNT
NPUU: PUNU
OOPT: TOPO
OORT: ROTO
OOST: OSTO
OOSZ: ZOOS
OOTT: TOTO
OOUZ: OUZO
OOYY: YOYO
OOZZ: ZOZO
OPPS: POPS
OPRS: PROS
OPRT: PORT
      TROP
OPRU: POUR
      PROU
      PURO
OPST: POST
      POTS
      SPOT
      STOP
      TOPS
OPSU: OPUS
      OUPS
OPTU: POTU
OPTY: TYPO
OPUX: POUX
OPUY: YOUP
ORRT: TORR
ORSS: SORS
ORST: ROTS
      SORT
      TORS
ORSU: OURS
ORTT: TORT
      TROT
ORTU: TOUR
      TROU
ORTY: TORY
      TROY
ORUX: ROUX
ORXY: ORYX
OSST: OSTS
      SOTS
      TOSS
OSSU: OSSU
      SOUS
OSTT: STOT
OSTU: OUST
      TOUS
OSUV: VOUS
OTTU: TOUT
OTUX: TOUX
PRSU: PURS
PSST: PSST
PSSY: PSYS
PSTU: PUTS
      STUP
PSUY: PUYS
PSUZ: ZUPS
PTTU: PUTT
RSSU: SURS
RSTU: RUTS
RSUU: URUS
SSUU: USUS
TTUU: TUTU
UUYZ: YUZU
