AAABC: ABACA
AAABY: ABAYA
AAACG: AGACA
AAACT: ATACA
AAADG: AGADA
AAAHN: AHANA
AAALV: AVALA
AAANS: ASANA
AAARS: ARASA
AABBM: BAMBA
AABBN: NABAB
AABBR: BARBA
       RABAB
AABBS: BABAS
AABCH: BACHA
AABCL: BACLA
       CABLA
AABCM: CAMBA
AABCN: CABAN
AABCR: CABRA
AABCS: CABAS
AABCT: TABAC
AABDG: BAGAD
AABDI: BADAI
AABDN: BANDA
AABDR: BARDA
       BRADA
AABDS: BADAS
       DABAS
AABDT: BADAT
AABDU: DAUBA
AABEL: ABALE
AABER: ARABE
AABFF: BAFFA
AABFR: BAFRA
AABGL: GALBA
AABGM: GAMBA
AABGN: BANGA
AABGS: GABAS
       GASBA
AABGU: BAGUA
AABHI: BAHAI
AABHL: HABLA
AABIL: BALAI
AABIM: ABIMA
AABIR: ABRIA
AABIS: BAISA
       BASAI
AABIT: BATAI
AABIV: BAVAI
AABIY: BAYAI
AABJL: JABLA
AABLL: BALLA
AABLM: AMBLA
       BLAMA
       LAMBA
AABLN: BALAN
       BANAL
       NABLA
AABLR: RABLA
AABLS: BALSA
       BASAL
       BLASA
       SABLA
AABLT: TABLA
AABMM: MAMBA
AABMR: AMBRA
       BRAMA
AABMS: SAMBA
AABMY: YAMBA
AABNR: RABAN
AABNT: BANAT
AABOY: ABOYA
AABQU: BAQUA
AABRR: BARRA
AABRS: ABRAS
       BRASA
       SABAR
       SABRA
AABRT: RABAT
       TABAR
AABRV: BRAVA
AABRY: BRAYA
AABRZ: BARZA
       BAZAR
AABSS: BASAS
       BASSA
AABST: ABATS
       BASAT
       BASTA
       BATAS
AABSU: ABUSA
AABSV: BAVAS
AABSY: BAYAS
AABTT: BATAT
AABTU: ABUTA
AABTV: BAVAT
AABTY: BAYAT
AACCH: CACHA
AACCO: CACAO
AACCS: CACAS
AACCT: TACCA
AACDR: CADRA
       CARDA
AACDS: ADACS
AACEG: AGACE
AACEL: ECALA
AACEP: CAPEA
AACER: ACARE
       ACERA
AACEV: CAVEA
AACFH: FACHA
AACFR: FARCA
AACFT: CAFTA
AACGH: GACHA
AACGI: GAIAC
AACGL: GLACA
AACGN: CAGNA
AACGU: CAGUA
AACHH: HACHA
AACHI: AICHA
AACHK: HACKA
       KACHA
AACHL: LACHA
AACHM: HAMAC
       MACHA
AACHP: PACHA
AACHR: ACHAR
AACHT: ACHAT
       TACHA
AACHV: VACHA
AACIL: CALAI
       LACAI
AACIM: CAMAI
AACIN: CANAI
AACIP: CAPAI
AACIR: CARIA
AACIS: ACAIS
       CASAI
AACIT: ACTAI
AACIV: CAVAI
AACJN: CAJAN
AACJT: JACTA
AACKR: ARACK
AACKT: CAKTA
AACKY: KAYAC
AACLL: CALLA
AACLM: CALMA
       CLAMA
       MACLA
AACLN: CANAL
       LANCA
AACLO: CALAO
AACLP: CLAPA
       PLACA
AACLR: RACLA
AACLS: CALAS
       LACAS
AACLT: CALAT
       CALTA
       LACAT
       TACLA
AACLV: CALVA
       CLAVA
AACMP: CAMPA
AACMR: CRAMA
AACMS: CAMAS
AACMT: CAMAT
AACNN: CANNA
AACNP: PANCA
AACNR: ANCRA
       CANAR
       CRANA
       NACRA
AACNS: CANAS
AACNT: CANAT
       CANTA
       TANCA
AACNZ: NAZCA
AACOT: ATOCA
AACOU: CAOUA
AACOV: VACOA
AACPP: CAPPA
AACPS: CAPAS
       PACAS
       PACSA
AACPT: CAPAT
       CAPTA
AACQU: CAQUA
AACRR: CARRA
AACRS: ACRAS
       ARACS
       SACRA
AACRT: CARAT
       CARTA
       TRACA
AACRV: CARVA
AACSS: CASAS
       CASSA
AACST: ACTAS
       CASAT
       CASTA
       CATAS
AACSU: CAUSA
       SAUCA
AACSV: CAVAS
AACSW: AWACS
AACTT: ACTAT
AACTV: CAVAT
AADDR: DARDA
AADDS: DADAS
AADDX: ADDAX
AADEG: ADAGE
AADEL: DEALA
AADEV: EVADA
AADFI: FADAI
AADFR: FARAD
       FARDA
AADFS: FADAS
AADFT: FADAT
AADGR: GARDA
       GRADA
AADGU: DAGUA
AADHI: HAIDA
AADHL: HADAL
AADHR: HARDA
AADII: AIDAI
AADIM: DAMAI
AADIR: DAIRA
       RADAI
       RADIA
AADIS: AIDAS
AADIT: AIDAT
       DATAI
AADJR: ADJAR
       RADJA
AADKY: DAYAK
AADLL: DALLA
AADLR: LARDA
AADLU: ADULA
AADMN: DAMAN
       DAMNA
       MANDA
       NDAMA
AADMS: DAMAS
AADMT: DAMAT
AADNP: PADAN
       PANDA
AADNR: NADAR
AADNS: DANSA
AADNV: VANDA
AADOR: ADORA
AADOS: ASADO
AADPR: DRAPA
AADRR: ADRAR
       RADAR
AADRS: RADAS
AADRT: RADAT
       TARDA
AADRV: DRAVA
AADRY: DRAYA
AADST: DATAS
AADSV: ADAVS
AADTT: DATAT
AADTU: TAUDA
AAEFN: FAENA
AAEFR: AFARE
AAEGG: GAGEA
AAEGL: EGALA
AAEGM: AGAME
AAEGN: NAGEA
AAEGP: AGAPE
       PAGEA
AAEGR: AGREA
       EGARA
       RAGEA
AAEGT: AGATE
AAEGV: AGAVE
AAEGY: EGAYA
AAEHN: AHANE
AAEIR: AERAI
AAELN: ANALE
AAELS: ALEAS
       ALESA
AAELT: ALTEA
       ETALA
AAELV: AVALE
AAELW: AWALE
AAEMN: AMENA
       EMANA
AAEMR: MARAE
AAEMT: ETAMA
AAENP: PAEAN
AAENR: ARENA
AAEPT: EPATA
AAERS: AERAS
       ARASE
AAERT: AERAT
AAERV: AVARE
       AVERA
AAERX: AXERA
AAESV: EVASA
AAETY: ETAYA
AAFFG: GAFFA
AAFFT: TAFFA
AAFIM: MAFIA
AAFIN: FANAI
AAFIT: TAFIA
AAFIX: FAXAI
AAFKN: NAKFA
AAFLN: FANAL
       FLANA
AAFLR: RAFLA
AAFLS: ALFAS
AAFLT: FATAL
AAFMS: FAMAS
AAFMT: FATMA
       MATAF
AAFNS: FANAS
AAFNT: FANAT
AAFRS: AFARS
       FRASA
AAFRT: FARTA
       TARAF
AAFRY: FRAYA
AAFST: AFATS
AAFSX: FAXAS
AAFTU: FAUTA
AAFTW: FATWA
AAFTX: FAXAT
AAGGN: GAGNA
       GANGA
AAGGR: RAGGA
AAGGS: GAGAS
AAGGT: TAGGA
AAGHS: AGHAS
AAGIM: AGAMI
AAGIN: GAINA
AAGIR: AGIRA
       GARAI
AAGIS: SAIGA
AAGIT: AGITA
       GAITA
       GATAI
       TAIGA
AAGIV: GAVAI
AAGIZ: GAZAI
AAGJN: GANJA
AAGLL: ALGAL
       GALLA
AAGLN: GLANA
       LAGAN
AAGLR: GRAAL
       GRALA
AAGLS: GALAS
AAGLT: TAGAL
AAGLU: GAULA
AAGLV: VAGAL
       VALGA
AAGLY: GAYAL
AAGMM: GAMMA
       MAGMA
AAGMN: MAGNA
       MANGA
AAGMY: GAMAY
AAGNP: PANGA
AAGNR: ARGAN
       GRANA
AAGNS: GANSA
       NAGAS
AAGNT: AGNAT
       GANTA
       TANGA
AAGNW: GNAWA
AAGOR: AGORA
AAGRS: ARGAS
       GARAS
       RAAGS
       RAGAS
AAGRT: GARAT
AAGRU: ARGUA
       GAURA
       RAGUA
AAGRV: GRAVA
AAGSS: SAGAS
AAGST: GATAS
AAGSV: GAVAS
AAGSZ: GAZAS
AAGTT: GATAT
       GATTA
AAGTU: TAGUA
AAGTV: GAVAT
AAGTZ: GAZAT
AAGUV: VAGUA
AAHIL: HALAI
AAHIR: HAIRA
AAHIT: HATAI
AAHIV: AVAHI
       HAVAI
AAHJR: RAJAH
AAHKK: HAKKA
AAHKR: HARKA
AAHKS: HAKAS
AAHLL: HALAL
AAHLP: ALPHA
AAHLR: LAHAR
AAHLS: HALAS
AAHLT: HALAT
AAHLV: HALVA
AAHMR: HARAM
AAHMS: SHAMA
AAHNP: HANAP
AAHNS: AHANS
       SHANA
AAHNT: HANTA
AAHNU: NAHUA
AAHNZ: HAZAN
AAHPP: HAPPA
AAHPR: HARPA
AAHPS: PHASA
AAHPX: HAPAX
AAHRS: HARAS
AAHRT: ARHAT
AAHST: HATAS
AAHSV: HAVAS
AAHTT: HATAT
AAHTV: HAVAT
AAIIM: AIMAI
AAIIR: AIRAI
AAIJN: JAINA
AAIJS: JASAI
AAIKT: AKITA
AAIKW: KAWAI
AAILL: AILLA
       ALLAI
       ALLIA
AAILM: LAMAI
AAILN: LAINA
AAILP: ALPAI
       LAPAI
AAILR: RALAI
AAILS: ALIAS
       SALAI
AAILT: ALITA
       TALAI
AAILV: LAVAI
AAILX: AXIAL
AAILY: LAYAI
AAIMN: ANIMA
       MANIA
AAIMP: PAMAI
AAIMR: ARMAI
       MARIA
       RAMAI
AAIMS: AIMAS
       MAIAS
       MASAI
       SAAMI
AAIMT: AIMAT
       AMATI
       MATAI
       TAMIA
AAIMZ: MAZAI
       ZAMIA
AAINP: PANAI
AAINR: NAIRA
       RAINA
AAINS: ANISA
       NAIAS
AAINU: AUNAI
AAINV: AVINA
AAIPR: PARAI
       PARIA
       RAPAI
       RAPIA
AAIPS: SAPAI
AAIPT: ATIPA
       TAPAI
AAIPV: PAVAI
AAIPY: PAYAI
AAIRR: RAIRA
AAIRS: AIRAS
       ARIAS
       ARISA
       RAIAS
       RASAI
AAIRT: AIRAT
       RAITA
       RATAI
       TAIRA
       TARAI
AAIRU: AURAI
AAIRV: VARIA
AAIRY: RAYAI
       RAYIA
AAISS: ASSAI
AAISV: AVAIS
       AVISA
       VASAI
AAISX: AXAIS
AAITT: TATAI
AAITV: AVAIT
AAITX: AXAIT
       TAXAI
AAIVV: AVIVA
AAJJS: JAJAS
AAJLP: JALAP
AAJNS: NAJAS
AAJPP: JAPPA
AAJPS: JASPA
AAJQR: QAJAR
AAJRS: RAJAS
AAJRT: JARTA
AAJSS: JASAS
       JASSA
AAJST: JASAT
AAJSV: JAVAS
AAJZZ: JAZZA
AAKKN: KANAK
AAKKY: KAYAK
AAKLO: KOALA
AAKLR: KRAAL
AAKLT: KATAL
AAKMR: KARMA
AAKMZ: ZAMAK
AAKNP: PANKA
AAKNS: AKANS
       KANAS
AAKNT: KANAT
       TANKA
AAKPP: KAPPA
AAKPR: PARKA
AAKRS: ARAKS
AAKST: KATAS
       TAKAS
AAKSV: KAVAS
AAKSW: KAWAS
AAKSY: YAKAS
AAKTZ: ZAKAT
AALLR: RALLA
AALLS: ALLAS
AALLT: ALLAT
       TALLA
AALMP: LAMPA
       PALMA
AALMS: LAMAS
       SALAM
       SLAMA
       SMALA
AALMT: LAMAT
       MALTA
       TAMAL
AALMX: XALAM
AALNN: ANNAL
AALNP: PALAN
       PLANA
AALNS: NASAL
AALNT: NATAL
AALNU: ALUNA
AALNV: NAVAL
AALNY: NYALA
AALOS: SAOLA
AALPP: PALPA
       PAPAL
AALPR: PARLA
AALPS: ALPAS
       LAPAS
       PALAS
AALPT: ALPAT
       APLAT
       LAPAT
AALPX: ALPAX
AALQU: LAQUA
AALRS: RALAS
       SALAR
AALRT: RALAT
AALRV: LAVRA
       RAVAL
AALSS: LASSA
       SALAS
       SALSA
AALST: ATLAS
       SALAT
       TAALS
       TALAS
AALSU: AULAS
       SALUA
AALSV: AVALS
       LAVAS
       VALSA
AALSY: ALYAS
       LAYAS
AALTT: LATTA
       TALAT
AALTV: LAVAT
AALTY: LAYAT
AAMMM: MAMMA
AAMMN: AMMAN
       MAMAN
AAMMQ: MAQAM
AAMMS: MAMAS
AAMNR: MARNA
AAMNS: AMANS
       MANAS
       MANSA
AAMNT: AMANT
       ATMAN
       MANAT
       MANTA
AAMPP: MAPPA
       PAMPA
AAMPR: RAMPA
AAMPS: PAMAS
AAMPT: PAMAT
AAMPU: PAUMA
AAMPV: VAMPA
AAMQU: MAQUA
AAMRR: MARRA
AAMRS: ARMAS
       ASRAM
       MAARS
       MARAS
       RAMAS
AAMRT: ARMAT
       RAMAT
       TRAMA
AAMRU: AMURA
AAMRZ: ZARMA
AAMSS: MASSA
AAMST: MATAS
       TAMAS
AAMSU: AMUSA
AAMSY: MAYAS
AAMSZ: MAZAS
AAMTT: MATAT
AAMTZ: MAZAT
AANNN: NANAN
AANNO: ANONA
AANNR: NANAR
AANNS: NAANS
       NANAS
AANNT: ANTAN
       TANNA
AANNV: VANNA
AANPP: NAPPA
AANPS: PANAS
       PANSA
AANPT: PANAT
AANPX: PANAX
AANRR: NARRA
AANRS: ANARS
AANRV: NAVRA
       VARAN
       VARNA
AANSS: SANAS
AANST: SATAN
AANSU: AUNAS
       SAUNA
AANSZ: SANZA
AANTT: NATTA
AANTU: AUNAT
       AUTAN
AANTV: AVANT
       VANTA
AANTX: AXANT
AANTY: AYANT
AANUX: ANAUX
AAOPP: POPAA
AAORZ: AZORA
AAOSX: AXOAS
AAOTU: AOUTA
       OUATA
AAOTZ: AZOTA
AAOUV: AVOUA
AAOVY: AVOYA
AAPPR: RAPPA
AAPPS: APPAS
       PAPAS
AAPPT: APPAT
AAPPZ: ZAPPA
AAPQU: PAQUA
AAPRS: PARAS
       RAPAS
AAPRT: PARAT
       RAPAT
AAPRU: APURA
AAPSS: PASSA
       SAPAS
AAPST: PATAS
       SAPAT
       TAPAS
AAPSU: PAUSA
AAPSV: PAVAS
AAPSY: PAYAS
AAPTT: TAPAT
AAPTU: TAUPA
AAPTV: PAVAT
AAPTY: PAYAT
AAQRU: ARQUA
       RAQUA
AAQSU: SAQUA
AAQTU: TAQUA
AAQUV: VAQUA
AARSS: RASAS
       SARAS
AARST: RASAT
       RASTA
       RATAS
       TARAS
AARSU: AURAS
       SAURA
AARSY: RAYAS
AARTT: RATAT
       TARAT
       TATAR
AARTY: RAYAT
       TAYRA
AARUZ: AZURA
AASSS: SASSA
AASST: TASSA
AASSV: VASAS
AASSY: YASSA
AASTT: TATAS
AASTU: SAUTA
AASTV: VASAT
AASTX: TAXAS
AASTY: SATAY
AASUV: SAUVA
AATTT: TATAT
AATTX: TAXAT
ABBEK: KEBAB
ABBEL: BABEL
       LABBE
ABBEM: BEMBA
ABBER: BARBE
       REBAB
ABBES: ABBES
ABBIL: BABIL
ABBIR: RABBI
ABBMO: BOMBA
ABBRU: BARBU
ABBSY: BABYS
ABCEH: ACHEB
       BACHE
       BECHA
       CHEBA
ABCEL: BACLE
       CABLE
ABCEM: CAMBE
ABCEO: COBEA
ABCER: BERCA
       CABRE
       CRABE
ABCES: ABCES
ABCET: BECTA
ABCHI: BACHI
       BICHA
ABCHT: BATCH
ABCHU: BUCHA
ABCIK: KABIC
ABCIL: CIBLA
ABCIR: CABRI
ABCIS: BASIC
ABCIU: CUBAI
ABCKL: BLACK
ABCLN: BLANC
ABCLO: BOCAL
ABCLU: BACUL
ABCNO: BACON
       BANCO
ABCNS: BANCS
ABCOR: CARBO
       COBRA
ABCOT: CABOT
ABCOZ: COBZA
ABCSU: CABUS
       CUBAS
       UBACS
ABCTU: CUBAT
ABDEE: BADEE
ABDEG: BADGE
ABDEN: BANDE
ABDEO: ADOBE
ABDER: BADER
       BARDE
       BRADE
ABDES: BADES
       DABES
ABDET: DEBAT
ABDEU: DAUBE
ABDEZ: BADEZ
ABDIN: BADIN
ABDIR: BRIDA
ABDNO: BONDA
ABDNR: BRAND
ABDOR: ABORD
       BORDA
       BRODA
       DOBRA
ABDOS: ABDOS
ABDOU: BOUDA
ABDRS: BARDS
ABDSU: BAUDS
ABEER: BEERA
ABEES: ABEES
       BASEE
ABEET: BATEE
       BEATE
ABEEV: BAVEE
ABEFF: BAFFE
ABEFL: FABLE
ABEFR: BAFRE
ABEFU: BEAUF
ABEGI: GABIE
ABEGL: BAGEL
       BELGA
       GABLE
       GALBE
ABEGM: GAMBE
ABEGN: BAGNE
ABEGR: BARGE
       GERBA
ABEGU: BAGUE
       BAUGE
ABEHI: BEHAI
       EBAHI
ABEHL: HABLE
ABEHR: HERBA
ABEIL: BAILE
       BELAI
       LABIE
ABEIM: ABIME
       AMIBE
       IAMBE
ABEIN: BAINE
ABEIO: ABOIE
ABEIR: ABRIE
       BRAIE
ABEIS: ABIES
       BAIES
       BAISE
       BASIE
       BEAIS
ABEIT: ABETI
       BATIE
       BEAIT
ABEIX: BIAXE
ABEJL: JABLE
ABEJM: JAMBE
ABEKN: NEBKA
ABEKR: BREAK
ABEKS: SEBKA
ABEKY: KABYE
ABELL: BALLE
       LABEL
ABELM: AMBLE
       BLAME
       MELBA
ABELN: LABNE
       NABLE
ABELO: LAOBE
ABELR: BRELA
       LABRE
       RABLE
ABELS: ABLES
       BALES
       BELAS
       BLASE
       BLESA
       SABLE
ABELT: BALTE
       BELAT
       TABLE
       TALEB
ABELY: BAYLE
ABELZ: BLAZE
ABEMR: AMBRE
       BRAME
ABEMT: EMBAT
ABEMU: BAUME
       EMBUA
ABEMY: ABYME
ABENN: BANNE
       BENNA
ABENR: BERNA
ABENT: BEANT
ABEOR: AROBE
       OBERA
ABEOU: EBOUA
ABEOY: ABOYE
ABEOZ: AZOBE
ABEQU: BAQUE
ABERR: ARBRE
       BARRE
ABERS: ABERS
       BASER
       BRASE
       RABES
       SABRE
ABERT: BATER
       REBAT
       TRABE
ABERV: BAVER
       BRAVE
ABERY: BARYE
       BAYER
       BRAYE
ABERZ: ZABRE
       ZEBRA
ABESS: BASES
       BASSE
       BESAS
ABEST: BASTE
       BATES
       BEATS
       BETAS
       EBATS
       TABES
ABESU: ABUSE
       AUBES
ABESV: BAVES
ABESY: BAYES
ABESZ: BASEZ
ABETT: BATTE
ABETU: ABUTE
ABETZ: BATEZ
ABEUX: BEAUX
ABEVZ: BAVEZ
ABEYZ: BAYEZ
ABFFI: BIFFA
ABFFL: BLAFF
ABFIR: FIBRA
ABGGU: BUGGA
ABGGY: BAGGY
ABGIK: KABIG
ABGIL: BIGLA
ABGIO: GOBAI
       IBOGA
ABGNS: BANGS
ABGNU: BUGNA
ABGOS: GOBAS
ABGOT: GOBAT
ABGOU: BAGOU
       BOGUA
ABGUU: BUGUA
ABHIJ: HIJAB
ABHIL: HALBI
ABHIS: SAHIB
       SHIBA
ABHIT: HABIT
ABHST: BAHTS
       BATHS
ABHTU: BAHUT
ABIIL: ALIBI
       BILAI
ABIIN: BINAI
ABIIP: BIPAI
ABIIS: BIAIS
       BISAI
ABIIT: BITAI
       TIBIA
ABIJO: JOBAI
ABIKT: BATIK
ABILL: BILLA
ABILM: LAMBI
       LIMBA
ABILN: BILAN
ABILO: ABOLI
       LOBAI
ABILQ: QIBLA
ABILR: BARIL
       BLAIR
       LABRI
       RIBLA
ABILS: BAILS
       BILAS
ABILT: BILAT
ABIMN: NIMBA
ABIMR: BRIMA
ABINN: BANNI
ABINQ: NIQAB
ABINR: NIBAR
ABINS: BAINS
       BASIN
       BINAS
       NABIS
       SABIN
ABINT: BINAT
ABINU: AUBIN
ABINZ: BAZIN
ABIOR: BOIAR
       BOIRA
       ROBAI
ABIOS: ABOIS
       BOISA
ABIOT: BOITA
ABIOV: OBVIA
ABIOX: BOXAI
ABIPS: BIPAS
ABIPT: BIPAT
ABIQU: BIQUA
ABIRR: BARRI
ABIRS: ABRIS
       BASIR
       BRAIS
       BRISA
       SABIR
ABIRT: BATIR
       BRAIT
       RBATI
       RIBAT
ABIRV: BRAVI
       VIBRA
ABIRZ: ZARBI
ABISS: BASIS
       BISAS
       BISSA
       ISBAS
ABIST: BASIT
       BATIS
       BISAT
       BITAS
ABISU: BUSAI
ABISW: BIWAS
ABITT: BATIT
       BITAT
       BITTA
ABITU: BUTAI
       TUBAI
ABJNO: BANJO
ABJOR: BARJO
ABJOS: JOBAS
ABJOT: JABOT
       JOBAT
ABKOU: KOUBA
ABKRU: BURKA
ABLLU: BULLA
ABLMS: LAMBS
ABLMU: ALBUM
ABLOS: BOLAS
       LABOS
       LOBAS
ABLOT: LOBAT
       OBLAT
       TOLBA
ABLOU: BOULA
ABLOW: BOWAL
ABLOY: LYOBA
ABLPS: BLAPS
ABLRU: BRULA
ABLST: BLAST
ABLSU: SUBLA
ABLTU: BLUTA
ABMMO: MAMBO
ABMNO: AMBON
ABMOR: OMBRA
ABMOS: SAMBO
ABMOT: TOMBA
ABMOU: BOUMA
ABMRU: BRUMA
       RUMBA
ABMTU: TUMBA
ABMUZ: ZUMBA
ABNNO: BANON
ABNOR: BARON
       BORNA
ABNOS: SNOBA
ABNOT: BATON
ABNOU: NOUBA
ABNRS: BARNS
       BRANS
ABNRU: RUBAN
ABNSU: BUNAS
       NUBAS
ABNTU: BANTU
       TABUN
ABOOT: BOOTA
ABOPR: PROBA
ABORS: BORAS
       ROBAS
ABORT: RABOT
       ROBAT
       TABOR
ABORV: BRAVO
ABORX: BORAX
ABORY: BROYA
ABOSS: BOSSA
       SOBAS
ABOST: ABOTS
       SABOT
ABOSU: BAOUS
       BOUSA
ABOSX: BOXAS
ABOTT: BOTTA
ABOTU: ABOUT
       BOUTA
       TABOU
ABOTX: BOXAT
ABOUY: BAYOU
       BOYAU
ABOUZ: BAZOU
ABQRU: BURQA
ABQUU: BUQUA
ABRSZ: ZARBS
ABRTU: BURAT
ABSSU: BUSAS
ABSTU: BUSAT
       BUTAS
       TSUBA
       TUBAS
ABTTU: BATTU
       BUTAT
       BUTTA
       TUBAT
ABUZZ: BUZZA
ACCDE: DECCA
ACCDU: CADUC
ACCEH: CACHE
ACCES: ACCES
ACCHI: CHIAC
ACCHO: COACH
       COCHA
ACCHT: CATCH
ACCIL: CICLA
ACCIR: CIRCA
ACCKR: CRACK
ACCLU: ACCUL
ACCNO: ACCON
ACCOR: ACCRO
ACCOS: CASCO
       COCAS
       SOCCA
ACCOT: ACCOT
ACCOU: CACOU
       COUAC
ACCRS: CRACS
ACCRU: ACCRU
ACCSU: ACCUS
ACCSY: CYCAS
ACCUY: YUCCA
ACDDY: CADDY
ACDEH: DACHE
ACDEI: ACIDE
       CEDAI
ACDEL: CLADE
ACDEN: DANCE
       DECAN
ACDER: CADRE
       CARDE
       CRADE
       DARCE
       REDAC
ACDES: CADES
       CEDAS
       DACES
       DECAS
ACDET: CADET
       CEDAT
ACDEU: CAUDE
ACDHU: CHAUD
ACDIN: CANDI
ACDIO: CODAI
ACDIS: ASDIC
       CADIS
       CAIDS
ACDIT: DICTA
ACDLU: DUCAL
ACDNO: ADONC
ACDOR: CADOR
       CORDA
       CRADO
ACDOS: CODAS
ACDOT: CODAT
ACDOU: COUDA
ACDTU: DUCAT
ACEEG: CAGEE
ACEEJ: JACEE
ACEEL: CALEE
       ECALE
       LACEE
ACEEM: CAMEE
ACEEN: CANEE
ACEEP: CAPEE
ACEER: ACERE
       RACEE
ACEES: CASEE
ACEET: ACTEE
ACEEV: CAVEE
ACEFH: FACHE
ACEFL: FECAL
ACEFR: CAFRE
       FARCE
ACEFS: CAFES
       FACES
       FASCE
ACEFT: CAFTE
ACEGH: GACHE
ACEGL: GLACE
ACEGN: CAGNE
       CANGE
       ECANG
ACEGR: GARCE
       GERCA
       GRACE
ACEGS: CAGES
ACEGT: CAGET
ACEGU: CAGUE
ACEHH: HACHE
ACEHI: AICHE
       ECHAI
ACEHK: HACKE
       KACHE
ACEHL: CHALE
       LACHE
       LECHA
ACEHM: MACHE
       MECHA
ACEHN: ANCHE
ACEHP: CHAPE
       CHEAP
       PECHA
ACEHR: ARCHE
       CHERA
ACEHS: ACHES
       ECHAS
       ESCHA
       SACHE
       SECHA
ACEHT: ECHAT
       TACHE
ACEHV: CHEVA
       VACHE
ACEIL: CELAI
       CLAIE
ACEIM: ECIMA
ACEIP: EPICA
       IPECA
ACEIR: ACIER
       CARIE
       CRAIE
       CREAI
       ECRIA
ACEIT: CATIE
ACEIU: CAIEU
ACEJT: CAJET
       JACTE
ACEKS: CAKES
ACELL: CALLE
       CELLA
ACELM: CALME
       CLAME
       MACLE
ACELN: CLEAN
       LANCE
ACELO: ECOLA
ACELP: CLAPE
       PLACE
ACELR: CALER
       LACER
       RACLE
ACELS: CALES
       CELAS
       LACES
ACELT: CALTE
       CELAT
       ECLAT
       LACET
       LACTE
       TACLE
ACELU: ECULA
ACELV: CLAVE
ACELY: ACYLE
ACELZ: CALEZ
       LACEZ
ACEMO: CAMEO
ACEMP: CAMPE
ACEMR: CAMER
       CARME
       CRAME
       CREMA
       MACRE
ACEMS: ACMES
       CAMES
       SECAM
ACEMU: ECUMA
ACEMZ: CAMEZ
ACENN: CANNE
       ENCAN
ACENO: CANOE
       OCEAN
ACENP: PECAN
ACENR: ANCRE
       CANER
       CARNE
       CERNA
       CRANE
       CRENA
       ECRAN
       ENCRA
       NACRE
       RANCE
ACENS: ACNES
       CANES
       CEANS
       ENCAS
ACENT: CANTE
       TANCE
ACENZ: CANEZ
ACEOP: ECOPA
ACEOR: ACORE
ACEOT: ECOTA
ACEPR: CAPER
       CAPRE
       CARPE
       CREPA
       PARCE
       PERCA
       RECAP
ACEPS: CAPES
       PACSE
       SPACE
ACEPT: CAPET
       CAPTE
       PACTE
ACEPU: EPUCA
ACEPZ: CAPEZ
ACEQU: CAQUE
ACERR: CARRE
       RACER
ACERS: ACRES
       ARECS
       CASER
       CESAR
       CRASE
       CREAS
       RACES
       REACS
       SACRE
       SCARE
       SERAC
ACERT: ACTER
       CARET
       CARTE
       CERAT
       CREAT
       CRETA
       ECART
       RECTA
       TERCA
       TRACE
ACERU: ECURA
ACERV: CAVER
       CRAVE
       CREVA
ACERX: CAREX
ACESS: ASSEC
       CASES
       CASSE
       CESSA
ACEST: ACTES
       CASTE
       CATES
       ECSTA
ACESU: CAUSE
       SAUCE
       SCEAU
ACESV: CAVES
ACESY: CAYES
ACESZ: CASEZ
ACETT: TACET
ACETV: CAVET
ACETX: EXACT
ACETZ: ACTEZ
ACEUV: CUEVA
ACEUY: CAYEU
ACEVZ: CAVEZ
ACFHI: FICHA
ACFHO: FACHO
ACFIN: CANIF
ACFIR: FARCI
ACFIT: ACTIF
ACFLN: FLANC
ACFLO: FOCAL
ACFLS: CALFS
ACFNO: FACON
       FONCA
ACFNR: FRANC
ACFNY: FANCY
ACFOR: FORCA
ACFOT: FACTO
ACFRS: FRACS
ACFTU: CUFAT
ACGIL: GICLA
ACGNO: COGNA
       CONGA
ACGOR: CARGO
ACGOT: CAGOT
ACGOU: CAGOU
ACHHO: HOCHA
ACHHS: CHAHS
       HACHS
       HASCH
       SCHAH
ACHHU: HUCHA
ACHII: CHIAI
ACHIL: LICHA
ACHIN: CHINA
       NICHA
ACHIP: CHIPA
ACHIR: ARCHI
       CHAIR
       RACHI
ACHIS: CHAIS
       CHIAS
ACHIT: CHIAT
ACHJU: JUCHA
ACHKR: KRACH
ACHLO: LOCHA
ACHLS: CLASH
ACHMO: CHOMA
       MACHO
ACHMP: CHAMP
ACHMT: MATCH
ACHMU: MUCHA
ACHNO: NACHO
ACHNR: RANCH
ACHNS: CHANS
ACHNT: CHANT
       TCHAN
ACHOP: CHAPO
       CHOPA
       PHACO
       POCHA
ACHOR: RACHO
       ROCHA
ACHOS: CHAOS
       HOCAS
ACHOT: CAHOT
       CATHO
       TCHAO
ACHOY: CHOYA
ACHPT: PATCH
ACHRS: ARCHS
       CHARS
       CRASH
ACHRU: RUCHA
ACHSS: CASHS
ACHST: CHATS
ACHSV: CHVAS
ACHSW: SCHWA
ACHTT: TCHAT
ACHTU: CHAUT
       CHUTA
ACHTY: YACHT
ACHUX: CHAUX
ACIIN: ACINI
ACIIR: CIRAI
       CRIAI
ACIIS: SCIAI
ACIIT: CITAI
ACIIV: VICIA
ACIKT: CAKTI
ACILL: CILLA
ACILM: CALMI
       CLAIM
ACILN: CALIN
ACILP: CIPAL
       CLAPI
ACILR: CLAIR
       LIRAC
ACILS: LACIS
       LAICS
       SICLA
       SLICA
ACILT: TICAL
ACILU: CULAI
ACILV: CLIVA
ACIMN: NICAM
ACIMS: MACIS
       MICAS
ACIMT: AMICT
ACINN: CANIN
ACINO: CAION
       NOCAI
ACINP: PANIC
       PINCA
ACINR: CAIRN
       RANCI
       RINCA
ACINS: INCAS
ACINT: CATIN
ACINV: VAINC
ACIOP: COPIA
ACIOR: AIRCO
       OCRAI
ACIOT: COATI
       COITA
       COTAI
ACIOX: COXAI
ACIPS: ASPIC
       PICAS
       SPICA
ACIPU: PUCAI
ACIRS: CARIS
       CIRAS
       CRIAS
       CRISA
ACIRT: CATIR
       CIRAT
       CRIAT
ACIRU: CAURI
       CUIRA
       CURAI
ACIRV: CARVI
ACISS: ASICS
       SCIAS
ACIST: ASTIC
       CATIS
       CITAS
       SCIAT
ACISU: SUCAI
ACISV: SICAV
ACITT: CATIT
       CITAT
ACITU: CUITA
ACIUV: CUVAI
ACJKS: JACKS
ACJNO: AJONC
       JONCA
ACJNU: CAJUN
ACJOS: JACOS
ACJOT: JACOT
ACJOU: CAJOU
ACKKN: KNACK
ACKLR: CLARK
ACKLS: LACKS
ACKMS: SMACK
ACKNS: SNACK
ACKPS: PACKS
ACKRS: RACKS
ACKST: TACKS
ACKSY: YACKS
ACLLO: ALLOC
       COLLA
       LOCAL
ACLLS: CALLS
ACLMP: CLAMP
ACLMS: CLAMS
ACLNO: CLONA
ACLNS: CLANS
ACLNU: NUCAL
ACLOO: ALOCO
ACLOP: CLOPA
       COPAL
       COPLA
ACLOR: CLORA
       CROLA
ACLOS: CALOS
       COLAS
ACLOT: CALOT
       OCTAL
ACLOU: CLOUA
       COULA
ACLOV: VOCAL
ACLOX: COXAL
ACLOZ: COLZA
ACLPS: CLAPS
       SCALP
ACLRW: CRAWL
ACLRY: LYCRA
ACLST: TALCS
ACLSU: ACULS
       CALUS
       CULAS
ACLSY: CLAYS
ACLTU: CULAT
ACMMO: COMMA
ACMNO: MACON
ACMOP: CAMPO
ACMOR: MACRO
ACMOS: COMAS
ACMPS: CAMPS
ACMRS: MARCS
ACMSU: CAMUS
       SUMAC
ACMUV: CAVUM
ACNNO: CANON
ACNOP: CAPON
       PONCA
ACNOR: ARCON
       CORAN
       CORNA
       NARCO
ACNOS: ACONS
       NOCAS
ACNOT: CANOT
       CONTA
       NOCAT
       TACON
       TONCA
ACNOY: CAYON
ACNRS: CRANS
ACNSS: SCANS
ACNST: CANTS
ACNSU: CANUS
ACNSY: CYANS
ACNTU: CANUT
ACNUU: AUCUN
ACOPP: COPPA
ACOPR: COPRA
ACOPS: CAPOS
       POSCA
       SCOPA
ACOPT: CAPOT
ACOPU: COUPA
       POUCA
ACORS: CORSA
       OCRAS
       OSCAR
       SCORA
ACORT: OCRAT
ACOSS: COSSA
ACOST: COTAS
       OCTAS
       SCATO
       TACOS
ACOSX: COXAS
ACOTT: COTAT
       COTTA
       TACOT
ACOTU: COUTA
ACOTX: COXAT
ACOUV: COUVA
ACOUY: COYAU
ACPRS: CRAPS
       PARCS
ACPSU: PUCAS
ACPTU: PUCAT
ACRRY: CARRY
ACRST: TRACS
ACRSU: CRAUS
       CURAS
       SUCRA
ACRSV: VRACS
ACRSY: CARYS
ACRSZ: CZARS
ACRTT: TRACT
ACRTU: CURAT
ACRUX: CRAUX
ACSST: SCATS
ACSSU: SUCAS
ACSSY: SACYS
ACSTT: TACTS
ACSTU: ACTUS
       SCUTA
       SUCAT
ACSUV: CUVAS
ACTUV: CUVAT
ADDEI: DEDIA
ADDER: DARDE
ADDEY: DYADE
ADDNY: DANDY
ADDPY: PADDY
ADDRS: DARDS
ADEEF: FADEE
ADEEI: AIDEE
ADEEL: DEALE
ADEEM: DAMEE
ADEEN: ADNEE
ADEER: RADEE
ADEES: AEDES
ADEET: DATEE
ADEEV: EVADE
ADEFI: DEFIA
ADEFR: FADER
       FARDE
ADEFS: FADES
ADEFT: FADET
ADEFZ: FADEZ
ADEGJ: GADJE
ADEGR: EGARD
       GARDE
       GRADE
ADEGS: GADES
ADEGT: DEGAT
ADEGU: DAGUE
       GAUDE
ADEHL: HALDE
ADEHR: HARDE
ADEIL: DELAI
       DELIA
       ELIDA
       IDEAL
       LAIDE
ADEIM: AMIDE
       MEDIA
ADEIN: DAINE
       DENIA
       DIANE
ADEIP: APIDE
ADEIR: ADIRE
       AIDER
       ARIDE
       DRAIE
       RADIE
       RAIDE
ADEIS: AIDES
       DIESA
ADEIT: EDITA
ADEIU: ADIEU
ADEIV: AVIDE
       DEVIA
       EVIDA
ADEIZ: AIDEZ
ADEJR: JARDE
ADEJS: JADES
ADELL: DALLE
ADELN: ELAND
       LANDE
ADELP: PADEL
ADELR: LADRE
       LARDE
ADELS: DEALS
ADELT: DELTA
       TALED
ADELU: ADULE
       DUALE
       ELUDA
ADEMN: DAMNE
       MANDE
ADEMR: DAMER
       DRAME
       MADRE
       MERDA
ADEMS: DAMES
       EDAMS
ADEMT: ADMET
ADEMZ: DAMEZ
ADENO: ANODE
ADENP: EPAND
ADENR: DARNE
       DENAR
       REDAN
ADENS: ADNES
       DANSE
       SEDAN
ADENT: ADENT
       DENTA
ADENU: DENUA
ADENV: VENDA
ADEOP: APODE
ADEOR: ADORE
       ERODA
ADEPR: DRAPE
       PADRE
ADEPZ: PEDZA
ADERR: RADER
ADERS: DARSE
       RADES
       SARDE
ADERT: ADRET
       DATER
       TARDE
ADERU: ARDUE
       RUADE
ADERV: DEVRA
       DRAVE
ADERW: DEWAR
ADERY: DRAYE
ADERZ: RADEZ
ADEST: DATES
       STADE
ADESV: VEDAS
ADETT: DATTE
ADETU: TAUDE
ADETZ: DATEZ
       DZETA
ADFFI: DIFFA
ADFIT: DATIF
ADFNO: FONDA
ADFOS: FADOS
ADFRS: FARDS
ADFRT: DRAFT
ADGIJ: GADJI
ADGIN: GADIN
ADGIO: GODAI
ADGIU: GAUDI
       GUIDA
ADGJO: GADJO
ADGLN: GLAND
ADGNO: GONDA
ADGNR: GNARD
       GRAND
ADGOS: GODAS
ADGOT: DOGAT
       GODAT
ADGOU: GOUDA
ADGRS: DRAGS
ADHIJ: HADJI
       JIHAD
ADHIM: MAHDI
ADHIR: DAHIR
       HARDI
ADHIS: DASHI
ADHJS: HADJS
ADHLS: DAHLS
       DHALS
ADHNS: HANDS
ADHOS: DOSHA
ADHRS: HARDS
ADHRU: HUARD
ADHSU: DAHUS
       SADHU
ADIIN: DINAI
ADIIO: IODAI
ADIIR: DIRAI
       RAIDI
       RIDAI
ADIIV: VIDAI
ADIIW: WIDIA
ADIJN: DJAIN
ADIJS: JADIS
ADIKN: DAKIN
       DINKA
ADIKS: KADIS
ADILN: ALDIN
       LADIN
ADILO: DIOLA
       DOLAI
       IODLA
ADILP: PLAID
ADILR: LAIRD
       LIARD
       LIDAR
ADILS: DAILS
       DIALS
       LAIDS
ADILT: DALIT
ADILU: DILUA
ADIMN: ADMIN
ADIMR: MARDI
ADIMS: ADMIS
       DAIMS
       DIAMS
ADIMT: ADMIT
ADINN: ANDIN
ADINO: DANIO
       DOINA
ADINR: DINAR
       DRAIN
       NADIR
       RADIN
ADINS: DINAS
       NIDAS
ADINT: DINAT
ADINV: DIVAN
ADINW: DIWAN
ADIOP: DIAPO
       DOPAI
       PODIA
ADIOR: DORAI
       RADIO
       RODAI
ADIOS: DOSAI
       IODAS
ADIOT: DOTAI
       IODAT
ADIOU: AUDIO
       DOUAI
ADIPR: PARDI
ADIPU: DUPAI
ADIRS: DARIS
       DIRAS
       ISARD
       RADIS
       RAIDS
       RIADS
       RIDAS
ADIRT: RIDAT
ADIRU: DURAI
ADIRV: DRIVA
ADISS: SIDAS
ADISV: DIVAS
       VIDAS
ADITU: AUDIT
       DUITA
ADITV: VIDAT
ADJLO: JODLA
ADJRS: JARDS
ADJSU: JUDAS
ADKKO: KODAK
ADKNU: DUNKA
ADKOV: VODKA
ADLLO: ALDOL
ADLMO: DOLMA
       MODAL
ADLNO: NODAL
ADLNS: LANDS
ADLOP: PODAL
ADLOS: DOLAS
       SOLDA
ADLOT: DALOT
       DOLAT
       DOTAL
ADLOU: DOULA
ADLOY: YODLA
ADLPU: PALUD
ADLRS: LARDS
ADLRU: DURAL
ADLSU: DUALS
ADLSY: LADYS
ADMNO: MONDA
ADMNU: MUNDA
ADMOU: DOUMA
ADMRS: DRAMS
ADMRU: MUDRA
ADNNO: DONNA
ADNOR: DARON
       RADON
       RANDO
ADNOS: ADONS
       DONAS
       SONDA
ADNOU: DONAU
ADNOX: DONAX
ADNQU: QUAND
ADNRS: NARDS
       RANDS
ADNST: STAND
ADOPR: DROPA
ADOPS: DOPAS
ADOPT: DOPAT
ADOPU: PADOU
ADOQU: QUADO
ADORS: DORAS
       RODAS
       SAROD
ADORT: DORAT
       RODAT
ADORU: DOUAR
ADOSS: DOSAS
       SADOS
       SODAS
ADOST: DOSAT
       DOTAS
ADOSU: DOUAS
       SOUDA
ADOSX: DOXAS
ADOTT: DOTAT
ADOTU: DOUAT
       DOUTA
ADOXY: OXYDA
ADPRS: DRAPS
ADPSU: DUPAS
ADPTU: DUPAT
ADQSU: QUADS
ADQUU: DUQUA
ADRSU: ARDUS
       DURAS
       SUDRA
ADRSY: RYADS
       YARDS
ADRTU: DURAT
ADSTU: TAUDS
ADSUW: DAUWS
ADUUX: DUAUX
AEEER: AEREE
AEEFL: FEALE
AEEFM: FAMEE
AEEFN: FANEE
AEEFX: FAXEE
AEEGG: GAGEE
AEEGI: EGAIE
AEEGK: GEEKA
AEEGL: EAGLE
       EGALE
AEEGN: NAGEE
AEEGP: PAGEE
       PEAGE
AEEGR: AGREE
       EGARE
       GAREE
AEEGS: AGEES
AEEGT: ETAGE
       GATEE
AEEGU: AUGEE
AEEGV: GAVEE
AEEGY: EGAYE
AEEGZ: GAZEE
AEEHL: HALEE
AEEHT: ATHEE
       HATEE
AEEHV: HAVEE
       HEVEA
AEEIL: AILEE
AEEIM: AIMEE
AEEIN: AINEE
AEEIR: AIREE
AEEIS: AISEE
AEEIT: ETAIE
AEEJS: JASEE
AEEKN: AKENE
AEELL: ALLEE
AEELM: ALMEE
       LAMEE
AEELN: ALENE
AEELP: ALPEE
       EPELA
       LAPEE
       PALEE
AEELR: REALE
AEELS: ALESE
       SALEE
AEELT: ATELE
       ETALE
       TALEE
AEELV: ELAVE
       ELEVA
       LAVEE
AEELW: AWELE
AEELY: LAYEE
AEELZ: ALEZE
AEEMM: MAMEE
AEEMN: AMENE
       EMANE
       ENEMA
AEEMP: PAMEE
AEEMR: AMERE
       ARMEE
       MAREE
       RAMEE
AEEMT: ETAME
       MATEE
AEEMX: EXEMA
AEEMZ: MAZEE
AEENN: ANNEE
AEENP: APNEE
       NAPEE
       PANEE
AEENR: ARENE
AEENS: ANEES
       ANSEE
AEENU: AUNEE
AEENX: AXENE
AEEPR: PAREE
       RAPEE
AEEPS: SAPEE
AEEPT: EPATE
       ETAPE
       PATEE
       TAPEE
AEEPV: EPAVE
       PAVEE
AEEPY: PAYEE
AEERR: AERER
       REERA
AEERS: AERES
       RASEE
AEERT: ARETE
       RATEE
       TAREE
AEERV: AVERE
AEERY: RAYEE
AEERZ: AEREZ
AEESV: EVASE
       VASEE
AEESX: AXEES
AEETT: ETETA
       TATEE
AEETX: EXEAT
       TAXEE
AEETY: ETAYE
AEFFG: GAFFE
AEFFM: MAFFE
AEFFT: TAFFE
AEFGI: FIGEA
AEFGN: FAGNE
       FANGE
AEFIL: FELAI
AEFIM: MEFIA
AEFIN: FAINE
AEFIR: FAIRE
       FERAI
       FERIA
       FIERA
       FRAIE
AEFIT: FAITE
       FETAI
AEFKN: KENAF
AEFKR: FRAKE
       FREAK
AEFKS: FAKES
AEFKT: KEFTA
AEFLL: FALLE
AEFLN: ENFLA
       FLANE
AEFLR: FERAL
       FERLA
       RAFLE
AEFLS: FELAS
AEFLT: FELAT
       TEFAL
AEFLU: FEULA
       FLEAU
AEFMR: FERMA
AEFMS: FAMES
       MAFES
AEFNR: FANER
AEFNS: FANES
       NAFES
AEFNU: FAUNE
AEFNZ: FANEZ
AEFOV: FOVEA
AEFPR: FRAPE
AEFRR: FERRA
AEFRS: FARES
       FERAS
       FRASE
       SAFRE
AEFRT: AFTER
       FARTE
       FRETA
AEFRX: FAXER
AEFRY: FRAYE
AEFSS: FASSE
       FESSA
AEFST: FASTE
       FATES
       FEATS
       FETAS
AEFSX: FAXES
AEFTT: FETAT
AEFTU: FAUTE
AEFUV: FAUVE
AEFUX: FEAUX
AEFXZ: FAXEZ
AEGGN: GAGNE
AEGGO: GOGEA
AEGGR: AGREG
       GAGER
AEGGS: GAGES
AEGGT: TAGGE
AEGGZ: GAGEZ
AEGHP: PHAGE
AEGIL: AGILE
       AIGLE
       ALGIE
       GELAI
       LIAGE
AEGIM: IGAME
       IMAGE
       MAGIE
AEGIN: AGNIE
       GAINE
       GENAI
AEGIP: PIGEA
AEGIR: AIGRE
       GERAI
       GREAI
       REAGI
AEGIS: AGIES
       GAIES
       GEAIS
AEGIT: AGITE
       GAITE
       TIGEA
AEGIU: AIGUE
       GUEAI
AEGIX: IXAGE
AEGIZ: GAIZE
AEGJU: JAUGE
       JUGEA
AEGLL: GALLE
       LEGAL
AEGLN: AGNEL
       ANGLE
       GENAL
       GLANE
       GLENA
       LANGE
AEGLO: LOGEA
AEGLP: PAGEL
       PLAGE
AEGLR: GRALE
       GRELA
       LAGER
       LARGE
       REGAL
       REGLA
AEGLS: GALES
       GELAS
AEGLT: GALET
       GELAT
       LEGAT
AEGLU: ALGUE
       GAULE
       LEGUA
       LUGEA
AEGMM: GAMME
       GEMMA
AEGMN: MAGNE
       MANGE
AEGMO: OMEGA
AEGMR: GAMER
       GERMA
       MARGE
AEGMS: MAGES
       MEGAS
AEGMT: GAMET
       TAGME
AEGNP: PAGNE
AEGNR: GENRA
       GRENA
       NAGER
       RANGE
       REGNA
AEGNS: ANGES
       GANSE
       GENAS
       NAGES
AEGNT: AGENT
       ETANG
       GANTE
       GEANT
       GENAT
AEGNU: NUAGE
AEGNV: VEGAN
AEGNZ: NAGEZ
AEGOR: ORAGE
AEGOT: OTAGE
AEGPR: PAGER
       PAGRE
AEGPS: PAGES
AEGPU: GAUPE
       PEGUA
AEGPZ: PAGEZ
AEGRR: GARER
       RAGER
AEGRS: AGRES
       GARES
       GERAS
       GREAS
       GRESA
       RAGES
AEGRT: GATER
       GERAT
       GREAT
       TARGE
AEGRU: ARGUE
       RAGUE
       URGEA
AEGRV: GAVER
       GRAVE
       GREVA
AEGRZ: GAREZ
       GAZER
       RAGEZ
AEGSS: SAGES
       SEGAS
AEGST: GATES
       STAGE
AEGSU: AUGES
       GUEAS
       SAUGE
       SUAGE
       USAGE
AEGSV: GAVES
AEGSX: SAGEX
AEGSZ: GAZES
AEGTT: GATTE
AEGTU: AUGET
       GUEAT
       TAGUE
       TUAGE
AEGTZ: GATEZ
AEGUV: VAGUE
AEGUX: EGAUX
AEGVZ: GAVEZ
AEGZZ: GAZEZ
AEHIL: HELAI
AEHIN: HAINE
AEHIR: HAIRE
       HIERA
AEHIS: HAIES
AEHIT: THAIE
AEHIV: HAVIE
AEHJS: HAJES
AEHLL: HALLE
AEHLP: ALEPH
AEHLR: HALER
       HARLE
AEHLS: HALES
       HELAS
       SAHEL
AEHLT: ATHLE
       HALTE
       HELAT
AEHLZ: HALEZ
AEHMP: HAMPE
AEHMR: HAREM
AEHNS: HANSE
AEHNT: ANETH
       HANTE
       THANE
AEHPP: HAPPE
AEHPR: HARPE
       PHARE
       RAPHE
AEHPS: PHASE
AEHPT: APHTE
AEHRS: HERSA
AEHRT: HARET
       HATER
AEHRU: HUERA
AEHRV: HAVER
       HAVRE
AEHSS: HASES
AEHST: HASTE
       HATES
AEHSV: HAVES
AEHTT: THETA
AEHTU: HAUTE
AEHTZ: HATEZ
AEHVZ: HAVEZ
AEIIL: ELIAI
AEIIM: EMIAI
AEIIP: EPIAI
AEIJN: JAINE
AEIJT: JETAI
AEIKM: KEMIA
AEILL: AILLE
       ALLIE
       ILEAL
AEILM: ELIMA
       EMAIL
       LAMIE
       MELAI
       MELIA
AEILN: ALIEN
       ENLIA
       LAINE
       LIANE
AEILP: EPILA
       LAPIE
       PALIE
       PELAI
       PLAIE
AEILR: ELIRA
       LIERA
       RELAI
       RELIA
AEILS: AILES
       ALISE
       ASILE
       ELIAS
       LAIES
       LESAI
       SALIE
AEILT: ALITE
       ELIAT
       LAITE
AEILU: AIEUL
       ELUAI
AEILV: ALEVI
       LEVAI
       VELAI
AEILX: AXILE
       EXILA
AEILZ: ALIZE
       LAIZE
AEIMM: IMAME
       MAMIE
AEIMN: AMINE
       ANIME
       MANIE
       MENAI
AEIMR: AIMER
       MAIRE
       MARIE
       RAMIE
AEIMS: AIMES
       AMIES
       EMIAS
       MAIES
       SAMIE
       SEMAI
AEIMT: ATEMI
       EMIAT
       MATIE
AEIMU: AMUIE
AEIMZ: AIMEZ
AEINN: NAINE
AEINP: EPINA
       PAIEN
       PEINA
AEINR: ANIER
       ARIEN
       NIERA
       RAINE
       RENIA
AEINS: AINES
       ANISE
       ASINE
       SAINE
       SANIE
AEINT: AIENT
       ANITE
       ENTAI
       ETAIN
       INEAT
       TENIA
AEINV: AVIEN
       AVINE
       ENVIA
       NAEVI
       NAIVE
       VAINE
       VEINA
AEINZ: NAZIE
AEIOV: AVOIE
AEIPP: PEPIA
AEIPR: EPAIR
       PAIRE
       PARIE
AEIPS: EPAIS
       EPIAS
       PAIES
       PESAI
       SEPIA
AEIPT: EPIAT
       PETAI
       PIETA
       TAPIE
AEIPV: PAVIE
AEIPX: EXPIA
AEIRR: AIRER
       ERRAI
       RAIRE
AEIRS: AIRES
       ARISE
       RAIES
       REAIS
       SERAI
       SERIA
       SIERA
AEIRT: ETIRA
       ITERA
       REAIT
       TAIRE
       TARIE
       TIARE
       TRAIE
AEIRV: RAVIE
       REVAI
       VAIRE
       VARIE
       VRAIE
AEIRX: IXERA
AEIRZ: AIREZ
       AZERI
       ZAIRE
AEISS: AISES
       ESSAI
       SAIES
AEIST: ETAIS
       SAITE
       TAIES
       TAISE
AEISV: AVISE
AEISX: SEXAI
AEITT: ETAIT
       TATIE
       TETAI
AEITV: EVITA
AEITX: TAXIE
AEIUX: AIEUX
AEIVV: AVIVE
AEIVX: VEXAI
AEIVZ: AVIEZ
AEIXZ: AXIEZ
AEJKR: JERKA
AEJLS: JALES
AEJLT: TJALE
AEJLV: JAVEL
AEJMS: MAJES
AEJNS: JEANS
AEJNT: JANTE
AEJNU: JAUNE
       JEUNA
AEJPP: JAPPE
AEJPS: JASPE
AEJQU: JAQUE
AEJRR: JARRE
AEJRS: JASER
AEJRT: JARTE
AEJSS: JASES
       JASSE
AEJST: JETAS
AEJSZ: JASEZ
AEJTT: JATTE
       JETAT
AEJTY: JAYET
AEJZZ: JAZZE
AEKLS: KALES
AEKMR: KERMA
AEKNP: PEKAN
AEKNR: KAREN
AEKNS: KENAS
AEKSS: SAKES
AEKST: SKATE
       STEAK
AEKSU: UKASE
AELLM: MALLE
AELLP: PALLE
       PELLA
AELLR: ALLER
       RALLE
AELLS: ALLES
       SALLE
       SELLA
AELLT: LETAL
       TALLE
AELLU: ALLEU
       ALULE
AELLZ: ALLEZ
AELMP: AMPLE
       LAMPE
       PALME
AELMR: LAMER
       LARME
       MAERL
       MARLE
AELMS: ALEMS
       LAMES
       MALES
       MELAS
       SLAME
AELMT: MALTE
       MELAT
       METAL
AELMU: EMULA
       MEULA
       ULEMA
AELMY: AMYLE
AELMZ: LAMEZ
AELNP: NAPEL
       PANEL
       PENAL
       PLANE
AELNR: RENAL
AELNS: ANELS
       ELANS
AELNT: NATEL
AELNU: ALUNE
       AULNE
AELNV: NAVEL
       VENAL
AELOP: OPALE
       POELA
AELOR: AROLE
       ORALE
AELOS: ALOES
       ALOSE
       LOASE
       SOLEA
AELOV: OVALE
AELPP: APPEL
       PALPE
AELPR: ALPER
       LAPER
       PARLE
       PERLA
AELPS: ALPES
       ASPLE
       LAPES
       LAPSE
       PALES
       PELAS
       SALEP
       SALPE
AELPT: LEPTA
       PALET
       PELAT
       PELTA
       PLATE
AELPZ: ALPEZ
       LAPEZ
AELQU: LAQUE
AELRR: RALER
AELRS: LARES
       LASER
       RALES
       REALS
       SALER
AELRT: ALTER
       ARTEL
       RATEL
       TALER
AELRU: LAURE
AELRV: LARVE
       LAVER
       VELAR
AELRX: RELAX
AELRY: ARYLE
       LAYER
AELRZ: ARZEL
       RALEZ
AELSS: LASSE
       LESAS
       SALES
       SALSE
AELST: ETALS
       LESAT
       LESTA
       TAELS
       TALES
       TESLA
AELSU: ELUAS
       LAUSE
       SALUE
       SAULE
AELSV: LAVES
       LEVAS
       SALVE
       SELVA
       SLAVE
       VALSE
       VELAS
AELSW: WALES
AELSX: AXELS
AELSY: LAYES
AELSZ: LAZES
       SALEZ
AELTT: LATTE
       TALET
AELTU: AUTEL
       ELUAT
       TAULE
AELTV: LEVAT
       TAVEL
       VALET
       VELAT
AELTX: LATEX
AELTY: ALYTE
AELTZ: TALEZ
AELUV: UVALE
       VALUE
AELUZ: LAUZE
AELVV: VALVE
AELVZ: LAVEZ
       VALEZ
AELYZ: LAYEZ
AEMMO: AMOME
AEMMS: MAMES
AEMMT: MAMET
AEMNN: MANNE
AEMNP: EMPAN
AEMNR: MARNE
       RAMEN
AEMNS: MANES
       MANSE
       MENAS
AEMNT: MANTE
       MENAT
AEMNY: MAYEN
AEMOR: AROME
AEMOT: ATOME
AEMPP: MAPPE
AEMPR: APREM
       PAMER
       PARME
       PRAME
       RAMPE
AEMPS: PAMES
AEMPU: PAUME
AEMPV: VAMPE
AEMPZ: PAMEZ
AEMQU: MAQUE
AEMRR: ARMER
       MARRE
       RAMER
AEMRS: AMERS
       ARMES
       MARES
       MASER
       RAMES
AEMRT: ARMET
       MARTE
       MATER
       METRA
       TRAME
       TREMA
AEMRU: AMURE
       MAURE
       MUERA
       REMUA
AEMRZ: ARMEZ
       MAZER
       RAMEZ
AEMSS: MASSE
       MESAS
       SAMES
       SEMAS
AEMST: MASET
       MATES
       MEATS
       METAS
       SEMAT
       TEAMS
AEMSU: AMUSE
AEMSX: EXAMS
AEMSY: MAYES
       MYASE
AEMSZ: MAZES
AEMTT: MATTE
AEMTZ: MATEZ
       MAZET
AEMUV: MAUVE
AEMUX: EMAUX
AEMYZ: AZYME
AEMZZ: MAZEZ
AENNO: ANONE
AENNP: PANNE
AENNT: NEANT
       TANNE
AENNV: VANNE
AENOT: ATONE
AENOU: ENOUA
AENOV: NOVAE
AENOX: AXONE
AENPP: NAPPE
AENPR: PANER
AENPS: PANES
       PANSE
       PEANS
       PENSA
AENPT: PANTE
AENPZ: PANEZ
AENQU: QUENA
AENRR: NARRE
AENRS: NARSE
       SERAN
AENRT: ANTRE
       ENTRA
       REANT
       RENTA
AENRU: AUNER
       NUERA
       URANE
AENRV: NAVRE
AENRY: ARYEN
AENSS: ANSES
       NASES
       NASSE
       SENSA
AENST: ANTES
       ENTAS
       SANTE
       SEANT
       SENAT
AENSU: AUNES
       SAUNE
       SENAU
AENSV: AVENS
       NAVES
       SANVE
AENSZ: NAZES
AENTT: ENTAT
       ETANT
       NATTE
       TANTE
       TENTA
AENTV: AVENT
       NAVET
       VANTE
       VENTA
AENTX: AXENT
       TEXAN
AENUV: AVENU
AENUZ: AUNEZ
AENZZ: ZAZEN
AEOPR: APERO
       OPERA
       PAREO
AEOPS: PASEO
AEORS: OSERA
AEORT: AORTE
       OTERA
       TOREA
AEORZ: AZORE
AEOTU: AOUTE
       OUATE
AEOTV: OVATE
AEOTZ: AZOTE
AEOUV: AVOUE
AEOVY: AVOYE
AEPPR: PREPA
       RAPPE
AEPPS: PAPES
AEPPT: PAPET
AEPPZ: ZAPPE
AEPQU: PAQUE
AEPRR: PARER
       RAPER
AEPRS: APRES
       ASPRE
       EPARS
       ESPAR
       PARES
       PARSE
       PRASE
       RAPES
       REPAS
       SAPER
       SPARE
AEPRT: EPART
       PARTE
       PATER
       PATRE
       PRETA
       TAPER
AEPRU: APURE
       EPURA
       PARUE
       PREAU
       PUERA
AEPRV: PAVER
AEPRY: APYRE
       PAYER
AEPRZ: PAREZ
       RAPEZ
AEPSS: ASPES
       PASSE
       PESAS
       SAPES
AEPST: APTES
       PATES
       PESAT
       PESTA
       PETAS
       TAPES
AEPSU: PAUSE
       SAUPE
AEPSV: PAVES
       VAPES
       VESPA
AEPSY: PAYES
       PAYSE
AEPSZ: SAPEZ
AEPTT: PATTE
       PETAT
AEPTU: TAUPE
AEPTX: EXPAT
AEPTZ: TAPEZ
AEPUX: PEAUX
AEPVZ: PAVEZ
AEPYZ: PAYEZ
AEQRU: ARQUE
       RAQUE
AEQSU: ASQUE
       SAQUE
AEQTU: QUETA
       TAQUE
AEQUV: VAQUE
AERRS: ERRAS
       RARES
       RASER
       SERRA
AERRT: ARRET
       ERRAT
       RATER
       TARER
       TERRA
AERRU: RUERA
AERRV: RAVER
       VERRA
AERRY: RAYER
AERSS: RASES
       RESAS
       SERAS
AERST: ASTER
       ASTRE
       ATRES
       RATES
       RESTA
       SETAR
       STERA
       TARES
       TARSE
       TASER
       TERSA
AERSU: SAURE
       SUERA
       USERA
AERSV: AVERS
       RAVES
       REVAS
       SEVRA
       VASER
       VERSA
AERSY: EYRAS
       RAYES
AERSZ: RASEZ
AERTT: RATTE
       TARET
       TARTE
       TATER
       TETRA
AERTU: AUTRE
       TAURE
       TUERA
       URATE
AERTV: REVAT
AERTW: WATER
AERTX: EXTRA
       TAXER
AERTZ: RATEZ
       TAREZ
AERUX: REAUX
AERUZ: AUREZ
       AZURE
AERVV: VARVE
AERYZ: RAYEZ
AESSS: ASSES
       SASSE
AESST: ASTES
       SATES
       STASE
       TASSE
AESSV: VASES
       VESSA
AESSX: SAXES
       SEXAS
AESSY: YASSE
AESSZ: ASSEZ
AESTT: ETATS
       TATES
       TESTA
       TETAS
AESTU: SAUTE
AESTV: VASTE
AESTW: SWEAT
AESTX: SEXAT
       SEXTA
       TAXES
AESTZ: ZESTA
       ZETAS
AESUV: SAUVE
       SUAVE
AESUX: SEAUX
AESVX: VEXAS
AESVZ: SAVEZ
       VASEZ
AETTT: TETAT
AETTW: WATTE
AETTX: TEXTA
AETTZ: TATEZ
AETUV: ETUVA
AETUX: ETAUX
AETVX: VEXAT
AETXZ: TAXEZ
AEUVX: AVEUX
       VEAUX
AFFGR: GRAFF
AFFIK: KIFFA
AFFIN: AFFIN
AFFIP: PIFFA
AFFLU: LUFFA
AFFST: STAFF
AFFTU: AFFUT
AFGIL: GIFLA
AFGLO: GOLFA
       OFLAG
AFGLS: FLAGS
AFGNS: FANGS
AFGOT: FAGOT
AFGRS: GRAFS
AFGUU: FUGUA
AFHIT: HATIF
AFHLS: FLASH
AFHNO: FOHNA
AFHRW: WHARF
AFIIK: KIFAI
AFIIL: FILAI
AFIIP: PIFAI
AFIIS: FIAIS
AFIIT: FIAIT
AFIIX: FIXAI
AFIKR: FAKIR
       KAFIR
AFIKS: KIFAS
AFIKT: KIFAT
AFILM: FILMA
AFILN: FINAL
AFILO: FILAO
       LOFAI
AFILP: FLAPI
       PILAF
AFILR: FLAIR
       RIFLA
AFILS: FILAS
AFILT: FILAT
       LATIF
       LIFTA
AFILU: FLUAI
AFIMN: MANIF
AFIMR: FRIMA
AFIMS: FAIMS
AFIMT: MATIF
AFIMU: FUMAI
AFINN: ANNIF
AFINR: INFAR
       INFRA
AFINS: NAIFS
       SNIFA
AFINT: FIANT
       FITNA
       NATIF
AFIOR: FARIO
       FOIRA
       FORAI
AFIPR: FRIPA
AFIPS: PIAFS
       PIFAS
AFIPT: PIFAT
AFIRR: FRIRA
AFIRS: FARSI
       FRAIS
       FRISA
AFIRT: FRITA
       IFTAR
       TARIF
AFIRU: FUIRA
       FURIA
AFISS: FASSI
       FISSA
AFIST: FAITS
AFISU: FUSAI
       SUIFA
AFISX: FIXAS
AFITT: FITTA
AFITU: FUITA
AFITX: FIXAT
AFKLT: KLAFT
AFKRT: KRAFT
AFLLU: FALLU
AFLMO: MOFLA
AFLNS: FLANS
AFLNU: FALUN
AFLOO: LOOFA
AFLOR: FROLA
AFLOS: LOFAS
AFLOT: FALOT
       LOFAT
AFLOU: FLOUA
       FOULA
AFLST: FLATS
AFLSU: FLUAS
AFLTU: FLUAT
       FLUTA
       FUTAL
AFLUX: FLUXA
AFMNU: FANUM
AFMOR: FORMA
AFMSU: FUMAS
AFMTU: FATUM
       FUMAT
AFNNO: FANON
AFNNY: FANNY
AFNOS: FAONS
AFNOT: TONFA
AFORS: AFROS
       FAROS
       FORAS
AFORT: FORAT
AFORU: FROUA
AFOSS: FOSSA
       SOFAS
AFOSU: SAFOU
AFOTU: FOUTA
AFOTY: FAYOT
AFQSW: WAQFS
AFRST: FARTS
       RAFTS
AFRSU: SURFA
AFRUX: FURAX
AFSSU: FUSAS
       SAUFS
AFSTU: FUSAT
AFSUV: FAVUS
AGGIS: GIGAS
AGGIU: GIGUA
AGGJO: JOGGA
AGGLO: AGGLO
AGGNS: GANGS
AGHMO: OGHAM
AGHNO: HOGAN
AGHOT: GOTHA
AGIIR: AIGRI
AGIIT: GITAI
AGILL: GLIAL
AGILN: LIGNA
       LINGA
AGILP: GLAPI
AGILT: GLATI
AGILU: GLUAI
       LIGUA
AGIMN: GAMIN
AGIMO: AMIGO
       IMAGO
AGIMR: GRIMA
       MIGRA
AGIMS: SIGMA
AGINO: AGONI
AGINP: PIGNA
AGINR: GARNI
       GRAIN
AGINS: AGNIS
       GAINS
       NAGIS
       SIGNA
AGINT: GITAN
AGINV: VAGIN
AGINX: XIANG
AGIOS: AGIOS
AGIPS: GASPI
AGIPU: GUIPA
AGIRS: GARIS
       GRISA
AGIRT: TIGRA
AGIRV: GIVRA
       GRAVI
       VAGIR
AGIST: GITAS
AGISU: AGUIS
       AIGUS
       GUAIS
AGISV: VAGIS
AGITT: GITAT
AGITV: VAGIT
AGJLU: JUGAL
AGKOP: GOPAK
AGKOU: KAGOU
AGKOW: GWOKA
AGLLO: ALGOL
       GALLO
AGLMO: LAGOM
AGLMS: GLAMS
AGLNO: GALON
       LAGON
AGLNS: SLANG
AGLOP: GALOP
AGLOR: ARGOL
       GORAL
       LARGO
AGLOS: GLOSA
       GOALS
AGLOU: LOGUA
AGLSS: GLASS
AGLSU: GLUAS
AGLTU: GLUAT
AGLUU: GLUAU
AGLUZ: GUZLA
AGMMO: GOMMA
AGMNO: MANGO
AGMOR: GROMA
AGMOS: OGAMS
AGMOT: MAGOT
AGMOU: GAMOU
AGMRU: GARUM
AGMSU: SAGUM
AGNNO: ANGON
AGNOP: POGNA
AGNOR: ANGOR
       ARGON
       ROGNA
AGNOS: SANGO
AGNOT: TANGO
AGNOU: GUANO
AGNOW: WAGON
AGNOZ: GAZON
AGNRS: RANGS
AGNSS: SANGS
AGNST: GANTS
       TANGS
AGNSU: ANGUS
AGNSY: YANGS
AGORT: ARGOT
       RAGOT
AGORU: GAROU
       GOURA
AGOSS: GOSSA
AGOSU: SAGOU
AGOSY: GOYAS
       YOGAS
AGOTU: GOUTA
AGOTV: GAVOT
AGOUV: VOGUA
AGOUZ: GAZOU
AGOYZ: GYOZA
AGPSS: GASPS
AGPSU: PAGUS
AGRSU: ARGUS
       GAURS
       GRAUS
       GUARS
AGRSY: GRAYS
AGRTU: GRUTA
AGRUU: GRUAU
AGRUX: GRAUX
AGSSU: GAUSS
AGSSW: SWAGS
AGSTU: TSUGA
AHHIN: HIHAN
AHHSS: SHAHS
AHHUU: HUHAU
AHIIS: HIAIS
AHIIT: HIAIT
AHIKR: HARKI
AHIKS: HAIKS
AHIKU: HAIKU
AHILT: THALI
AHILU: HUILA
AHIMO: MAOHI
AHIMP: AMPHI
AHIMS: AMISH
AHIMU: HUMAI
AHINS: NASHI
AHINT: HIANT
       TAHIN
AHIOU: HOUAI
AHIPS: SPAHI
AHIRT: TRAHI
AHIRU: AHURI
AHIRV: HAVIR
AHISS: HISSA
AHIST: THAIS
AHISU: HUAIS
AHISV: HAVIS
AHITU: HUAIT
       HUTIA
AHITV: HAVIT
AHKLS: LAKHS
AHKNS: ANKHS
       KHANS
AHKOP: HOPAK
AHKOS: SHAKO
AHKOU: HOUKA
AHKST: KHATS
AHLLS: HALLS
AHLNO: HALON
AHLNU: UHLAN
AHLOS: HALOS
AHLOU: HOULA
AHLPY: PHYLA
AHLRU: HURLA
AHLSS: SLASH
AHMRU: RHUMA
AHMSS: SMASH
AHMST: MATHS
AHMSU: HUMAS
AHMTU: HUMAT
AHNOS: SHONA
AHNOY: HAYON
AHNSS: SHANS
AHNTU: HUANT
AHOPP: POPAH
AHOPU: POUAH
AHORS: HORAS
AHORT: THORA
       TORAH
AHOST: HOSTA
AHOSU: HOUAS
AHOSV: HOVAS
AHOSX: XHOSA
AHOTT: HOTTA
AHOTU: HOUAT
AHOUW: WAOUH
AHOUY: HOYAU
AHPST: SPATH
AHPTY: TYPHA
AHRSS: RASHS
AHRST: HARTS
       TAHRS
       TRASH
AHRSU: SURAH
AHRSY: SYRAH
AHRTU: HUART
AHSST: HASTS
AHSTU: HAUTS
AHTUY: THUYA
AIIJT: TAIJI
AIIKL: LIKAI
AIIKS: SKIAI
AIILM: LIMAI
AIILO: AIOLI
AIILP: PILAI
       PLIAI
AIILR: LIRAI
AIILS: LIAIS
       SILAI
AIILT: LIAIT
       LITAI
AIILV: AVILI
AIIMM: MIMAI
AIIMN: MINAI
AIIMR: MIRAI
       RIMAI
AIIMS: MISAI
AIIMT: IMITA
       MITAI
AIIMX: MIXAI
AIINS: AINSI
       NIAIS
AIINT: NIAIT
AIINV: VINAI
AIIPP: PIPAI
AIIPR: PRIAI
       RIPAI
AIIPT: TIPAI
AIIRR: RIRAI
AIIRS: IRAIS
       IRISA
       RIAIS
AIIRT: IRAIT
       RIAIT
       TIRAI
       TRIAI
AIIRV: RIVAI
       VIRAI
AIISS: SAISI
AIIST: TISAI
AIISV: VISAI
AIISX: IXAIS
       IXIAS
AIITX: IXAIT
AIJKN: KANJI
AIJNN: NINJA
AIJNS: JAINS
AIJNU: JAUNI
AIJOR: RIOJA
AIJOU: JOUAI
AIJRU: JURAI
AIJST: JATIS
AIJTU: JUTAI
AIKKS: KAKIS
AIKLS: KALIS
       LIKAS
AIKLT: LIKAT
AIKMS: KAMIS
       MAKIS
AIKNS: KINAS
AIKNT: TAKIN
AIKOP: OKAPI
AIKOT: KOTAI
       TOKAI
AIKPP: KIPPA
AIKPS: PIKAS
AIKRS: RAKIS
AIKSS: SAKIS
       SIKAS
       SKAIS
       SKIAS
AIKST: IKATS
       SAKTI
       SKIAT
AIKSV: KIVAS
AIKSW: KAWIS
AIKUZ: AZUKI
AILLP: PILLA
AILLS: LILAS
AILLT: TILLA
AILLV: VILLA
AILMN: LIMAN
       MALIN
       MILAN
AILMP: AMPLI
AILMR: MARLI
AILMS: ISLAM
       LIMAS
       MAILS
       MALIS
AILMT: LIMAT
       TAMIL
AILNO: ANOLI
       LIANO
AILNP: ALPIN
       LAPIN
       PLAIN
AILNS: ANILS
       SALIN
AILNT: LATIN
       LIANT
AILNU: ALUNI
AILNV: ALVIN
       NIVAL
AILNY: INLAY
AILOP: APIOL
       POILA
AILOS: ALIOS
       ALOIS
       ISOLA
AILOT: TOILA
       TOLAI
AILOU: IOULA
       LOUAI
AILOV: LOVAI
       VIOLA
       VOILA
       VOLAI
AILPP: APPLI
AILPR: PALIR
AILPS: LAPIS
       LAPSI
       PALIS
       PILAS
       PLAIS
       PLIAS
AILPT: PALIT
       PILAT
       PLAIT
       PLIAT
AILPU: PILAU
AILPW: PILAW
AILRS: LARIS
       LIRAS
       RAILS
       RIALS
       SALIR
AILRT: LITRA
       RITAL
       TRAIL
       TRIAL
AILRU: LUIRA
       RUILA
AILRV: AVRIL
       LIVRA
       RIVAL
       VIRAL
AILRX: LARIX
AILRY: LYRAI
       RIYAL
AILSS: LASSI
       LISSA
       SALIS
       SIALS
       SILAS
       SISAL
AILST: LAITS
       LISTA
       LITAS
       SALIT
       SILAT
AILSU: LAIUS
AILSV: LAVIS
AILSW: WALIS
AILSY: LYSAI
AILTT: LITAT
       TILTA
AILTU: LUTAI
       TUILA
AILTV: VITAL
AILUX: LUXAI
AILZZ: LAZZI
AIMMS: AMMIS
       IMAMS
       MIMAS
AIMMT: MIMAT
AIMMU: UMAMI
AIMNP: MANIP
AIMNR: MARIN
       RAMIN
AIMNS: IMANS
       MAINS
       MINAS
AIMNT: MAINT
       MATIN
       MINAT
       MITAN
AIMNZ: NIZAM
AIMOR: MAORI
       MOIRA
AIMOS: MOAIS
       MOISA
AIMOT: TOMAI
AIMOU: MIAOU
AIMOY: MOYAI
AIMPR: PARMI
       PRIMA
AIMPS: SAMPI
AIMRR: MARRI
AIMRS: MARIS
       MIRAS
       RAMIS
       RIMAS
AIMRT: MATIR
       MIRAT
       RIMAT
       TRIMA
AIMRU: AMUIR
       MURAI
AIMSS: MISAS
       SAMIS
       SIMAS
AIMST: MATIS
       MISAT
       MITAS
       SAMIT
       TAMIS
AIMSU: AMUIS
       MUAIS
       MUSAI
AIMSX: MAXIS
       MIXAS
AIMTT: MATIT
       MITAT
AIMTU: AMUIT
       MUAIT
       MUTAI
AIMTX: MIXAT
AIMWX: WIMAX
AINNO: ANION
AINNS: NAINS
       NINAS
AINNT: NANTI
       NIANT
       TANIN
AINNV: ANNIV
AINNZ: ZANNI
AINOP: APION
       OPINA
       PIANO
AINOR: NORIA
       ORNAI
AINOT: NOTAI
       TAINO
AINOU: AINOU
       NOUAI
AINOV: AVION
       NOVAI
AINOY: NOYAI
AINOZ: ZONAI
AINPP: NIPPA
AINPR: RAPIN
AINPS: PAINS
       PIANS
       PISAN
       SAPIN
AINPT: PATIN
       PINTA
       TAPIN
AINQU: NIQUA
AINRS: ARSIN
       RANIS
       SARIN
AINRT: NITRA
       RIANT
       TARIN
       TRAIN
AINRU: NUIRA
       RUINA
       UNIRA
       URINA
AINRV: INVAR
       RAVIN
AINSS: ASINS
       SAINS
AINST: SAINT
       SATIN
       TAINS
       TIANS
AINSU: NUAIS
       SINUA
       USINA
AINSV: VAINS
       VINAS
AINSW: IWANS
AINSZ: NAZIS
       ZAINS
       ZANIS
AINTT: TATIN
       TINTA
       TITAN
AINTU: NUAIT
       TUNAI
AINTV: VINAT
AINTX: IXANT
AINZZ: ZANZI
AIOPR: PAROI
AIOPS: POSAI
AIOPT: OPIAT
       OPTAI
       PATIO
       POTAI
       TOPAI
AIORR: ARROI
AIORS: ROSAI
AIORT: RATIO
       RIOTA
       ROTAI
AIORU: OUIRA
       ROUAI
AIORV: AVOIR
AIORY: ORIYA
AIOSS: OASIS
       OSAIS
AIOST: IOTAS
       OSAIT
       OTAIS
       TOISA
AIOSU: OUAIS
AIOSV: AVISO
AIOSY: OYAIS
AIOTT: OTAIT
AIOTU: TOUAI
AIOTV: VOTAI
AIOTY: OYAIT
AIOUV: VOUAI
AIPPS: PAPIS
       PIPAS
AIPPT: PIPAT
       TIPPA
AIPPU: APPUI
AIPPZ: ZIPPA
AIPQU: PIQUA
AIPRS: PAIRS
       PARIS
       PARSI
       PRIAS
       PRISA
       RIPAS
AIPRT: PARTI
       PATIR
       PRIAT
       RIPAT
       TAPIR
       TRIPA
AIPRU: RUPAI
AIPRV: PRIVA
AIPSS: ASPIS
       PISSA
AIPST: PATIS
       PISTA
       PITAS
       SPITA
       TAPIS
       TIPAS
AIPSU: PUAIS
       PUISA
       SUPAI
AIPTT: PATIT
       PITTA
       TAPIT
       TIPAT
AIPTU: PUAIT
AIPTY: TYPAI
AIPZZ: PIZZA
AIQSU: QUAIS
       QUASI
AIQTU: TIQUA
AIRRS: RIRAS
AIRRT: TARIR
AIRRV: RAVIR
AIRSS: ARSIS
       RASSI
       SARIS
AIRST: SITAR
       STRIA
       TARIS
       TIRAS
       TRAIS
       TRIAS
AIRSU: RUAIS
       RUSAI
       SAURI
AIRSV: RAVIS
       RIVAS
       VAIRS
       VIRAS
       VRAIS
AIRTT: TARIT
       TARTI
       TIRAT
       TITRA
       TRAIT
       TRIAT
AIRTU: RUAIT
AIRTV: RAVIT
       RIVAT
       VIRAT
       VITRA
AIRVV: VIVRA
AISSS: ASSIS
       ISSAS
AISST: ASSIT
       ASTIS
       SATIS
       TISAS
       TISSA
AISSU: AUSSI
       SUAIS
       USAIS
AISSV: VISAS
       VISSA
AISSY: AISYS
AISTT: TATIS
       TISAT
AISTU: SITUA
       SUAIT
       TUAIS
       USAIT
AISTV: VISAT
       VISTA
AISTW: SWATI
AISTX: TAXIS
AISWZ: SWAZI
AITTU: TUAIT
AITVV: VIVAT
AJKOT: TOKAJ
AJLNO: JALON
AJLOU: JOUAL
AJMOR: MAJOR
AJMPU: JUMPA
AJMRU: JUMAR
AJNOP: JAPON
AJNOR: JORAN
AJNOU: ANJOU
AJOPT: PAJOT
AJORU: AJOUR
AJOSS: SOJAS
AJOST: JOTAS
AJOSU: JOUAS
       SAJOU
AJOTU: AJOUT
       JOUAT
       JOUTA
AJOUY: JOYAU
AJPSU: PUJAS
AJRSU: JURAS
AJRTU: JURAT
AJSTU: AJUTS
       JUTAS
AJTTU: JUTAT
AJYZZ: JAZZY
AKKOP: KAPOK
AKKOS: KOKAS
AKKRS: KRAKS
AKLOO: ALOKO
AKLOP: PAKOL
       POLKA
AKLOS: KOLAS
AKMOS: AMOKS
       MAKOS
       MOKAS
AKMRS: MARKS
AKNOS: KAONS
       KOANS
AKNOT: TONKA
AKNST: TANKS
AKNSU: KUNAS
AKOPP: KOPPA
AKOPS: KAPOS
AKOPY: YAPOK
AKORS: KORAS
       OKRAS
AKOST: KOTAS
AKOTT: KOTAT
AKOTY: TOKAY
AKOUZ: ZOUKA
AKQRU: QUARK
AKRSS: KSARS
AKRST: KARST
       KARTS
AKRSU: RAKUS
AKSST: SKATS
AKSSU: SKUAS
AKSTU: STUKA
AKSTY: KYATS
ALLMU: MULLA
ALLNO: LLANO
ALLOS: SALOL
ALLOT: ATOLL
ALLOY: LOYAL
ALLUU: ULULA
ALMMS: MALMS
ALMNO: MALON
ALMNU: MANUL
ALMOR: MORAL
ALMOU: LOUMA
       MOULA
ALMPU: PLUMA
ALMRU: MURAL
ALMRY: MYLAR
ALMSS: SLAMS
ALMST: MALTS
       SMALT
ALMSU: LUMAS
       MALUS
       MAULS
ALNOP: LAPON
       NOPAL
ALNOR: LORAN
ALNOS: SALON
       SONAL
ALNOT: TALON
       TONAL
ALNOY: LAYON
       ONLAY
ALNOZ: ZONAL
ALNPS: PLANS
ALNPT: PLANT
ALNSU: ALUNS
       ULNAS
ALOPR: POLAR
ALOPS: SALOP
ALOPT: PALOT
ALOPU: LOUPA
ALOPX: PALOX
ALOPY: PLOYA
ALORS: ALORS
       AROLS
ALORT: TOLAR
ALORU: LOURA
       OURLA
       ROULA
ALORV: ORVAL
ALORY: ROYAL
ALOSS: LASSO
ALOST: ALTOS
       SALTO
       TOLAS
ALOSU: LOUAS
       SAOUL
       SOULA
ALOSV: LOVAS
       VOLAS
ALOTT: LOTTA
       TOLAT
       TOTAL
ALOTU: LOUAT
ALOTV: LOVAT
       VOLAT
       VOLTA
ALOTX: TAXOL
ALOUV: LOUVA
       OVULA
ALPST: PLATS
ALPSU: PALUS
       PULAS
       PULSA
ALRRU: RURAL
ALRSU: SURAL
ALRSY: LYRAS
       RYALS
ALRTU: ULTRA
ALRTY: LYRAT
ALSSY: LYSAS
ALSTU: LUTAS
       SALUT
       TALUS
ALSTY: LYSAT
       STYLA
ALSUV: VALUS
ALSUX: LUXAS
ALSWY: YAWLS
ALTTU: LUTAT
       LUTTA
ALTUV: VALUT
ALTUX: LUXAT
ALUUV: UVULA
AMMMO: MAMMO
AMMMY: MAMMY
AMMNO: NOMMA
AMMOP: POMMA
AMMOS: SOMMA
AMMOU: OUMMA
AMMST: STAMM
AMMSU: UMMAS
AMMSY: MAMYS
       SAMMY
AMNNO: MANON
AMNOR: ARMON
       MORNA
       NORMA
       ROMAN
AMNOS: MOSAN
       NOMAS
       SOMAN
AMNOT: AMONT
       MATON
       MONTA
       TOMAN
AMNOU: MANOU
AMNTU: MUANT
AMOOZ: ZOOMA
AMOPP: POMPA
AMOQU: MOQUA
AMORS: OMRAS
AMORU: AMOUR
AMOSS: MASOS
       SAMOS
       SOMAS
AMOST: MATOS
       TOMAS
AMOSU: MAOUS
AMOSX: MOXAS
AMOSY: MAYOS
       MOYAS
AMOTT: MOTTA
       TOMAT
AMOTU: MATOU
AMOTY: MOYAT
AMOTZ: MAZOT
AMOZZ: MOZZA
AMPRT: TRAMP
AMPSS: SPAMS
AMPSU: PUMAS
AMPSV: VAMPS
AMPSY: SYMPA
AMRST: SMART
       TRAMS
AMRSU: ARUMS
       MURAS
AMRTU: MURAT
AMRUY: MAURY
AMSSU: MUSAS
       MUSSA
       SAMUS
AMSTU: MATUS
       MUSAT
       MUTAS
AMSUZ: ZAMUS
AMTTU: MUTAT
AMTUX: TAXUM
ANNOS: ANONS
       SONNA
ANNOT: TONNA
ANNQU: QANUN
ANNST: NANTS
       TANNS
ANNSU: SUNNA
ANNTU: NUANT
ANOOZ: OZONA
ANOPR: PRONA
ANOPS: PAONS
ANOPT: PATON
       PONTA
       TAPON
ANOPX: PAXON
ANORS: ORNAS
       SARON
       SONAR
ANORT: ORANT
       ORNAT
       RATON
       TRONA
ANORU: ROUAN
ANORV: VARON
ANORY: RAYON
ANOST: NOTAS
       OSANT
       TAONS
ANOSU: NOUAS
       SOUNA
ANOSV: AVONS
       NOVAS
       SAVON
ANOSX: AXONS
       SAXON
ANOSY: AYONS
       NOYAS
       SAYON
ANOSZ: ZONAS
ANOTT: NOTAT
       OTANT
ANOTU: NOUAT
       TAUON
ANOTV: NOVAT
ANOTX: TAXON
ANOTY: NOYAT
       OYANT
ANOTZ: ZONAT
ANOUY: NOYAU
ANPSU: PANSU
       PUNAS
ANPTU: PUANT
ANPTY: PANTY
ANQTU: QUANT
ANRST: TRANS
ANRTU: RUANT
ANRTY: TYRAN
ANSTU: SUANT
       TUNAS
       USANT
ANSUU: UNAUS
ANSUY: YUANS
ANTTU: TUANT
       TUNAT
ANUUX: UNAUX
AOPPU: PAPOU
AOPQU: POQUA
AOPRS: PAROS
       PRAOS
AOPRT: PATRO
       PORTA
AOPSS: POSAS
       PSOAS
       SOAPS
AOPST: OPTAS
       POSAT
       POSTA
       POTAS
       TOPAS
AOPSU: SOUPA
AOPSV: VAPOS
AOPSY: POYAS
AOPTT: OPTAT
       POTAT
       TOPAT
AOPTU: PATOU
AOPTV: PAVOT
AOQRU: ROQUA
AOQTU: QUOTA
       TOQUA
AORSS: ROSAS
       ROSSA
       SAROS
AORST: ROSAT
       ROTAS
       TAROS
AORSU: ROUAS
AORTT: ROTAT
       TAROT
AORTU: ATOUR
       OUTRA
       RAOUT
       ROUAT
       ROUTA
       TOURA
       TROUA
AORUV: OUVRA
AORUX: ORAUX
AOSSS: ASSOS
AOSST: TOSAS
       TOSSA
AOSSX: SAXOS
AOSSY: SOYAS
AOSTT: TOAST
AOSTU: AOUTS
       AUTOS
       TOUAS
AOSTV: VOTAS
AOSTY: OYATS
AOSUV: VOUAS
AOTTU: ATOUT
       TATOU
       TOUAT
AOTTV: VOTAT
AOTUV: VOUAT
       VOUTA
AOUZZ: ZAZOU
APPRT: TRAPP
APPSY: PAPYS
APRST: PARTS
       RAPTS
       SPART
       SPRAT
       STRAP
APRSU: PARUS
       RUPAS
       SUPRA
APRSW: WRAPS
APRSY: SPRAY
APRTU: PARUT
       RUPAT
       TRAPU
APRTY: PARTY
APSST: SPATS
APSSU: SUPAS
APSSW: SWAPS
       WASPS
APSTU: STUPA
       SUPAT
APSTY: TYPAS
APTTU: PATTU
       PUTTA
APTTY: TYPAT
AQRTU: QUART
AQSTU: SQUAT
AQSUW: SQUAW
ARSST: SARTS
       STARS
       STRAS
       TSARS
ARSSU: RUSAS
       SAURS
ARSTU: RUSAT
       SUTRA
ARSTY: ARTYS
ARSTZ: TZARS
ARSUV: VARUS
ARSUZ: AZURS
ASSTT: STATS
ASSTU: SAUTS
ASTTW: WATTS
ASTUV: VATUS
ASTUX: TAXUS
ATUUY: TUYAU
AUUVX: UVAUX
BBBOY: BOBBY
BBEES: BEBES
BBEIL: BIBLE
BBEIR: BIRBE
       BRIBE
BBELU: BULBE
BBEMO: BOMBE
BBEOP: BEBOP
BBEOT: BOBET
BBHOY: HOBBY
BBIIL: BIBLI
BBIIS: BIBIS
BBIMO: BIMBO
BBISU: BIBUS
BBLOS: BLOBS
BBLOY: LOBBY
BBLSU: BULBS
BBNOU: BOBUN
       BUBON
BBOOS: BOBOS
BCEEH: BECHE
BCEEO: COBEE
BCEER: BERCE
       REBEC
BCEES: CEBES
BCEET: BECTE
BCEEU: CUBEE
BCEHI: BICHE
BCEHS: CHEBS
BCEHU: BUCHE
BCEIL: CIBLE
BCELS: CLEBS
BCEMO: COMBE
BCEOS: COBES
BCEOT: BECOT
BCERU: CUBER
BCESU: CUBES
BCEUZ: CUBEZ
BCIKR: BRICK
BCILO: BICOL
BCIMO: COMBI
BCIOS: BISOC
BCIOT: BICOT
BCIRS: CRIBS
BCISU: CUBIS
BCKLO: BLOCK
BCKOS: BOCKS
BCLOO: COBOL
BCLOS: BLOCS
BCLSU: CLUBS
BCMOO: COMBO
BCOOS: BOSCO
BCOOT: COBOT
BCORS: BROCS
       CORBS
BCOSU: BOUCS
BCRSU: SCRUB
BCSSU: BUSCS
BDEER: BREDE
BDEES: BEDES
BDEET: DEBET
BDEEY: DEBYE
BDEHO: HEBDO
BDEIO: BOIDE
BDEIR: BRIDE
BDEIS: BIDES
BDEIT: BIDET
       DEBIT
BDELS: BLEDS
BDEMO: DEMOB
BDENO: BEDON
       BONDE
BDEOR: BORDE
       BRODE
BDEOU: BOUDE
BDERY: DERBY
BDETU: DEBUT
BDHIO: BODHI
BDIIN: BINDI
BDIIS: DIBIS
BDILN: BLIND
BDINO: BIDON
       BONDI
BDIOU: BIDOU
       BOUDI
BDJOR: BORDJ
BDKOO: DOBOK
BDLNO: BLOND
BDLOO: BOLDO
BDLOY: DOLBY
BDNOS: BONDS
BDORS: BORDS
BDOSY: BODYS
BDOUU: BOUDU
BEEEK: BEKEE
BEEEL: BELEE
BEEEN: EBENE
BEEET: BETEE
BEEFN: BENEF
BEEFS: BESEF
BEEFZ: BEZEF
BEEGI: BEIGE
BEEGL: BELGE
       GLEBE
BEEGO: GOBEE
BEEGR: BERGE
       GERBE
       GREBE
BEEGU: BEGUE
BEEHR: HERBE
BEEIL: BILEE
BEEIN: BENIE
       BINEE
       NIEBE
BEEIO: OBEIE
BEEIP: BIPEE
BEEIR: BIERE
       BRIEE
       IBERE
BEEIS: BISEE
BEEIT: BETIE
       BITEE
BEEIZ: BEIEZ
BEEKS: BEKES
BEELL: BELLE
       LEBEL
BEELM: BLEME
BEELO: BOLEE
       LOBEE
       OBELE
BEELP: PLEBE
BEELR: BELER
       BRELE
BEELS: BELES
       BLESE
BEELT: BETEL
BEELU: BLEUE
BEELY: YEBLE
BEELZ: BELEZ
BEEMO: BOMEE
BEEMR: BERME
       BREME
BEEMU: EMBUE
BEENN: BENNE
BEENR: BERNE
BEENT: BEENT
       BENET
BEEOR: BOREE
       OBERE
       ROBEE
BEEOS: OBESE
BEEOT: BOETE
BEEOU: BOUEE
       EBOUE
BEEOX: BOXEE
BEERS: SERBE
BEERT: BERET
BEERU: BEURE
       ERBUE
       REBEU
       REBUE
BEERV: BREVE
       VERBE
BEERW: WEBER
BEERZ: ZEBRE
BEEST: BESET
       BETES
BEESU: BEUSE
       BUEES
       BUSEE
BEETT: BETTE
BEETU: BUTEE
       TUBEE
BEEUV: BEVUE
       BUVEE
BEFFI: BIFFE
BEFIR: BRIEF
       FIBRE
BEFIS: BIEFS
BEFOU: BOEUF
BEFRS: BREFS
BEGGU: BUGGE
BEGIL: BIGLE
BEGIO: BOGIE
       GOBIE
BEGIR: BIGRE
BEGIS: BIGES
BEGIT: GIBET
BEGIU: BIGUE
BEGLO: GLOBE
BEGLU: BUGLE
       BULGE
BEGMU: BEGUM
BEGNU: BUGNE
BEGOR: GOBER
BEGOS: BOGES
       GOBES
BEGOU: BOGUE
       BOUGE
BEGOY: BOGEY
BEGOZ: GOBEZ
BEGSU: BEGUS
BEGUU: BUGUE
BEHRU: HERBU
BEHSU: BEUHS
BEIIL: BILIE
BEIJN: BENJI
BEIKR: BIKER
BEILL: BILLE
BEILM: BLEMI
       LIMBE
BEILO: LOBIE
BEILP: PIBLE
BEILR: BILER
       LIBER
       LIBRE
       RIBLE
BEILS: BILES
BEILU: BLEUI
       LUBIE
BEILZ: BILEZ
BEIMN: NIMBE
BEIMO: BIOME
BEIMR: BRIME
BEIMU: IMBUE
BEINN: BENIN
BEINR: BENIR
       BINER
BEINS: BENIS
       BIENS
       BINES
BEINT: BENIT
BEINZ: BINEZ
BEIOR: BOIRE
       BORIE
       BROIE
       OBEIR
       OBIER
BEIOS: BOISE
       OBEIS
BEIOT: BIOTE
       BOITE
       OBEIT
BEIOV: BOIVE
       OBVIE
BEIPR: BIPER
BEIPS: BIPES
BEIPZ: BIPEZ
BEIQU: BIQUE
BEIRS: BISER
       BRIES
       BRISE
       SBIRE
BEIRT: BITER
BEIRU: BRUIE
       BUIRE
BEIRV: VIBRE
BEIRY: BYERI
BEIRZ: BRIZE
BEISS: BISES
       BISSE
BEIST: BETIS
       BISET
       BITES
BEISU: SUBIE
BEISV: VIBES
BEISZ: BISEZ
BEITT: BITTE
BEITU: BITUE
BEITZ: BITEZ
       BIZET
BEJOR: JOBER
BEJOS: JOBES
BEJOT: OBJET
BEJOZ: JOBEZ
BEJSU: JUBES
BEKRU: BEURK
BEKUZ: UZBEK
BELLU: BULLE
BELMO: BEMOL
       OMBLE
BELNO: BELON
       NOBEL
       NOBLE
BELOO: OBOLE
BELOR: LOBER
BELOS: LOBES
       OBELS
BELOT: BOLET
       ELBOT
BELOU: BOULE
BELOZ: LOBEZ
BELRU: BRULE
       BURLE
BELRY: BERYL
BELST: BLETS
BELSU: BLEUS
       BLUES
       SUBLE
BELTU: BLUET
       BLUTE
BELTZ: BLETZ
BEMMO: BOMME
BEMOP: POMBE
BEMOR: BROME
       OMBRE
BEMOS: BOMES
       SOMBE
BEMOT: TOMBE
BEMOU: BOUME
BEMRU: BRUME
BEMSU: BUMES
       EMBUS
       SEBUM
BEMTU: EMBUT
BENNO: BONNE
BENOR: BORNE
BENOS: BEONS
       SNOBE
BENOT: BENTO
       BETON
       BONTE
BENOZ: BONZE
BENRS: BRENS
BENRT: BRENT
BENRU: BRUNE
       BURNE
BEOOR: OROBE
BEOOT: BOOTE
BEOPR: PROBE
BEORR: ROBER
       ROBRE
BEORS: BOERS
       BORES
       ORBES
       ROBES
       SOBRE
       SORBE
BEORT: BEROT
       REBOT
BEORU: BOURE
       BROUE
BEORX: BOXER
BEORY: BROYE
BEORZ: ROBEZ
BEOSS: BOSSE
BEOST: BOTES
BEOSU: BOUES
       BOUSE
BEOSX: BOXES
BEOTT: BOTTE
BEOTU: BOUTE
BEOXZ: BOXEZ
BEQUU: BUQUE
BERSU: BEURS
       BURES
       BUSER
       REBUS
       SUBER
BERTU: BRUTE
       BUTER
       REBUT
       TUBER
       TURBE
BERXY: BERYX
BESSU: BUSES
       BUSSE
BESTU: BUSTE
       BUTES
       TUBES
BESTY: BYTES
BESUZ: BUSEZ
       ZEBUS
BETTU: BUTTE
BETUZ: BUTEZ
       BUZET
       TUBEZ
BEUVZ: BUVEZ
BEUZZ: BUZZE
BFFLU: BLUFF
BFINO: BONIF
BFIOR: FIBRO
BFIOU: BOUIF
BGGUY: BUGGY
BGINO: BINGO
BGIOR: BIGOR
BGIOS: BIGOS
       IGBOS
BGIOT: BIGOT
BGISU: GIBUS
       GUIBS
BGLOS: BLOGS
BGMOO: GOMBO
BGNOO: BONGO
BGORU: BOURG
BGRSU: BURGS
BGRUY: RUGBY
BHIOU: HIBOU
BHKOZ: KHOBZ
BHLSU: BLUSH
BHMRU: RHUMB
BHSSU: BUSHS
BIILN: BLINI
BIIST: BITIS
BIJOU: BIJOU
BIKOT: BOKIT
BIKRS: BRIKS
BILLS: BILLS
BILMO: LIMBO
BILOS: LOBIS
BILOU: OUBLI
BILST: STILB
BILTZ: BLITZ
BIMOZ: ZOMBI
BIMSU: IMBUS
BINNO: BINON
BINOR: BORIN
       BRION
       ROBIN
BINOS: BISON
       BONIS
BINOV: BOVIN
BINRS: BRINS
BINRU: BRUNI
       BURIN
BINTU: BUTIN
BIORS: BRIOS
BIORT: RIBOT
BIORV: VIBOR
       VIBRO
BIOST: BITOS
       OBITS
BIOSU: BISOU
BIOUZ: BIZOU
BIPSU: PUBIS
BIQTU: QUBIT
BIRRS: BIRRS
BIRRU: BRUIR
BIRSU: BRUIS
       RUBIS
       SUBIR
       UBRIS
BIRTU: BRUIT
       TRIBU
BISSU: SUBIS
BISTU: BITUS
       SUBIT
BITTU: BITTU
BITUZ: BIZUT
BJMOU: JUMBO
BKMOU: KOMBU
BKOOR: BROOK
BKOOS: BOOKS
BLLSU: BULLS
BLMOO: BLOOM
BLMOP: PLOMB
BLOOS: BOLOS
BLORS: BROLS
BLOST: BLOTS
BLOSU: BOLUS
BLOTU: BULOT
BMOOS: BOOMS
BMORU: BROUM
BMOSU: BOUMS
       UMBOS
BMRSU: RUMBS
BNOOS: BOSON
BNOOX: BOXON
BNORU: BURON
BNOSS: SNOBS
BNOSU: BONUS
BNRSU: BRUNS
BOORT: ROBOT
BOOST: BOOST
       BOOTS
       BOTOS
BOOTX: BOTOX
BORST: BORTS
BORSU: BOURS
       BROUS
BORTU: BROUT
       BUTOR
       TURBO
BOSSU: BOSSU
BOSTU: BOUTS
       BUTOS
       OBTUS
BOSTY: TOBYS
BOUYZ: BOUZY
BRSTU: BRUTS
BRUUU: URUBU
CCCIO: COCCI
CCDEO: CODEC
CCEEH: ECHEC
CCEER: CERCE
CCEHK: CHECK
CCEHO: COCHE
CCEIL: CICLE
CCELR: CLERC
CCELY: CYCLE
CCEOS: SECCO
CCEOU: COCUE
CCHIS: CHICS
CCHOO: CHOCO
       HOCCO
CCHOS: CHOCS
CCIKL: CLICK
CCILS: CLICS
CCIOS: OCCIS
CCIOU: COUIC
CCIRS: CRICS
CCLOO: COLOC
CCLOY: CYCLO
CCLUU: CUCUL
CCNOO: COCON
CCNOU: CONCU
CCOOR: CROCO
CCOOS: COCOS
CCORS: CROCS
CCOSU: COCUS
CCSUU: CUCUS
CDEEE: CEDEE
CDEEH: DECHE
CDEEO: CODEE
CDEER: CEDER
       CEDRE
CDEES: CEDES
       DECES
CDEEU: DECUE
CDEEX: CEDEX
CDEEZ: CEDEZ
CDEHU: DECHU
       DUCHE
CDEIR: CIDRE
       DECRI
CDEIS: CEDIS
       DECIS
CDEIT: DICTE
CDEKS: DECKS
CDELO: DELCO
       DOLCE
CDEMO: MEDOC
CDENO: CONDE
CDEOR: CODER
       CORDE
       CREDO
       DECOR
CDEOS: CODES
       DECOS
CDEOT: DOCTE
CDEOU: COUDE
       DOUCE
CDEOX: CODEX
CDEOZ: CODEZ
CDERU: DECRU
       REDUC
CDESU: DECUS
       DUCES
CDETU: DECUT
CDIIN: INDIC
CDILO: DOLIC
CDIOS: DICOS
       DISCO
CDIOU: DOUCI
CDIOV: COVID
CDIRU: DURCI
CDKOS: DOCKS
CDLOO: CLODO
CDLOU: CLOUD
CDNOO: CODON
       CONDO
CDOSU: COUDS
       DOCUS
       DOUCS
CDSSU: SCUDS
CEEEH: ECHEE
CEEEL: CELEE
CEEEP: CEPEE
CEEER: CREEE
CEEFS: FECES
CEEGP: CEGEP
CEEGR: GERCE
CEEHI: CHIEE
CEEHL: LECHE
CEEHM: MECHE
CEEHN: CHENE
CEEHP: PECHE
CEEHR: CHERE
       ECHER
       RECHE
CEEHS: ECHES
       ESCHE
       SECHE
CEEHT: ECHET
CEEHU: ECHUE
CEEHV: CHEVE
CEEHZ: ECHEZ
CEEIM: ECIME
CEEIN: NIECE
CEEIP: EPICE
       PIECE
CEEIR: CIREE
       CRIEE
       ECRIE
CEEIS: SCIEE
CEEIT: CITEE
CEEJT: EJECT
CEEKR: CREEK
CEELL: CELLE
CEELO: COLEE
       ECOLE
CEELR: CELER
       RECEL
CEELS: CELES
CEELT: CELTE
CEELU: CULEE
       ECULE
CEELY: LYCEE
CEELZ: CELEZ
CEEMR: CREME
CEEMU: ECUME
CEENN: CENNE
CEENP: PENCE
CEENR: CERNE
       CRENE
       ENCRE
CEENS: CENES
       CENSE
       SCENE
CEEOP: ECOPE
CEEOR: OCREE
CEEOT: COTEE
       ECOTE
CEEOX: COXEE
CEEPR: CREPE
       PERCE
CEEPS: CEPES
CEEPU: EPUCE
       PUCEE
CEERR: CREER
       RECRE
CEERS: CREES
       RECES
CEERT: CRETE
       TERCE
CEERU: CUREE
       ECRUE
       ECURE
       RECUE
CEERV: CREVE
CEERZ: CREEZ
       RECEZ
CEESS: CESSE
CEEST: CESTE
       SECTE
CEESU: SUCEE
CEESV: VECES
       VESCE
CEESX: EXCES
CEETT: CETTE
CEEUV: CUVEE
       VECUE
CEFHI: FICHE
CEFHS: CHEFS
CEFIR: RECIF
CEFLS: CLEFS
CEFNO: FONCE
CEFOR: FORCE
CEFOS: COEFS
CEFRS: CERFS
CEGIL: GICLE
CEGIU: CIGUE
CEGIZ: CEZIG
CEGKO: GECKO
CEGNO: COGNE
       CONGE
CEGNY: CYGNE
CEGRS: GRECS
CEHHO: HOCHE
CEHHU: HUCHE
CEHIK: CHEIK
CEHIL: CHILE
       LICHE
CEHIM: MICHE
CEHIN: CHENI
       CHIEN
       CHINE
       NICHE
CEHIO: CHOIE
CEHIP: CHIPE
CEHIR: CHERI
       CHIER
       RICHE
CEHIS: CHIES
CEHIZ: CHIEZ
CEHJU: JUCHE
CEHKO: CHOKE
CEHKT: KETCH
CEHLO: LOCHE
CEHLR: LERCH
CEHLY: CHYLE
CEHMO: CHOME
       MOCHE
CEHMU: MUCHE
CEHMY: CHYME
CEHNU: CHENU
CEHOP: CHOPE
       POCHE
CEHOR: CHORE
       ROCHE
CEHOS: CHOSE
       ECHOS
CEHOT: HECTO
CEHOU: COHUE
       OUCHE
CEHOY: CHOYE
CEHPU: PECHU
       PUCHE
CEHRS: CHERS
CEHRU: RUCHE
CEHST: TECHS
CEHSU: CHUES
       ECHUS
CEHTU: CHUTE
       ECHUT
CEIIL: CILIE
CEIIV: VICIE
CEIJO: JOICE
CEILL: CILLE
CEILS: CIELS
       LICES
       SICLE
       SLICE
CEILU: CELUI
CEILV: CLIVE
CEIMN: MINCE
CEIMP: IMPEC
CEIMR: CRIME
       MERCI
CEIMS: CIMES
CEINO: ECOIN
       ICONE
CEINP: PINCE
CEINR: ECRIN
       RINCE
CEINS: CEINS
       CINES
CEINT: CEINT
CEIOP: COPIE
CEIOR: CROIE
CEIOT: COITE
       COTIE
CEIPP: CIPPE
CEIPR: CIPRE
       CREPI
       REPIC
CEIPT: PICTE
CEIRR: CIRER
       CIRRE
       CRIER
CEIRS: CIRES
       CIRSE
       CRIES
       CRISE
       ECRIS
       SCIER
CEIRT: CITER
       ECRIT
       RECIT
CEIRU: CUIRE
       CURIE
CEIRZ: CIREZ
       CRIEZ
CEISS: SCIES
CEIST: CISTE
       CITES
CEISU: CUISE
CEISV: CIVES
       VICES
CEISZ: SCIEZ
CEITU: CUITE
CEITV: CIVET
CEITZ: CITEZ
CEIUX: CIEUX
       ICEUX
CEJNO: JONCE
CEKNS: NECKS
CEKOS: COKES
CEKPS: SPECK
CEKRS: RECKS
CEKST: TECKS
CELLO: COLLE
CELNO: CLONE
       LECON
       ONCLE
CELOO: ECOLO
CELOP: CLOPE
CELOR: CLORE
       CROLE
CELOS: CLOSE
       ECLOS
       SOCLE
CELOT: CETOL
       ECLOT
CELOU: CLOUE
       COULE
       OCULE
CELRU: CRUEL
       CULER
       LUCRE
       RECUL
CELSU: CLUES
       CLUSE
       CULES
CELTU: CULTE
CELUX: CULEX
       EXCLU
CELUZ: CULEZ
CEMMO: COMME
CEMOR: CORME
       MORCE
CEMOT: COMTE
CEMSY: CYMES
CENNO: CONNE
       NONCE
CENOP: PONCE
CENOR: CORNE
       ENCOR
       NECRO
       NOCER
       RONCE
CENOS: CONES
       NOCES
       ONCES
       SCONE
CENOT: CONTE
CENOU: OUNCE
CENOZ: NOCEZ
CENST: CENTS
CEOPR: PERCO
CEOPS: SCOPE
CEOPT: COPTE
CEOPU: COUPE
       POUCE
CEOQU: COQUE
CEORR: OCRER
CEORS: CORES
       CORSE
       OCRES
       SCORE
CEORT: COTER
       COTRE
       RECTO
CEORU: COEUR
       COURE
       ECROU
CEORX: COXER
CEORY: COYER
CEORZ: OCREZ
CEOSS: COSSE
CEOST: COTES
       ECOTS
       ESCOT
       ESTOC
       ETOCS
CEOSU: COUSE
CEOSX: COXES
CEOTT: COTTE
       OCTET
CEOTU: COUTE
CEOTZ: COTEZ
CEOUV: COUVE
CEOXZ: COXEZ
CEPRU: CREPU
       PERCU
       PUCER
       RECUP
CEPSU: PECUS
       PUCES
CEPUZ: PUCEZ
CERRU: CURER
       RECRU
CERST: CRETS
CERSU: CRUES
       CURES
       ECRUS
       RECUS
       SUCER
       SUCRE
CERTU: RECUT
CERUV: CUVER
CERUX: CREUX
CERUZ: CUREZ
CESSU: SECUS
       SUCES
CESUV: CUVES
       VECUS
CESUZ: SUCEZ
CETUV: VECUT
CEUVZ: CUVEZ
CFHIU: FICHU
CFHOU: CHOUF
CFILS: FLICS
CFINO: NOCIF
CFIOR: FORCI
CFIRS: FRICS
CFISS: FISCS
CFISU: FICUS
CFLOS: FLOCS
CFORS: FROCS
CFOSU: FOCUS
CFSUU: FUCUS
CGINO: COING
CGIOR: CORGI
CHIIL: CHILI
CHIIR: RICHI
CHIKT: KITCH
CHIMO: MOCHI
CHINO: CHINO
CHINS: INCHS
CHINT: TCHIN
CHINW: WINCH
CHIOP: CHIPO
CHIOR: CHIRO
       CHOIR
       ICHOR
CHIOS: CHOIS
CHIOT: CHIOT
       CHOIT
CHIOX: CHOIX
CHIPS: CHIPS
CHIPT: PITCH
CHIST: CHTIS
CHIVY: VICHY
CHLMU: MULCH
CHLNU: LUNCH
CHLOO: LOOCH
CHLOS: LOCHS
CHMSU: CHUMS
CHNOP: PONCH
CHNPU: PUNCH
CHOPS: CHOPS
CHOST: SOTCH
CHOTT: CHOTT
CHOUX: CHOUX
CHSTU: CHUTS
CIILV: CIVIL
CIIMN: MINCI
CIINR: RICIN
CIIOV: VOICI
CIKKS: KICKS
CIKQU: QUICK
CIKRT: TRICK
CIKST: STICK
CILLO: LICOL
CILMS: CLIMS
CILNO: COLIN
       NICOL
CILNS: CLINS
CILOS: COLIS
CILOT: CLITO
CILOU: LICOU
       OCULI
CILPS: CLIPS
CILRY: LYRIC
CIMNU: CUMIN
CIMOR: MICRO
CIMSS: SMICS
CINOP: PICON
CINOR: CIRON
CINOS: COINS
       SCION
       SINOC
CINOT: TONIC
CINRS: CRINS
CINSU: INCUS
CINSZ: ZINCS
CIOOS: SOCIO
CIOPS: PISCO
CIOPT: PICOT
       PICTO
       TOPIC
CIOPU: POUIC
CIORS: COIRS
       CROIS
CIORT: COTIR
       CROIT
CIORX: CROIX
CIOST: COITS
       COTIS
CIOSU: SOUCI
CIOSV: VIOCS
CIOTT: COTIT
CIOUV: COUVI
CIPSS: SPICS
CIRSS: CRISS
CIRST: TRICS
CIRSU: CUIRS
CISTU: CUITS
       CUTIS
       ICTUS
CJKOO: JOCKO
CJNOS: JONCS
CJNOU: JUNCO
CKORS: ROCKS
CKOST: STOCK
CKPSU: PUCKS
CKRSU: RUCKS
CKRTU: TRUCK
CLLSU: SCULL
CLMUU: CUMUL
CLNOO: COLON
CLNOW: CLOWN
CLOOS: COLOS
       COOLS
       LOCOS
CLOPS: PLOCS
CLOPU: CLOUP
       PLOUC
CLOST: COLTS
CLOSU: CLOUS
       LOCUS
CLOTU: CULOT
CMOOP: COMPO
CMOOS: MOCOS
       MOOCS
CMORU: MUCOR
CMSSU: MUSCS
CMSUU: MUCUS
       MUSCU
CNNOU: CONNU
CNOOR: CORON
CNOOS: CONSO
CNOOT: COTON
CNORT: TRONC
CNORU: CORNU
CNORW: CROWN
CNOSU: NOUCS
       SUCON
CNOSY: CYONS
COOPR: CORPO
COOPS: SCOOP
COORS: CORSO
COORU: ROCOU
COOST: SCOOT
COPRS: CORPS
       PORCS
       PROCS
COPRU: CROUP
       CUPRO
COPSU: COUPS
CORRU: CRUOR
CORSS: CROSS
CORST: TROCS
CORSU: COURS
CORSW: CROWS
CORTU: COURT
       TURCO
CORUU: COURU
COSSU: COSSU
COSSY: COSYS
COSTU: COUTS
       SCOUT
COSUU: COUSU
COSUV: COUVS
CRRUY: CURRY
CRSTU: TRUCS
       TURCS
CSSTU: STUCS
DDEEI: DEDIE
DDEIN: DENDI
       DINDE
DDEIO: DIODE
DDEIS: DEDIS
DDEIT: DEDIT
DDEOU: DODUE
DDETY: TEDDY
DDIOT: DIDOT
DDIOU: DUODI
DDITU: DUDIT
DDJSU: JUDDS
DDOOS: DODOS
DDOSU: DODUS
DEEFI: DEFIE
DEEFN: FENDE
DEEFS: FEDES
DEEFT: DEFET
DEEGI: EGIDE
DEEGL: DEGEL
DEEGO: GEODE
       GODEE
DEEGR: DEGRE
       DREGE
DEEGU: DEGUE
       GUEDE
DEEGW: WEDGE
DEEIL: DELIE
       EDILE
       ELIDE
       IDEEL
DEEIM: DEMIE
DEEIN: DENIE
       DIENE
DEEIO: IODEE
DEEIR: EIDER
       REDIE
       RIDEE
DEEIS: DIESE
       IDEES
       SEIDE
DEEIT: DEITE
       DIETE
       EDITE
       TIEDE
DEEIV: DEVIE
       EVIDE
       VIDEE
DEELO: DOLEE
DEELU: ELUDE
       LEUDE
DEEMR: DERME
       MERDE
DEEMS: DEMES
       MEDES
DEEMT: DEMET
DEEMY: EMYDE
DEEMZ: MEDZE
DEENO: ONDEE
DEENP: PENDE
DEENR: RENDE
DEENS: DENSE
       EDENS
DEENT: DENTE
       ETEND
       TENDE
DEENU: DENUE
       EDUEN
DEENV: VENDE
DEENZ: ZENDE
DEEOP: DOPEE
       EPODE
DEEOR: DOREE
       ERODE
       RODEE
DEEOS: DOSEE
       SODEE
DEEOT: DOTEE
DEEOU: DOUEE
DEEOX: EXODE
DEEPR: PERDE
DEEPS: SPEED
DEEPU: DUPEE
DEEPZ: PEDZE
DEERT: DETER
DEERU: DUREE
       REDUE
DEERV: DREVE
DEESU: SUEDE
DEETT: DETTE
DEETU: ETUDE
DEETV: DEVET
DEETW: TWEED
DEEVZ: DEVEZ
DEFGU: FUDGE
DEFIL: FIELD
DEFIR: REDIF
DEFIS: DEFIS
DEFIT: DEFIT
DEFJL: FJELD
DEFNO: FONDE
DEFNS: FENDS
DEFNU: FENDU
DEFOU: DOUFE
DEGIL: GILDE
       GLIDE
DEGIN: DIGNE
DEGIU: DIGUE
       GUIDE
DEGLO: LODGE
DEGMO: DOGME
DEGNO: GONDE
DEGNU: DEGUN
DEGOR: GODER
DEGOS: DOGES
       GODES
DEGOT: GODET
DEGOU: DOGUE
DEGOZ: GODEZ
DEGSU: DEUGS
DEHLO: DHOLE
DEHNY: HYDNE
DEHOP: EPHOD
DEHOR: HORDE
DEHRY: HYDRE
DEHSS: SHEDS
DEIIM: IMIDE
DEIIO: OIDIE
DEIIT: TIEDI
DEIIX: DIXIE
DEIJU: JEUDI
DEILO: IDOLE
       IODLE
DEILS: LIEDS
       SLIDE
DEILT: DELIT
       LEDIT
       TILDE
DEILU: DEUIL
       DILUE
       DULIE
DEIMN: DENIM
DEIMS: DEMIS
       DIMES
       MEDIS
DEIMT: DEMIT
       MEDIT
DEINR: DINER
DEINS: DENIS
       DINES
       INDES
DEINT: DENTI
DEINU: INDUE
DEINV: DEVIN
DEINX: INDEX
DEINZ: DINEZ
DEIOP: PODIE
DEIOR: IODER
       ROIDE
DEIOS: IODES
       OSIDE
DEIOT: EDITO
DEIOV: DOIVE
       OVIDE
       VIDEO
DEIOX: IXODE
DEIOZ: IODEZ
       ZOIDE
DEIPS: PIEDS
DEIPT: DEPIT
DEIRR: RIDER
DEIRS: DESIR
       DIRES
       REDIS
       RIDES
DEIRT: REDIT
DEIRV: DRIVE
       VERDI
       VIDER
DEIRZ: DIREZ
       RIDEZ
DEISS: DISES
       DISSE
DEIST: DITES
       EDITS
DEISU: SUIDE
DEISV: DEVIS
       DIVES
       VIDES
DEITU: DUITE
DEIUX: DIEUX
DEIVZ: VIDEZ
DEJLO: JODEL
       JODLE
DEJNU: DJEUN
DEKNO: KENDO
DEKNU: DUNKE
DEKRU: KURDE
DEKSS: DESKS
DEKSY: DYKES
DELNO: LODEN
       NDOLE
DELOR: DOLER
       DROLE
DELOS: DOLES
       SOLDE
DELOT: DELOT
DELOY: YODEL
       YODLE
DELOZ: DOLEZ
DELPU: DEPLU
DELSU: DUELS
DELSV: VELDS
DELTV: VELDT
DEMMO: MODEM
DEMNO: DEMON
       MONDE
DEMOR: DORME
       DROME
       MORDE
DEMOS: DEMOS
       DOMES
       MODES
DEMOU: EMOUD
DEMPU: PEDUM
DEMSU: DUMES
       SEDUM
DENNO: DONNE
DENOO: ODEON
DENOP: PONDE
DENOR: DONER
       DRONE
       NORDE
       REDON
       RONDE
DENOS: ENDOS
       ONDES
       SEDON
       SONDE
DENOT: TONDE
DENOU: NOEUD
DENOV: DEVON
DENOY: DOYEN
DENPR: PREND
DENPS: PENDS
DENPU: PENDU
DENRS: NERDS
       RENDS
DENRT: TREND
DENRU: RENDU
DENRY: DERNY
DENST: DENTS
       TENDS
DENSU: DUNES
DENSV: VENDS
DENSY: DYNES
DENSZ: ZENDS
DENTU: DENTU
       TENDU
DENUV: VENDU
DEOOR: RODEO
DEOPR: DOPER
       DROPE
DEOPS: DOPES
DEOPT: DEPOT
DEOPZ: DOPEZ
DEORR: DORER
       ORDRE
       RODER
DEORS: DORES
       DOSER
       RODES
DEORT: DOTER
       TORDE
DEORU: DOUER
       ODEUR
DEORX: REDOX
DEORZ: DOREZ
       RODEZ
DEOSS: DOSES
       DOSSE
       SODES
DEOST: DOTES
DEOSU: DOUES
       OUEDS
       SOUDE
DEOSZ: DOSEZ
DEOTU: DOUTE
DEOTV: DEVOT
DEOTX: DETOX
DEOTZ: DOTEZ
DEOUV: DOUVE
DEOUZ: DOUEZ
       DOUZE
DEOXY: OXYDE
DEPRS: PERDS
DEPRU: DRUPE
       DUPER
       PERDU
       PRUDE
DEPSU: DUPES
DEPUZ: DUPEZ
DEQUU: DUQUE
DERRU: DURER
DERSU: DRUES
       DRUSE
       DURES
       REDUS
       RUDES
DERTU: REDUT
DERUZ: DRUZE
       DUREZ
DESSU: DUSES
       DUSSE
DESTU: DEUST
       DUTES
DETUV: DUVET
DFIMO: MODIF
DFIOR: FIORD
       FROID
DFIRT: DRIFT
DFJOR: FJORD
DFLOO: FLOOD
DFNOS: FONDS
DFNOU: FONDU
DFOSU: DOUFS
DGIIT: DIGIT
DGINO: DIGON
       DINGO
DGINR: DRING
DGIOT: DOIGT
DGNOO: DOGON
DGNOS: DONGS
       GONDS
DGNOU: DUGON
DGORS: GORDS
DGORU: GOURD
DHIIN: HINDI
DHIKR: DHIKR
DHIOS: SHIDO
DHIOT: DHOTI
DHOOR: RHODO
DHORU: HOURD
DIIMS: MIDIS
DIINR: INDRI
DIINV: DIVIN
DIIOR: ROIDI
DIIOT: IDIOT
DIIRT: TRIDI
DIISS: SIDIS
DIISV: DIVIS
DIITX: DIXIT
DIJNN: DJINN
DIKNR: DRINK
DILLR: DRILL
DILNO: INDOL
DILNU: LUNDI
DILOR: DIRLO
DILOS: DIOLS
       LIDOS
DIMOR: DORMI
DIMSU: MUIDS
DINNO: ONDIN
DINOR: DORIN
       NORDI
       RONDI
DINOU: INDOU
DINSU: INDUS
DIOPS: DISPO
       POIDS
DIORS: DORIS
       ORDIS
DIORT: DROIT
DIORU: OURDI
DIOST: DIOTS
       DOITS
DIOTV: DIVOT
DIRTU: DURIT
DISTU: DUITS
DJOOS: DOJOS
DJOSU: JUDOS
DJRUU: JUDRU
DKNOO: KONDO
DKNSU: DUNKS
DKOUY: KYUDO
DLLOY: DOLLY
       LLOYD
DLMUU: MULUD
DLOOS: DOLOS
DLORS: LORDS
DLORU: LOURD
DMNOU: MOUND
DMORS: MORDS
DMORU: MORDU
DMOSU: DOMUS
       DOUMS
       MOUDS
DMRSU: DRUMS
DMRUU: DURUM
DNOOR: RONDO
DNOOS: SNOOD
DNOOT: TONDO
DNOPS: PONDS
DNOPU: PONDU
       POUND
DNORS: RONDS
DNORU: ROUND
DNOST: TONDS
DNOSU: UDONS
DNOTU: DONUT
       TONDU
DOORS: ORDOS
DOORU: DOURO
DOPRS: DROPS
       PRODS
DORST: TORDS
DORSU: SOURD
DORTU: TORDU
       TOURD
DPSUU: PUDUS
DRSUU: URDUS
DSSTU: STUDS
EEEFL: FELEE
EEEFT: FETEE
EEEGK: GEEKE
EEEGL: GELEE
EEEGN: EGEEN
       GENEE
EEEGR: GEREE
       GREEE
EEEGU: GUEEE
EEEHL: HELEE
EEEIL: ELIEE
EEEIM: EMIEE
EEEIP: EPIEE
EEEJT: JETEE
EEEKT: TEKEE
EEELM: MELEE
EEELP: EPELE
       PELEE
EEELS: LESEE
EEELU: ELUEE
EEELV: ELEVE
       LEVEE
EEELZ: ZELEE
EEEMM: MEMEE
EEEMN: MENEE
EEEMS: SEMEE
EEENR: RENEE
EEENT: ENTEE
EEEPP: PEPEE
EEEPS: EPEES
       PESEE
EEEPT: PETEE
EEERV: REVEE
EEESW: EWEES
EEESX: SEXEE
EEETT: ETETE
       TETEE
EEEVX: VEXEE
EEFFT: EFFET
EEFGI: FIGEE
EEFIK: KEFIE
       KIFEE
EEFIL: FILEE
EEFIM: MEFIE
EEFIP: PIFEE
EEFIR: FERIE
       FIERE
EEFIS: FIEES
EEFIX: FIXEE
EEFLL: FELLE
EEFLN: ENFLE
       NEFLE
EEFLR: FELER
       FERLE
       FRELE
EEFLS: ELFES
       FELES
EEFLU: FEULE
EEFLZ: FELEZ
EEFMM: FEMME
EEFMR: FERME
EEFMU: FUMEE
EEFNO: FOENE
EEFNR: ENFER
       FRENE
EEFNT: FENTE
EEFNU: ENFEU
EEFOR: FOREE
EEFOU: FOUEE
EEFOX: FOXEE
EEFRR: FERRE
       FRERE
EEFRT: FERTE
       FETER
       FRETE
EEFRU: FERUE
EEFRZ: FEREZ
EEFSS: FESSE
EEFST: FETES
EEFSU: FEUES
       FUSEE
EEFSV: FEVES
EEFTU: ETEUF
       FUTEE
EEFTZ: FETEZ
EEGGO: GOGEE
EEGGR: GREGE
EEGHS: GHEES
EEGIL: ELEGI
       LIEGE
EEGIM: GEMIE
       MEGIE
EEGIN: GENIE
       IGNEE
       NEIGE
EEGIP: EPIGE
       PIEGE
       PIGEE
EEGIR: ERIGE
       REGIE
EEGIS: SIEGE
EEGIT: ETIGE
       GITEE
EEGIX: EXIGE
EEGJU: JUGEE
EEGKS: GEEKS
EEGLN: GLENE
EEGLO: ELOGE
       GEOLE
       GOLEE
       LOGEE
EEGLR: GELER
       GERLE
       GRELE
       LEGER
       REGEL
       REGLE
EEGLS: GELES
       LEGES
EEGLU: GLUEE
       LEGUE
       LUGEE
EEGLZ: GELEZ
EEGMM: GEMME
EEGMR: GERME
EEGNR: GENER
       GENRE
       GREEN
       GRENE
       REGNE
EEGNS: GENES
EEGNT: GENET
       GENTE
       GNETE
       TENGE
EEGNV: VENGE
EEGNW: WENGE
EEGNZ: GENEZ
EEGPR: PEGRE
EEGPU: GUEPE
       PEGUE
EEGRR: GERER
       GREER
EEGRS: GERES
       GREES
       GRESE
       SERGE
EEGRU: GUEER
       GUERE
EEGRV: GREVE
       VERGE
EEGRZ: GEREZ
       GREEZ
EEGSS: GESSE
EEGST: GESTE
EEGSU: GUEES
EEGTU: GUETE
EEGUZ: GUEEZ
       GUEZE
EEHIS: HIEES
EEHLR: HELER
EEHLS: HELES
EEHLZ: HELEZ
EEHMR: RHEME
EEHMS: HEMES
EEHMT: THEME
EEHMU: HUMEE
EEHNN: HENNE
EEHNY: HYENE
EEHOU: HOUEE
EEHOV: EVOHE
EEHPR: HERPE
EEHRS: HERES
       HERSE
EEHRT: ETHER
       HETRE
EEHRU: HEURE
EEHRV: HERVE
EEHST: THESE
EEHSU: HUEES
EEHTT: THETE
EEIKL: LIKEE
EEIKS: SKIEE
EEILM: ELEMI
       ELIME
       LIMEE
EEILN: ENLIE
EEILP: EPILE
       PILEE
       PLIEE
EEILR: ELIER
       ELIRE
       RELIE
EEILS: ELEIS
       ELIES
       ELISE
       LIEES
EEILT: ELITE
       LITEE
EEILU: LIEUE
EEILV: EVEIL
       VELIE
       VIELE
EEILX: EXILE
       LEXIE
EEILZ: ELIEZ
EEIMM: MIMEE
EEIMN: MINEE
       NIEME
EEIMR: EMERI
       EMIER
       MIREE
       RIMEE
EEIMS: EMIES
       EMISE
       MISEE
       SEIME
EEIMT: MITEE
EEIMX: MIXEE
       XIEME
EEIMZ: EMIEZ
EEINN: INNEE
EEINP: EPINE
       PEINE
EEINR: ERINE
       REINE
       RENIE
EEINS: NIEES
       SEINE
EEINV: ENVIE
       VEINE
       VINEE
EEINX: EXINE
EEINZ: ZEINE
EEIPP: PEPIE
       PIPEE
EEIPR: EPIER
       PERIE
       PRIEE
       RIPEE
EEIPS: EPIES
EEIPT: EPITE
       PIETE
       TIPEE
EEIPU: EPIEU
EEIPX: EXPIE
EEIPZ: EPIEZ
       PIEZE
EEIRS: RISEE
       SERIE
EEIRT: ETIER
       ETIRE
       ITERE
       TIREE
       TRIEE
EEIRV: EVIER
       RIVEE
       VIREE
EEIRZ: REIEZ
EEISV: VISEE
EEISX: IXEES
EEISZ: SEIZE
EEITV: EVITE
EEITZ: ETIEZ
EEJKR: JERKE
EEJKT: KETJE
EEJNU: ENJEU
       JEUNE
EEJOU: JOUEE
EEJPS: JEEPS
EEJRT: JETER
       REJET
EEJRU: JUREE
EEJRZ: JEREZ
EEJSS: JESES
EEJST: EJETS
       JETES
EEJSU: JUSEE
EEJSZ: JEZES
EEJTT: JETTE
EEJTZ: JETEZ
EEKKS: KEKES
EEKOP: PEKOE
EEKPT: PEKET
EEKRS: ESKER
EEKST: SKEET
       TEKES
EELLP: PELLE
EELLS: ELLES
       SELLE
EELLT: TELLE
EELLV: VELLE
EELMM: LEMME
EELMO: MELOE
EELMR: MELER
       MERLE
EELMS: MELES
EELMU: EMULE
       MEULE
EELMY: ELYME
EELMZ: MELEZ
EELNO: LEONE
EELNT: LENTE
EELNU: LUNEE
EELOP: POELE
EELOT: ETOLE
       TOLEE
EELOU: LOUEE
EELOV: LOVEE
       VOLEE
EELOX: ELOXE
EELPR: LEPRE
       PELER
       PERLE
       PRELE
EELPS: PELES
EELPT: LEPTE
       PELTE
EELPU: PEULE
EELPZ: PELEZ
EELRS: LESER
       REELS
EELRU: ELUER
       REELU
       RELUE
EELRV: LEVER
       LEVRE
       VELER
EELRY: LYREE
EELSS: LESES
EELST: LESTE
       STELE
       TELES
EELSU: ELUES
       SEULE
EELSV: LEVES
       SELVE
       VELES
EELSY: LYSEE
EELSZ: LESEZ
       ZELES
EELTT: LETTE
EELTU: LUTEE
EELTV: VELET
       VELTE
EELTX: TELEX
EELUV: VELUE
       VEULE
EELUX: LUXEE
EELUZ: ELUEZ
EELVZ: LEVEZ
       VELEZ
EEMMN: MNEME
EEMMS: MEMES
EEMNO: NOEME
EEMNR: MENER
EEMNS: MENES
       MENSE
       NEEMS
       NEMES
EEMNT: MENTE
EEMNU: MENUE
       NEUME
EEMNZ: MENEZ
EEMOP: POEME
EEMOR: MOERE
EEMOT: METEO
       TOMEE
EEMOY: MOYEE
EEMPR: PERME
EEMPT: TEMPE
EEMRS: MERES
       SEMER
EEMRT: METRE
       REMET
       TERME
EEMRU: MEURE
       MUREE
       REMUE
EEMSS: MESSE
       SEMES
EEMST: EMETS
       TMESE
EEMSU: EMEUS
       EMUES
       EUMES
       MUEES
       MUSEE
EEMSZ: MEZES
       SEMEZ
EEMTT: METTE
EEMTU: EMEUT
       MEUTE
       MUTEE
EEMUV: MEUVE
EEMZZ: MEZZE
EENNP: PENNE
EENNR: RENNE
EENNS: NENES
       SENNE
EENOR: ORNEE
EENOS: NOESE
EENOT: NOTEE
EENOU: ENOUE
       NOUEE
EENOV: NOVEE
EENOY: NOYEE
EENOZ: OZENE
       ZONEE
EENPR: NEPER
EENPS: NEPES
       PENES
       PENSE
EENPT: PENTE
EENRS: NERES
       RENES
EENRT: ENTER
       ENTRE
       REENT
       RENTE
       TERNE
EENRV: VERNE
EENSS: SENES
       SENSE
EENST: ENTES
       SENTE
EENSU: NUEES
       USNEE
EENSV: NEVES
       VENES
EENTT: NETTE
       TENTE
EENTU: TENUE
       TUNEE
EENTV: EVENT
       VENET
       VENTE
EENTW: TWEEN
EENTZ: ENTEZ
       TENEZ
EENUV: NEUVE
       NEVEU
       VENUE
EENVZ: VENEZ
EENWZ: WENZE
EEOPR: OPERE
EEOPS: POSEE
EEOPT: POETE
       POTEE
       TOPEE
EEORS: OREES
       ROSEE
EEORT: ROTEE
       TOREE
EEORU: ROUEE
EEOSS: OSEES
EEOST: OTEES
EEOSV: OVEES
EEOTU: TOUEE
EEOTV: VOTEE
EEOUV: OEUVE
       VOUEE
EEPPS: PEPES
EEPRR: PERRE
EEPRS: PERES
       PERSE
       PESER
       SERPE
EEPRT: PERTE
       PETER
       PETRE
       PRETE
EEPRU: EPURE
       PUREE
       REPUE
       RUPEE
EEPSS: PESES
       PESSE
EEPST: PESTE
       PETES
EEPSU: PUEES
       SUPEE
EEPSV: PEVES
EEPSZ: PESEZ
       PEZES
EEPTT: PETTE
EEPTY: TYPEE
EEPTZ: PETEZ
EEQRU: QUEER
EEQSU: SEQUE
EEQTU: QUETE
EEQUU: QUEUE
EERRR: ERRER
EERRS: ERRES
       SERRE
EERRT: TERRE
EERRV: REVER
       VERRE
EERRZ: ERREZ
EERSS: ERSES
       SERES
EERST: ESTER
       ETRES
       RESTE
       SERTE
       STERE
       TERSE
EERSU: RUEES
       RUSEE
       UREES
EERSV: REVES
       SERVE
       SEVRE
       VERSE
EERSX: SEXER
       XERES
EERSZ: SEREZ
EERTT: TETER
EERTV: REVET
       TREVE
       VERTE
EERUV: REVUE
EERVV: VERVE
EERVX: VEXER
EERVZ: REVEZ
EESSS: ESSES
EESST: ESTES
EESSU: EUSSE
       SUEES
       USEES
EESSV: SEVES
       VESSE
EESSX: SEXES
EESTT: TESTE
       TETES
EESTU: EUTES
       TUEES
EESTV: TEVES
       VESTE
       VETES
EESTX: SEXTE
EESTZ: ZESTE
EESUV: SUEVE
       UVEES
EESUX: SEXUE
EESUY: YEUSE
EESVX: VEXES
EESXZ: SEXEZ
EESYY: YEYES
EETTT: TETTE
EETTU: TETUE
EETTW: TWEET
EETTX: TEXTE
EETTZ: TETEZ
EETUV: ETUVE
       VETUE
EETVZ: VETEZ
EEUVV: VEUVE
EEVXZ: VEXEZ
EFFIK: KIFFE
EFFIP: PIFFE
EFFIR: FIFRE
       RIFFE
EFFIS: FIEFS
EFFIT: TIFFE
EFFOR: OFFRE
EFFST: TEFFS
EFGIL: GELIF
       GIFLE
EFGIR: FIGER
       GRIEF
EFGIS: FIGES
EFGIU: FIGUE
EFGIZ: FIGEZ
EFGLO: GOLFE
EFGNO: FONGE
EFGOR: FORGE
EFGOU: FOUGE
EFGUU: FUGUE
EFHLS: SHELF
EFHNO: FOEHN
       FOHNE
EFIIN: FINIE
EFIIX: FIXIE
EFIIZ: FIIEZ
EFIKR: KEFIR
       KIFER
EFIKS: KIEFS
       KIFES
EFIKZ: KIFEZ
EFILL: FILLE
EFILM: FILME
EFILN: FELIN
       FENIL
       FLEIN
EFILO: FIOLE
       FOLIE
EFILR: FILER
       RIFLE
EFILS: FIELS
       FILES
EFILT: FILET
       LIFTE
EFILU: FEUIL
EFILX: FELIX
EFILZ: FILEZ
EFIMR: FERMI
       FIRME
       FREMI
       FRIME
EFIMS: FIMES
EFINN: ENFIN
EFINR: FREIN
EFINS: FEINS
       FINES
       NIFES
       SNIFE
EFINT: FEINT
       FIENT
EFINU: ENFUI
EFIOR: FOIRE
EFIOS: FOIES
EFIOT: FIOTE
EFIOU: FOUIE
EFIPR: FRIPE
       PERIF
       PIFER
EFIPS: PIFES
EFIPZ: PIFEZ
EFIRR: FERIR
       FRIRE
EFIRS: FIERS
       FRISE
       REFIS
EFIRT: EFRIT
       FRITE
       REFIT
       RETIF
EFIRU: FURIE
EFIRV: REVIF
       VERIF
EFIRX: FIXER
EFISS: FISSE
EFIST: FITES
EFISU: FUIES
       SUIFE
EFISX: FIXES
EFITT: FITTE
EFITU: FUITE
EFIUX: FIEUX
EFIXZ: FIXEZ
EFJLL: FJELL
EFJSU: FEUJS
EFKSU: KEUFS
EFLLO: FOLLE
EFLMO: MOFLE
EFLMU: MUFLE
EFLNO: FELON
EFLNU: FLENU
EFLOR: FLORE
       FROLE
       LOFER
EFLOS: FLOES
       LOFES
EFLOU: FLOUE
       FOULE
EFLOZ: LOFEZ
EFLRU: FLEUR
       FLUER
EFLRY: FLYER
EFLSS: SELFS
EFLST: FLETS
EFLSU: FLUES
       FUELS
       FUSEL
EFLTU: FLUET
       FLUTE
EFLUX: FLUXE
EFLUZ: FLUEZ
EFMOR: FORME
EFMRU: FEMUR
       FUMER
EFMSU: FUMES
       MEUFS
EFMTU: FUMET
EFMUZ: FUMEZ
EFNOR: FREON
EFNOT: FONTE
EFNRS: NERFS
EFNSU: FUNES
       NEUFS
EFOPR: PERFO
EFORR: FORER
EFORS: FORES
EFORT: FORET
       FORTE
EFORU: FROUE
       FUERO
EFORY: FOYER
EFORZ: FOREZ
EFOSS: FOSSE
EFOSU: OEUFS
EFOSX: FOXES
EFOTU: FOUET
       FOUTE
EFPRS: PERFS
EFPSU: PEUFS
EFRRY: FERRY
EFRSS: SERFS
EFRST: FRETS
EFRSU: FERUS
       FUSER
       REFUS
       SURFE
EFRTU: FURET
EFRUX: FREUX
EFSSU: FESSU
       FUSES
       FUSSE
EFSTU: FETUS
       FUSTE
       FUTES
       TEUFS
EFSUV: VEUFS
EFSUZ: FUSEZ
EFTTU: TUFTE
EFUYZ: FUYEZ
EGGHY: HYGGE
EGGIU: GIGUE
EGGJO: JOGGE
EGGOR: GOGER
       GORGE
EGGOS: GOGES
EGGOU: GOUGE
EGGOZ: GOGEZ
EGGRU: GRUGE
EGHOT: GOTHE
EGIIL: LIGIE
EGIIR: GIRIE
EGIIV: VIGIE
EGILL: GILLE
EGILN: LIGNE
       LINGE
EGILS: GLIES
       LIGES
       SIGLE
EGILT: GILET
EGILU: LIGUE
EGIMR: GEMIR
       GRIME
       MEGIR
       MIGRE
EGIMS: GEMIS
       MEGIS
EGIMT: GEMIT
       MEGIT
EGIMU: MUGIE
EGIMZ: MEZIG
EGINN: ENGIN
EGINO: OIGNE
EGINP: PIGNE
EGINS: GEINS
       IGNES
       SEING
       SIGNE
       SINGE
EGINT: GEINT
EGINV: VIGNE
EGIOR: GROIE
       ORGIE
EGIOV: OGIVE
EGIPR: PIGER
EGIPS: PIGES
EGIPU: GUIPE
EGIPZ: PIGEZ
EGIRR: REGIR
EGIRS: GESIR
       GRISE
       REGIS
EGIRT: GITER
       REGIT
       TIGER
       TIGRE
EGIRU: GUERI
       RUGIE
EGIRV: GIVRE
       GRIVE
EGIST: GITES
       TIGES
EGISU: GUISE
       IGUES
EGISZ: GISEZ
       SEZIG
EGITZ: GITEZ
       TEZIG
       TIGEZ
EGIUX: EXIGU
EGIUZ: ZIGUE
EGJRU: JUGER
EGJSU: JUGES
EGJUZ: JUGEZ
EGLMO: GLOME
       GOLEM
EGLMU: GLUME
EGLNO: GNOLE
       LONGE
       ONGLE
EGLOR: ERGOL
       GROLE
       LOGER
       REGLO
EGLOS: GLOSE
       LEGOS
       LOGES
EGLOU: GOULE
       LOGUE
EGLOZ: LOGEZ
EGLRU: GLUER
       LUGER
EGLSU: GLUES
       LUGES
EGLSY: GLEYS
EGLUZ: GLUEZ
       LUGEZ
EGMMO: GOMME
EGMNO: GNOME
EGMOR: MORGE
EGMOT: MEGOT
EGMRU: GRUME
       MURGE
EGMSU: MUGES
EGNOP: POGNE
       PONGE
EGNOR: ROGNE
       RONGE
EGNOS: GNOSE
       GONES
       NEGOS
       SONGE
EGNOU: GENOU
EGNOZ: GONZE
EGNRU: GRENU
EGNST: GENTS
EGNSU: NEGUS
EGOPT: PEGOT
EGORS: GORES
       OGRES
       ORGES
EGORT: ERGOT
       GORET
EGORU: GOURE
       ORGUE
       ROGUE
       ROUGE
EGOSS: GOSSE
EGOST: TOGES
EGOTU: EGOUT
       GOUET
       GOUTE
EGOUV: VOGUE
       VOUGE
EGPRU: PURGE
EGPSY: GYPSE
EGRRU: REGUR
       URGER
EGRSU: GRUES
       SURGE
EGRSY: GYRES
EGRTU: GRUTE
EGRWZ: GWERZ
EGSSU: GUSSE
EGSTU: GUETS
EGUUX: GUEUX
EHHPY: HYPHE
EHIIZ: HIIEZ
EHIKS: SIKHE
EHILO: HELIO
EHILS: HILES
EHILU: HUILE
EHILX: HELIX
EHINN: HENNI
EHINT: HIENT
EHIOP: HOPIE
EHIRS: SHIRE
EHIRV: HIVER
EHISS: HISSE
EHIUZ: HUIEZ
EHKMR: KHMER
EHLLO: HELLO
EHLMS: LEHMS
EHLOS: SHEOL
EHLOT: HOTEL
EHLOU: HOULE
EHLPU: PEUHL
EHLRU: HURLE
EHLSW: WELSH
EHMMO: HOMME
EHMNY: HYMEN
       HYMNE
EHMOS: HOMES
EHMRU: HUMER
       RHUME
EHMSU: HUMES
EHMTY: MYTHE
EHMUZ: HUMEZ
EHNOP: PHONE
EHNOR: HERON
EHNOT: HONTE
EHNPY: HYPNE
EHNRY: HENRY
EHNSU: HUNES
EHNTU: HUENT
       THUNE
EHORS: HEROS
EHORT: RHETO
EHORU: HOUER
EHOST: ETHOS
       HOTES
EHOSU: HOUES
       HOUSE
EHOTT: HOTTE
EHOUZ: HOUEZ
EHPPU: HUPPE
EHPRY: HYPER
EHPSX: SPHEX
EHPSY: HYPES
       PHYSE
EHRSU: HEURS
       HURES
EHRTU: HEURT
EHRTZ: HERTZ
EHTTU: HUTTE
EHTUU: HUTUE
EIIJM: MEIJI
EIIKR: REIKI
EIILN: ILIEN
EIILV: VIEIL
EIILZ: LIIEZ
EIIMN: IMINE
EIIMP: IMPIE
EIIMT: IMITE
EIINR: IRIEN
EIINS: INIES
EIINZ: NIIEZ
EIIPT: PITIE
EIIRS: IRISE
EIIRZ: IRIEZ
       RIIEZ
EIIXZ: IXIEZ
EIJLO: JOLIE
EIJLU: JULIE
EIJMO: EMOJI
EIJOS: JOIES
EIJSV: JIVES
EIJUV: JUIVE
EIKKR: KRIEK
EIKLR: LIKER
EIKLS: LIKES
EIKLZ: LIKEZ
EIKMV: MIKVE
EIKNO: KOINE
EIKNP: PEKIN
EIKNS: KINES
EIKPS: KEPIS
EIKRS: SKIER
EIKRT: TRIKE
EIKRY: KYRIE
EIKSS: SKIES
EIKST: KITES
EIKSZ: SKIEZ
EILLM: MILLE
EILLN: NILLE
EILLO: OILLE
EILLP: PILLE
EILLT: TILLE
EILLV: VILLE
EILMP: EMPLI
EILMR: LIMER
       MILER
EILMS: LIMES
       MIELS
       MILES
EILMZ: LIMEZ
EILNO: ILEON
       NIOLE
EILNP: PENIL
       PLEIN
EILNR: LINER
EILNS: LIENS
EILNT: LIENT
EILNU: INULE
EILNV: VELIN
EILOP: PLOIE
       POILE
       POLIE
EILOR: ORIEL
EILOS: ISOLE
       OEILS
EILOT: ILOTE
       LOTIE
       TOILE
EILOU: IOULE
EILOV: OLIVE
       VIOLE
       VOILE
EILOZ: ZOILE
EILPP: LIPPE
EILPR: PERIL
       PILER
       PLIER
       REPLI
EILPS: PILES
       PLIES
EILPT: PILET
EILPU: PLUIE
EILPX: PIXEL
       PLEXI
EILPZ: PILEZ
       PLIEZ
EILRS: LIRES
       RELIS
       RIELS
       SILER
EILRT: LITER
       LITRE
       RELIT
EILRU: LIEUR
       LIURE
       LUIRE
       RELUI
       RUILE
EILRV: LIVRE
EILRZ: LIREZ
EILSS: LISES
       LISSE
       SILES
EILST: ILETS
       LISTE
       LITES
EILSU: ILEUS
       IULES
       LIEUS
       LUISE
       SEUIL
EILSV: LEVIS
       LIVES
       VILES
EILSX: EXILS
       LEXIS
       SILEX
EILSZ: LISEZ
       SILEZ
EILTT: TILTE
EILTU: TUILE
       UTILE
EILTV: LIVET
EILTZ: LITEZ
EILUX: LIEUX
EIMMO: MOMIE
EIMMR: MIMER
EIMMS: MIMES
EIMMZ: MIMEZ
EIMNN: MENIN
EIMNO: MOINE
EIMNR: MINER
EIMNS: MIENS
       MINES
       NEMIS
EIMNT: MENTI
       MINET
EIMNU: MUNIE
EIMNZ: MINEZ
EIMOR: MOIRE
EIMOS: EMOIS
       MOIES
       MOISE
       OMISE
       OSMIE
EIMOT: MOITE
EIMOV: VOMIE
EIMOX: OXIME
EIMPR: IMPER
       PRIME
EIMPT: TEMPI
EIMQU: MIQUE
EIMRR: MIRER
       RIMER
EIMRS: EMIRS
       MIRES
       MISER
       REMIS
       RIMES
EIMRT: MITER
       MITRE
       REMIT
       TRIME
EIMRU: MURIE
EIMRX: MIXER
       REMIX
EIMRZ: MIREZ
       REMIZ
       RIMEZ
EIMSS: ISMES
       MISES
       MISSE
       SEMIS
EIMST: ITEMS
       METIS
       MITES
EIMSV: VIMES
EIMSX: MIXES
EIMSZ: MISEZ
EIMTX: MIXTE
EIMTZ: MITEZ
EIMUX: MIEUX
EIMUZ: MUIEZ
EIMXZ: MIXEZ
EINNN: NENNI
EINNP: PINNE
EINNS: INNES
EINNT: NIENT
EINNU: ENNUI
       INNUE
EINNV: VENIN
EINNZ: ZINNE
EINOP: OPINE
EINOR: IRONE
       NOIRE
EINOS: NOIES
       NOISE
       SONIE
EINOT: OIENT
       OINTE
       TONIE
EINOV: ENVOI
       OVINE
EINPP: NIPPE
       PEPIN
EINPS: PEINS
       PENIS
       PINES
EINPT: PEINT
       PINTE
EINPU: PUINE
       PUNIE
EINQU: EQUIN
       NIQUE
       QUINE
EINRS: REINS
       RIENS
       SERIN
EINRT: INTER
       NITRE
       RIENT
       TENIR
       TERNI
       TRINE
EINRU: NUIRE
       REUNI
       RUINE
       URINE
EINRV: NERVI
       VENIR
       VERIN
       VERNI
       VINER
EINSS: SEINS
       SIENS
EINST: NIETS
       SENTI
       TEINS
       TIENS
       TINES
EINSU: NUISE
       SINUE
       UNIES
       USINE
EINSV: NIVES
       VIENS
       VINES
EINSX: NIXES
EINTT: TEINT
       TETIN
       TIENT
       TINTE
EINTU: UNITE
EINTV: VIENT
EINTX: IXENT
EINUZ: NUIEZ
EINVZ: VINEZ
EIOPR: POIRE
       PROIE
EIOPS: EPOIS
       POISE
EIORS: OSIER
       ROSIE
       SEOIR
EIORT: ORTIE
       RIOTE
       ROTIE
EIORU: ROUIE
EIORV: VIREO
       VOIRE
EIOSS: SOIES
       SOSIE
EIOST: SOTIE
       TOISE
EIOSU: OUIES
EIOSV: VOIES
       VOISE
EIOSZ: OSIEZ
EIOTT: OTITE
EIOTZ: OTIEZ
EIOYZ: OYIEZ
EIPPR: PIPER
EIPPS: PIPES
EIPPT: TIPPE
EIPPZ: PIPEZ
       ZIPPE
EIPQU: PIQUE
EIPRR: PERIR
       PRIER
       RIPER
EIPRS: EPRIS
       PERIS
       PIERS
       PIRES
       PRIES
       PRISE
       RIPES
       SPIRE
EIPRT: EPRIT
       PERIT
       PETRI
       PITRE
       REPIT
       TIPER
       TRIPE
EIPRV: PRIVE
EIPRZ: PRIEZ
       RIPEZ
EIPSS: PISES
       PISSE
EIPST: PISTE
       PITES
       SPITE
       STIPE
       TIPES
EIPSU: PUISE
EIPSV: PIVES
EIPTT: PETIT
EIPTU: TEPUI
       TUPIE
EIPTZ: TIPEZ
EIPUX: PIEUX
EIPUZ: PUIEZ
EIQTU: QUIET
       TIQUE
EIRRS: RIRES
       RISER
EIRRT: TERRI
       TIRER
       TRIER
EIRRU: RIEUR
EIRRV: RIVER
       VIRER
EIRRZ: RIREZ
EIRSS: RISSE
       SIRES
EIRST: RISTE
       RITES
       SERTI
       STRIE
       TIERS
       TIRES
       TISER
       TRIES
EIRSU: SIEUR
       SURIE
EIRSV: IVRES
       REVIS
       RIVES
       SERVI
       SEVIR
       VIRES
       VISER
EIRSX: RIXES
       SIREX
EIRTT: TIRET
       TITRE
EIRTU: TRUIE
EIRTV: REVIT
       RIVET
       VETIR
       VITRE
EIRTZ: TIREZ
       TRIEZ
EIRUZ: RUIEZ
EIRVV: VIVRE
EIRVZ: RIVEZ
       VIREZ
EISSS: SISES
EISST: SITES
       TISES
       TISSE
EISSU: ISSUE
       SUIES
EISSV: SEVIS
       VISES
       VISSE
EISTU: ETUIS
       SITUE
       SUITE
       USITE
EISTV: SEVIT
       VETIS
       VIETS
       VITES
EISTX: EXITS
       SIXTE
EISTY: YETIS
EISTZ: TISEZ
EISUV: SUIVE
EISUZ: SUIEZ
       USIEZ
EISVV: VIVES
EISVZ: VISEZ
EITTU: TUTIE
EITTV: VETIT
EITUZ: TUIEZ
EIUVX: VIEUX
EIVVZ: VIVEZ
EJKOR: JOKER
EJKRS: JERKS
EJLLO: JELLO
EJLMU: JUMEL
EJLOP: POLJE
EJLOU: JOULE
EJLPU: JULEP
EJLSU: JULES
EJMPU: JUMPE
EJNNY: JENNY
EJNOT: JETON
EJNTU: JUNTE
EJORU: JOUER
EJOSU: JOUES
EJOTU: JOUET
       JOUTE
EJOUZ: JOUEZ
EJPSU: JUPES
EJRRU: JURER
EJRSU: JURES
EJRTU: JUTER
EJRUZ: JUREZ
EJSSU: JESUS
EJSTU: JUSTE
       JUTES
       SUJET
       TEJUS
EJTUZ: JUTEZ
EKLMR: KREML
EKLOO: LOOKE
EKLPS: KELPS
EKMSU: KEUMS
EKNRS: KERNS
EKOPR: POKER
EKOPS: POKES
EKORS: KORES
EKORT: KOTER
EKOST: KOTES
EKOSW: WOKES
EKOTZ: KOTEZ
EKOUZ: ZOUKE
EKRST: TREKS
EKRTW: TWERK
EKSTY: KYSTE
ELLMO: MOLLE
ELLNS: NELLS
ELLNU: NULLE
ELLOR: ROLLE
ELLOT: TOLLE
ELLST: TELLS
ELLTU: TULLE
ELLUU: ULULE
ELMNO: MELON
       MONEL
ELMNU: LUMEN
ELMOP: LOMPE
ELMOS: MELOS
       MOLES
ELMOT: MOTEL
ELMOU: MOULE
       OLEUM
ELMPU: PLUME
ELMRS: MERLS
ELMRU: LEMUR
       MERLU
ELMSU: LUMES
       MULES
ELMTU: MULET
ELMUV: VELUM
ELNOS: ENOLS
       LONES
       NOELS
       SELON
       SOLEN
ELNOT: LENTO
ELNOV: ENVOL
ELNST: LENTS
ELNSU: LUNES
ELNTU: UNTEL
ELOPS: POLES
ELOPU: LOUPE
       POULE
ELOPY: PLOYE
ELOQU: LOQUE
ELORS: LOSER
       ORLES
       ROLES
ELORT: LEROT
       TOLER
       TROLE
ELORU: LOUER
       LOURE
       OURLE
       RELOU
       ROULE
ELORV: LOVER
       VOLER
ELORY: LOYER
ELOSS: LOESS
       LOSES
       SOLES
ELOST: LOTES
       TOLES
ELOSU: LOUES
       SOULE
ELOSV: LOVES
       VELOS
       VOLES
ELOSX: SOLEX
ELOSY: YOLES
ELOTT: LOTTE
       TOLET
ELOTV: VELOT
       VOLET
       VOLTE
ELOTZ: TOLEZ
ELOUV: LOUVE
       OVULE
ELOUZ: LOUEZ
ELOVV: VOLVE
ELOVZ: LOVEZ
       VOLEZ
ELPPU: PULPE
ELPRU: PLEUR
       REPLU
ELPSU: PEULS
       PULSE
ELPTU: PLEUT
ELQSU: QUELS
ELRRY: LYRER
ELRSU: LEURS
       RELUS
ELRSY: LYRES
       LYSER
ELRTU: LUTER
       RELUT
ELRUU: LUEUR
ELRUX: LUREX
       LUXER
ELRYZ: LYREZ
ELSST: LESTS
ELSSU: LUSSE
       SEULS
ELSSY: LYSES
ELSTU: LUTES
ELSTY: STYLE
ELSTZ: SELTZ
ELSUU: USUEL
ELSUV: ULVES
       VELUS
ELSUX: LUXES
ELSVY: SYLVE
ELSYZ: LYSEZ
ELTTU: LUTTE
ELTUZ: LUTEZ
ELUUV: UVULE
ELUVV: VULVE
ELUVX: VELUX
ELUXZ: LUXEZ
EMMNO: NOMME
EMMOP: POMME
EMMOS: MEMOS
       MOMES
       SOMME
EMMOT: TOMME
EMMOY: MYOME
EMMST: STEMM
EMMSU: MUMES
EMNNO: MENON
EMNOP: MONEP
EMNOR: MORNE
       NORME
       RENOM
EMNOS: MESON
       NOMES
EMNOT: MONTE
EMNOY: MOYEN
EMNRU: RUMEN
EMNSU: MENUS
EMNTU: MUENT
EMOOR: MOORE
EMOOZ: ZOOME
EMOPP: POMPE
EMOPR: EPROM
       ROMPE
EMOPT: TEMPO
EMOPY: MYOPE
EMOQU: MOQUE
EMORS: MORES
       MORSE
       ORMES
EMORT: METRO
       MORTE
       ORMET
       TOMER
EMORU: MEROU
       MORUE
EMORV: MORVE
       VOMER
EMORY: MOYER
EMOST: OMETS
       TOMES
EMOSU: EMOUS
       MOUES
EMOSY: MOYES
EMOTT: MOTET
       MOTTE
       TOMTE
       TOTEM
EMOTZ: TOMEZ
EMOUY: MOYEU
EMOYZ: MOYEZ
EMOZZ: MEZZO
EMPRS: PERMS
EMPST: TEMPS
EMPSU: PUMES
       SPUME
EMRRU: MURER
EMRSU: MEURS
       MURES
       MUSER
       SERUM
EMRTU: MEURT
       MURET
       MUTER
EMRTY: MYRTE
EMRUX: MUREX
       RUMEX
EMRUZ: MUREZ
EMSST: STEMS
EMSSU: MUSES
       MUSSE
       SEUMS
       SUMES
EMSTU: MUETS
       MUTES
       TUMES
EMSUZ: MUSEZ
EMTUZ: MUTEZ
ENNNO: NONNE
ENNOP: PENON
ENNOR: RENON
ENNOS: NEONS
       NONES
       ONSEN
       SONNE
ENNOT: TENNO
       TENON
       TONNE
ENNOX: XENON
ENNPY: PENNY
ENNTU: NUENT
ENOOR: RONEO
ENOOZ: OZONE
ENOPP: PEPON
ENOPR: PRONE
ENOPS: OPENS
       PENOS
       PEONS
       PESON
ENOPT: PETON
       PONTE
ENOPY: PONEY
ENORR: ORNER
ENORS: ORNES
       REONS
ENORT: ETRON
       NOTER
       NOTRE
       TENOR
       TONER
       TRONE
ENORU: NOUER
ENORV: NOVER
ENORY: NOYER
ENORZ: ORNEZ
       ZONER
ENOSS: SONES
ENOST: NOTES
       OSENT
       SETON
       STENO
       STONE
ENOSU: NOUES
ENOSV: NOVES
ENOSX: EXONS
ENOSY: NOYES
ENOSZ: ZONES
ENOTT: OTENT
       TETON
       TONTE
ENOTU: NOUET
ENOTZ: NOTEZ
ENOUZ: NOUEZ
ENOVZ: NOVEZ
ENOYZ: NOYEZ
ENOZZ: ZONEZ
ENPRU: PRUNE
ENPSU: PNEUS
ENPTU: PENTU
       PETUN
       PUENT
ENPTY: PENTY
ENQUU: NUQUE
ENRSU: NUERS
       NURSE
       RUNES
       URNES
ENRTU: RUENT
       TUNER
       TURNE
ENSTT: STENT
ENSTU: SUENT
       TENUS
       TUNES
       USENT
ENSTV: VENTS
ENSUV: VENUS
ENTTU: TUENT
ENTUZ: TUNEZ
EOOST: OSTEO
EOPPS: POPES
EOPPU: POUPE
EOPQU: POQUE
EOPRR: REPRO
EOPRS: PERSO
       PORES
       POSER
       PROSE
       PSORE
       REPOS
       SPORE
EOPRT: OPTER
       PEROT
       PORTE
       POTER
       PROTE
       TOPER
       TROPE
EOPRU: PROUE
EOPSS: PESOS
       POSES
       SPEOS
EOPST: OPTES
       PESTO
       POSTE
       POTES
       PTOSE
       TOPES
EOPSU: SOUPE
EOPSX: EXPOS
EOPSZ: POSEZ
EOPTT: PETTO
       POTET
EOPTU: POTUE
       POUET
EOPTZ: OPTEZ
       POTEZ
       TOPEZ
EOPUX: EPOUX
EOPXY: EPOXY
EOQRU: ORQUE
       ROQUE
EOQSU: OSQUE
EOQTU: TOQUE
EORRS: ROSER
EORRT: RETRO
       ROTER
EORRU: ROUER
EORRV: ROVER
EORSS: ESSOR
       ROSES
       ROSSE
       SORES
EORST: RESTO
       ROTES
       SORTE
       STORE
       TORES
       TORSE
EORSU: EUROS
       OURSE
       ROUES
       SOEUR
EORSV: VERSO
EORSX: OXERS
EORSY: SOYER
EORSZ: ROSEZ
       ZEROS
       ZORSE
EORTT: TORTE
EORTU: OUTRE
       ROUET
       ROUTE
       TOUER
       TOURE
       TROUE
       UTERO
EORTV: ORVET
       TORVE
       VOTER
       VOTRE
EORTZ: ROTEZ
EORUV: OUVRE
       VOUER
EORUZ: ROUEZ
EORVY: VOYER
EOSST: TOSSE
EOSSU: OSSUE
       SOUES
EOSTT: SOTTE
EOSTU: OUEST
       OUSTE
       SOUTE
       TOUES
EOSTV: VETOS
       VOTES
EOSTX: SEXTO
EOSUV: VESOU
       VOUES
EOSYZ: SOYEZ
EOTTU: TOUTE
EOTTX: TEXTO
EOTUV: VOUTE
EOTUZ: TOUEZ
EOTVZ: VOTEZ
EOUVX: VOEUX
EOUVZ: VOUEZ
EOVYZ: VOYEZ
EPPSU: PUPES
EPRRU: RUPER
EPRST: PRETS
EPRSU: PEURS
       PURES
       REPUS
       RUPES
       SPRUE
       SUPER
EPRTU: REPUT
EPRTY: TYPER
EPRUV: PREVU
EPRUX: PREUX
EPRUZ: RUPEZ
EPRXY: PYREX
EPSST: SPETS
       STEPS
EPSSU: PUSSE
       SUPES
EPSTU: PUTES
EPSTY: TYPES
EPSUZ: SUPEZ
EPTTU: PUTTE
EPTYZ: TYPEZ
EQTUU: TUQUE
EQUUX: QUEUX
ERRSU: RUSER
ERSSU: RUSES
       RUSSE
       SURES
ERSTU: SURET
ERSTV: VERTS
ERSTY: SYRTE
ERSUU: SUEUR
       USURE
ERSUV: REVUS
ERSUX: XERUS
ERSUZ: RUSEZ
ERTUU: TUEUR
ERTUV: VERTU
ESSSU: SUSSE
ESSTT: TESTS
ESSTU: SUTES
       TUSSE
ESSXY: SEXYS
ESTTU: TETUS
       TUTES
ESTUV: VETUS
ESTXY: XYSTE
FFIIS: FIFIS
FFIKS: KIFFS
       SKIFF
FFINS: SNIFF
FFIRS: RIFFS
FFISU: SUFFI
FGIOR: FRIGO
FGIST: GIFTS
FGLOS: GOLFS
FGNOU: GNOUF
FGSUU: FUGUS
FHIIS: HIFIS
FHIOT: THIOF
FHIQS: FIQHS
FHIRT: FIRTH
FHIST: SHIFT
FHLSU: FLUSH
FHNOS: FOHNS
FIILN: FILIN
FIINR: FINIR
FIINS: FINIS
FIINT: FINIT
FIINX: FIXIN
FIIOS: OISIF
FIISW: WIFIS
FIJSU: JUIFS
FIKSS: SKIFS
FILMO: FILMO
FILMS: FILMS
FILNO: FILON
FILNT: FLINT
FILOO: FOLIO
FILOS: FILOS
       FOILS
FILOU: FILOU
       FIOUL
FILPS: FLIPS
FILRT: FLIRT
FILST: LIFTS
FILSU: FUSIL
FIMOT: MOTIF
FIMTU: MUFTI
FINNS: FINNS
FINNU: FUNIN
FINOO: FONIO
FINOS: FIONS
       FOINS
       INFOS
FINOX: INFOX
FINSS: SNIFS
FINSU: INFUS
       UNIFS
FIORU: FOUIR
FIOSS: SOIFS
FIOST: TIFOS
FIOSU: FOUIS
       SOUFI
FIOTU: FITOU
       FOUIT
       OUFTI
FIOTV: VOTIF
FIRST: FRITS
       RIFTS
FIRTU: FRUIT
FIRTZ: FRITZ
FISSU: SUFIS
       SUIFS
FKLOS: FOLKS
FKNSU: FUNKS
FKNUY: FUNKY
FLLSU: FULLS
FLOOW: WOLOF
FLOPS: FLOPS
FLOPU: PLOUF
FLORU: FLUOR
FLOST: FLOTS
       LOFTS
FLOSU: FLOUS
       FLUOS
       LOUFS
FLOSW: FLOWS
FMORU: FORUM
FMRSU: SMURF
FNORT: FRONT
FNOST: FONTS
FNOTU: FUTON
FOORS: ROOFS
FOOST: FOOTS
FOPRS: PROFS
FOPSU: POUFS
FORST: FORTS
FORSU: FOURS
       ROUFS
FOSST: SOFTS
FOSTU: TOFUS
FOTUU: FOUTU
FRSSU: SURFS
FRSTU: TURFS
FRTUU: FUTUR
GGILO: GOLGI
GGIOT: GIGOT
GGLOU: GOGLU
GGNOS: GONGS
GGOOS: GOGOS
GGORS: GROGS
GGSUU: GUGUS
GHILT: LIGHT
GHIOS: SHOGI
GHISW: WHIGS
GHORU: ROUGH
GHOST: GOTHS
GHSTU: THUGS
GIILU: GUILI
GIILV: VIGIL
GIJOS: GOJIS
GILLR: GRILL
GILNO: LOGIN
GILOO: IGLOO
GILOS: LOGIS
GILOT: LIGOT
GILOU: IGLOU
GILRS: GIRLS
       GRILS
GILRY: GIRLY
GILSU: GLUIS
GIMNS: MINGS
GIMOY: GOYIM
GIMRU: MUGIR
GIMSU: MUGIS
GIMTU: MUGIT
GINOO: GONIO
GINOP: POING
GINOR: GIRON
       GROIN
GINOS: OINGS
GINOT: GITON
GINQS: QINGS
GINRS: RINGS
GINRY: GYRIN
GINSU: UGNIS
GINSW: SWING
GINTV: VINGT
GIORT: GRIOT
       TRIGO
GIORU: ROUGI
GIOSY: YOGIS
GIPRS: GRIPS
GIPSY: GIPSY
GIRRU: RUGIR
GIRSU: RUGIS
       SURGI
GIRTU: RUGIT
GIRVY: GIVRY
GJOSU: JOUGS
GKNOO: KONGO
GLMOO: MOGOL
GLNOS: LONGS
GLNOU: GLUON
GLOOS: LOGOS
GLOPU: GLOUP
GLOSS: GLOSS
GLOSV: VLOGS
GLOUU: GOULU
GLOUV: VULGO
GLPSU: PLUGS
GMNOU: MUNGO
GMOOR: GROOM
GMOSS: SMOGS
GMOSU: GOUMS
GNNOO: OGNON
GNNOS: GNONS
GNOOR: GORON
GNOOT: GOTON
GNOOZ: GONZO
GNORU: GRUON
GNOSS: SONGS
GNOST: TONGS
GNOSU: GNOUS
GOOPS: POGOS
GOORS: SORGO
GOORU: GOURO
GOPRU: GROUP
GORSU: GOURS
GORSY: GYROS
GOSTU: GOUTS
GOTUU: GOUTU
GOTUY: GUYOT
GPPUY: GUPPY
GRSUU: GURUS
GRSUY: GYRUS
HIIRS: RISHI
HIKNO: KHOIN
HIKOS: HOKIS
HIKSS: SIKHS
HILOP: PHILO
HILOT: LITHO
       THIOL
HINNO: HONNI
HINOR: RHINO
HINOS: HIONS
HINTU: HUTIN
HIOPP: HIPPO
HIOPS: HOPIS
HIOPX: XIPHO
HIORS: HOIRS
HIORU: HOURI
HIOST: ITHOS
HIPPY: HIPPY
HIPSW: WHIPS
HISST: SHITS
HISSU: SUSHI
HISTW: WHIST
HKLOO: KOHOL
HKLOS: KHOLS
HKORS: ROKHS
HKSUY: HUSKY
HLOPX: PHLOX
HLSSU: SLUSH
HLSTU: LUTHS
HMOOS: HOMOS
       MOHOS
HMOTY: MYTHO
HMRSU: RHUMS
HMSTY: THYMS
HMSUU: HUMUS
HNOOP: PHONO
HNORU: HURON
HNOST: THONS
HNOSU: HUONS
HNSTU: SHUNT
HOOPT: PHOTO
HOOST: HOSTO
       SHOOT
       SOTHO
HOPST: PHOTS
HORST: HORST
       SHORT
HOSST: HOSTS
       SHOTS
HOSSW: SHOWS
HOSTU: HOTUS
HOSUY: SHOYU
HRSSU: RUSHS
HSTUU: HUTUS
HSUUW: WUSHU
IIKKS: KIKIS
IIKLM: KILIM
IIKOR: RIKIO
IIKST: TIKIS
IIKSW: KIWIS
       WIKIS
       WISKI
IILNO: ILION
IILRS: SIRLI
IILRV: VIRIL
IIMMS: MIMIS
IIMNS: MINIS
IIMOS: MOISI
IIMOT: MOITI
IINOU: INOUI
IINST: INSTI
       INTIS
IINTU: INUIT
IINTV: INVIT
IIORT: TORII
IIOSV: VISIO
IIPPS: PIPIS
IIPPT: PIPIT
IIPST: TIPIS
IIRVZ: VIZIR
IISTT: TITIS
IISUV: SUIVI
IISZZ: ZIZIS
IJLOS: JOLIS
IJNOS: JOINS
IJNOT: JOINT
IJNSU: JUINS
IJORU: JOUIR
IJOSU: JOUIS
IJOTU: JOUIT
IKLLR: KRILL
IKLNS: LINKS
IKLOS: KILOS
IKLST: KILTS
IKLXY: KYLIX
IKNSS: SKINS
IKNSU: INUKS
IKOOR: IROKO
IKPSS: SKIPS
IKRSS: KRISS
IKRSZ: ZIKRS
ILLMO: MOLLI
ILLTW: TWILL
ILMNO: LIMON
ILMPU: PILUM
ILMSS: SLIMS
ILMSU: MUSLI
ILNNO: LINON
ILNOO: NIOLO
ILNOP: LOPIN
       PILON
       PLION
ILNOR: LIRON
ILNOS: LINOS
       LIONS
       NOLIS
       SOLIN
ILNOU: NIOLU
ILNPT: PLINT
ILNPU: LUPIN
ILNSU: LUSIN
ILNTU: LUTIN
ILNUZ: LUZIN
ILNVY: VINYL
ILOOP: POLIO
ILOPR: POLIR
ILOPS: POILS
       POLIS
ILOPT: PILOT
       POLIT
ILOPU: PILOU
       POILU
ILORS: LOIRS
       LORIS
ILORT: LOTIR
       TORIL
       TRIOL
ILOSS: SILOS
ILOST: ILOTS
       LOTIS
ILOSU: LOUIS
ILOSV: VIOLS
       VOLIS
ILOTT: LOTIT
ILOTU: OUTIL
ILPPU: LIPPU
ILPSS: LISPS
       SLIPS
ILQTU: QUILT
ILSST: SILTS
ILSSY: SYLIS
ILSTT: TILTS
IMMNU: IMMUN
IMNNO: MINON
IMNOO: MONOI
IMNOR: MORIN
IMNOS: MOINS
IMNOT: MINOT
       MITON
       TIMON
IMNOU: MINOU
IMNRU: MUNIR
       MURIN
IMNSU: MINUS
       MUNIS
IMNTU: MUNIT
       MUTIN
IMOOR: MORIO
IMOOT: OTOMI
IMOPR: IMPRO
       PRIMO
IMOPT: IMPOT
IMOPU: OPIUM
IMORS: MIROS
IMORU: ROUMI
IMORV: VOMIR
IMOSS: MISOS
       MOSSI
IMOSV: VOMIS
IMOTV: VOMIT
IMPRU: IMPUR
IMRRU: MURIR
IMRSU: MURIS
IMRTU: MURIT
IMSSU: SIUMS
INNOR: RONIN
INNOS: NIONS
       SINON
INNOU: UNION
INNSU: INNUS
INOOS: OISON
INOPP: IPPON
INOPR: ORPIN
       PRION
INOPS: PIONS
       POINS
INOPT: PINOT
       PITON
       POINT
       POTIN
INORS: IRONS
       NOIRS
       NORIS
       ORINS
       RIONS
INORT: INTRO
       IRONT
       NITRO
       ROTIN
INOSS: SOINS
INOST: OINTS
       TISON
INOSV: NOVIS
       OVINS
       OVNIS
       VISON
INOSX: IXONS
INOTX: INTOX
INPPU: PINUP
INPRT: PRINT
INPRU: PUNIR
       PURIN
       RUPIN
INPSS: SPINS
INPSU: PUNIS
       SUPIN
INPTU: INPUT
       PUNIT
INQTU: QUINT
INRST: TRINS
INRSU: SURIN
       URSIN
INSSU: SINUS
INSSW: SWINS
INSTU: NUITS
       SUINT
INSTW: TWINS
INSUV: UNIVS
IOPPS: PIPOS
IOPQU: QUIPO
IOPRS: SIROP
IOPRU: RIPOU
IOPSS: SIPOS
IOPTU: PITOU
IOPTV: PIVOT
IOPUY: YOUPI
IORRS: ROSIR
IORRT: ROTIR
IORRU: ROUIR
IORSS: ROSIS
       SOIRS
IORST: ROSIT
       ROSTI
       ROTIS
       SORTI
       TRIOS
       TROIS
IORSU: ROUIS
       SOURI
IORTT: ROTIT
IORTU: ROUIT
IORTV: VITRO
IOSTT: SITOT
       TOITS
IOSUV: VISOU
IOSUX: SIOUX
IPQUU: QUIPU
IPRST: STRIP
       TRIPS
IPSTT: PSITT
IPSTU: PUITS
       TUPIS
IPSTZ: SPITZ
IPTTU: PUTTI
IRRSU: SURIR
IRSSU: SURIS
IRSTU: SURIT
IRSTX: STRIX
IRSUV: VIRUS
ISSSU: ISSUS
ISSTU: TISSU
ISTTU: TITUS
       TUTSI
ISTTW: TWIST
ITTTU: TUTTI
JJOOS: JOJOS
JKNSU: JUNKS
JKNUY: JUNKY
JLOTU: JULOT
JMNOO: JOMON
JMOOS: MOJOS
JMPSU: JUMPS
JNOPU: JUPON
JNORU: JURON
JOOPR: PROJO
JORSU: JOURS
JRSUY: JURYS
KLOOS: LOOKS
KLOPU: PLOUK
KLSUY: SULKY
KMOOS: MOKOS
       MOOKS
KMOSS: SMOKS
KMPRU: KRUMP
KNOSS: SKONS
KNOTU: KNOUT
KNPSU: PUNKS
KNSSU: SKUNS
KOOST: KOTOS
KORSU: KSOUR
KORSY: YORKS
KOSSU: SOUKS
KOSUY: YUKOS
KOSUZ: ZOUKS
KRSSY: SKYRS
KRSUU: KURUS
LLMOO: MOLLO
LLMSU: MULLS
LLOOS: LOLOS
LLORS: ROLLS
LLORT: TROLL
LLOXY: XYLOL
LLPSU: PULLS
LLRUY: RULLY
LLSUU: LULUS
LMNOU: MULON
LMOOS: LOMOS
LMOOT: MOLTO
LMORU: MUROL
LMOST: SMOLT
LMOSY: MOLYS
LMOTU: MOULT
       MULOT
LMOUU: MOULU
LMPSU: LUMPS
LMSSU: SLUMS
LNNOY: NYLON
LNOOR: ORLON
LNOOZ: LONZO
LNORU: LURON
LNOUZ: LONZU
LOOPR: PROLO
LOOPS: POLOS
       POOLS
       SLOOP
LOOSS: SOLOS
LOOST: LOTOS
LOPST: PLOTS
LOPSU: LOUPS
       POULS
LOPSY: POLYS
LORRY: LORRY
LORUZ: RUOLZ
LOSSU: SOULS
LOSSW: SLOWS
LOSTU: LOTUS
       TOLUS
LOSTV: VOLTS
LOSTY: STYLO
LOTYZ: ZLOTY
LOUUV: VOULU
LPRSU: SLURP
LPSUU: LUPUS
MMOTY: TOMMY
MNOOS: MONOS
MNORU: MURON
MNOST: MONTS
MNOSU: MUONS
MOOOR: OROMO
MOOPR: PROMO
MOORV: VROOM
MOOST: MOTOS
MOOSZ: ZOOMS
MOPRS: ROMPS
MOPRT: ROMPT
MOPRU: PROMU
       ROMPU
MORST: MORTS
MORUV: VROUM
MOSSU: SOUMS
       SUMOS
MOSTU: MOTUS
       MOUTS
MRSUW: WURMS
MSSTU: MUSTS
NNOOS: NONOS
NNOSU: NUONS
NNOTU: NUTON
NOOPR: PONOR
       PORNO
NOOPT: PONOT
NOORT: TORON
NOOSS: OSONS
       SONOS
NOOST: OTONS
NOOSY: OYONS
NOOTT: TOTON
NOPST: PONTS
NOPSU: PUONS
NOPTY: TYPON
NORSU: RUONS
NOSSU: SUONS
       USONS
NOSTU: TONUS
       TUONS
NPSTU: PUNTS
NPSUU: PUNUS
OOPRS: SOPOR
OOPRT: PORTO
       PROTO
OOPRV: PROVO
OOPRX: PROXO
OOPST: TOPOS
OOPTT: POTTO
OORRT: ROTOR
OORST: ROTOS
OORTT: TTORO
OOSST: OSTOS
       SOSOT
OOSTT: TOTOS
OOSUZ: OUZOS
OOSYY: YOYOS
OOSZZ: ZOZOS
OOUVY: VOYOU
OPPPU: POPUP
OPPSU: SUPPO
OPRST: PORTS
       SPORT
OPRSU: PUROS
OPRTU: PROUT
       PUROT
OPRXY: PROXY
OPSST: POSTS
       SPOTS
       STOPS
OPSTU: POTUS
OPSTY: TYPOS
OPTTU: PUTTO
ORRST: TORRS
ORSST: SORTS
ORSSU: SUROS
ORSTT: TORTS
       TROTS
ORSTU: TOURS
       TROUS
ORSTY: STORY
       TORYS
ORTTU: TORTU
OSSSU: OSSUS
OSSTT: STOTS
OSTTU: STOUT
       TOUTS
       TUTOS
PSSTU: STUPS
PSTTU: PUTTS
RSTTU: TRUST
STTUU: STUUT
       TUTUS
SUUYZ: YUZUS
