Tirages de 2 lettres de AA à UW - Page 1/1

AA:	AA		OH														
AB:	BA	IL:	IL														
AC:	CA		LI														
AD:	DA	IM:	MI														
AF:	FA	IN:	IN														
AH:	AH		NI														
	HA	IP:	PI														
AI:	AI	IR:	RI														
AK:	KA	IS:	SI														
AL:	LA	IX:	XI														
AM:	MA	LU:	LU														
AN:	AN	MO:	OM														
	NA	MU:	MU														
AR:	RA	NO:	NO														
AS:	AS		ON														
	SA	NU:	NU														
AT:	TA		UN														
AU:	AU	OR:	OR														
AV:	VA	OS:	OS														
AY:	AY	OT:	TO														
BE:	BE	OU:	OU														
BI:	BI	PU:	PU														
BU:	BU	RU:	RU														
CE:	CE	SU:	SU														
CI:	CI		US														
CO:	OC	SV:	VS														
DE:	DE	TU:	TU														
DO:	DO		UT														
DU:	DU	UV:	VU														
	UD	UW:	WU														
EH:	EH																
	HE																
EJ:	JE																
EL:	LE																
EM:	ME																
EN:	EN																
	NE																
ER:	RE																
ES:	ES																
	SE																
ET:	ET																
	TE																
EU:	EU																
EV:	VE																
EX:	EX																
FI:	FI																
	IF																
GO:	GO																
HI:	HI																
HO:	HO																


